Sr. No.,Value date,Transaction Date,Cheque Number,Transacting Remarks,Withdrawal Amount,Deposit Amount,Balance
1,2019-12-31,2020-01-01,100000,Cheque Issued,2949.39,0.00,7050.61
2,2020-01-01,2020-01-01,,Investment - Stocks,3190.59,0.00,3860.02
3,2019-12-31,2020-01-01,,Salary Credit,0.00,4224.35,8084.37
4,2020-01-01,2020-01-01,,Transfer Received,0.00,2512.07,10596.44
5,2019-12-31,2020-01-01,,Daily Essentials,7.49,0.00,10588.95
6,2020-01-01,2020-01-01,,Transfer Received,0.00,1865.13,12454.08
7,2019-12-31,2020-01-01,,Online Transfer,1227.55,0.00,11226.53
8,2019-12-31,2020-01-01,,Transfer Received,0.00,625.27,11851.80
9,2020-01-02,2020-01-01,,Groceries - Online Delivery,130.03,0.00,11721.77
10,2020-01-01,2020-01-01,,Dining Out,63.49,0.00,11658.28
11,2020-01-02,2020-01-02,,Transfer Received,0.00,1293.68,12951.96
12,2020-01-02,2020-01-02,,Online Transfer,1629.42,0.00,11322.54
13,2020-01-01,2020-01-02,,ATM Withdrawal,320.86,0.00,11001.68
14,2020-01-02,2020-01-02,,Transfer Received,0.00,2009.53,13011.21
15,2020-01-02,2020-01-02,,Groceries - Supermarket,118.66,0.00,12892.55
16,2020-01-03,2020-01-03,,Credit Card Payment,932.07,0.00,11960.48
17,2020-01-03,2020-01-03,,Dining Out,75.69,0.00,11884.79
18,2020-01-04,2020-01-03,,Transfer Received,0.00,1661.27,13546.06
19,2020-01-03,2020-01-03,,Salary Credit,0.00,2863.88,16409.94
20,2020-01-03,2020-01-03,,Online Transfer,259.63,0.00,16150.31
21,2020-01-04,2020-01-04,,ATM Withdrawal,237.10,0.00,15913.21
22,2020-01-05,2020-01-04,,Loan EMI,1502.88,0.00,14410.33
23,2020-01-04,2020-01-04,,Cash Deposit,0.00,987.26,15397.59
24,2020-01-04,2020-01-04,,Credit Card Payment,218.75,0.00,15178.84
25,2020-01-05,2020-01-05,,Salary Credit,0.00,4806.14,19984.98
26,2020-01-05,2020-01-05,,Dining Out,26.99,0.00,19957.99
27,2020-01-05,2020-01-05,,Credit Card Payment,971.92,0.00,18986.07
28,2020-01-05,2020-01-05,,Interest Credited,0.00,76.95,19063.02
29,2020-01-05,2020-01-05,,Loan EMI,1984.04,0.00,17078.98
30,2020-01-06,2020-01-05,,Groceries - Online Delivery,71.18,0.00,17007.80
31,2020-01-05,2020-01-05,,Online Transfer,188.19,0.00,16819.61
32,2020-01-04,2020-01-05,,Groceries - Supermarket,92.06,0.00,16727.55
33,2020-01-05,2020-01-05,,Interest Credited,0.00,74.80,16802.35
34,2020-01-06,2020-01-06,,Online Transfer,146.61,0.00,16655.74
35,2020-01-06,2020-01-06,,Daily Essentials,33.24,0.00,16622.50
36,2020-01-07,2020-01-06,,Dining Out,22.04,0.00,16600.46
37,2020-01-06,2020-01-06,,Investment Returns,0.00,406.98,17007.44
38,2020-01-06,2020-01-06,,Salary Credit,0.00,3180.52,20187.96
39,2020-01-07,2020-01-07,,Online Transfer,1600.63,0.00,18587.33
40,2020-01-07,2020-01-07,,Credit Card Payment,675.59,0.00,17911.74
41,2020-01-08,2020-01-07,,Investment Returns,0.00,901.90,18813.64
42,2020-01-07,2020-01-07,,Investment - SIP,725.66,0.00,18087.98
43,2020-01-08,2020-01-07,,ATM Withdrawal,114.35,0.00,17973.63
44,2020-01-07,2020-01-07,,Groceries - Supermarket,164.92,0.00,17808.71
45,2020-01-07,2020-01-07,,Salary Credit,0.00,4261.50,22070.21
46,2020-01-08,2020-01-08,,Salary Credit,0.00,4257.53,26327.74
47,2020-01-09,2020-01-08,,Takeout,27.93,0.00,26299.81
48,2020-01-08,2020-01-08,,Transfer Received,0.00,958.44,27258.25
49,2020-01-08,2020-01-08,,Salary Credit,0.00,4873.08,32131.33
50,2020-01-07,2020-01-08,,Dining Out,39.20,0.00,32092.13
51,2020-01-08,2020-01-08,,Groceries - Supermarket,184.37,0.00,31907.76
52,2020-01-08,2020-01-09,,Loan EMI,1013.51,0.00,30894.25
53,2020-01-09,2020-01-09,,Credit Card Payment,782.72,0.00,30111.53
54,2020-01-10,2020-01-09,,Utility Payment,296.38,0.00,29815.15
55,2020-01-09,2020-01-09,,Groceries - Supermarket,57.31,0.00,29757.84
56,2020-01-10,2020-01-09,,Transfer Received,0.00,2406.60,32164.44
57,2020-01-09,2020-01-09,,Loan EMI,799.66,0.00,31364.78
58,2020-01-09,2020-01-09,,Utility Payment,141.63,0.00,31223.15
59,2020-01-10,2020-01-09,,ATM Withdrawal,427.66,0.00,30795.49
60,2020-01-10,2020-01-09,,Transfer Received,0.00,670.28,31465.77
61,2020-01-09,2020-01-09,,Salary Credit,0.00,2736.35,34202.12
62,2020-01-09,2020-01-09,,Rental Income,0.00,1925.83,36127.95
63,2020-01-10,2020-01-09,,Credit Card Payment,750.67,0.00,35377.28
64,2020-01-11,2020-01-10,,Credit Card Payment,971.63,0.00,34405.65
65,2020-01-11,2020-01-10,,ATM Withdrawal,434.23,0.00,33971.42
66,2020-01-10,2020-01-10,,Investment Returns,0.00,143.68,34115.10
67,2020-01-11,2020-01-11,,Rental Income,0.00,2501.94,36617.04
68,2020-01-11,2020-01-11,,Salary Credit,0.00,3432.92,40049.96
69,2020-01-11,2020-01-11,,Investment Returns,0.00,185.43,40235.39
70,2020-01-11,2020-01-11,,Transfer Received,0.00,736.34,40971.73
71,2020-01-13,2020-01-12,100001,Cheque Issued,1161.84,0.00,39809.89
72,2020-01-12,2020-01-12,,Credit Card Payment,439.64,0.00,39370.25
73,2020-01-12,2020-01-12,,Investment - Stocks,726.18,0.00,38644.07
74,2020-01-13,2020-01-13,,Dividend Received,0.00,66.90,38710.97
75,2020-01-13,2020-01-13,,Utility Payment,295.49,0.00,38415.48
76,2020-01-13,2020-01-13,,Transfer Received,0.00,1743.54,40159.02
77,2020-01-12,2020-01-13,,ATM Withdrawal,27.67,0.00,40131.35
78,2020-01-13,2020-01-13,,Utility Payment,112.00,0.00,40019.35
79,2020-01-14,2020-01-13,,Utility Payment,209.67,0.00,39809.68
80,2020-01-14,2020-01-14,,Credit Card Payment,444.60,0.00,39365.08
81,2020-01-13,2020-01-14,,Daily Essentials,49.46,0.00,39315.62
82,2020-01-14,2020-01-14,,Investment - Stocks,4478.64,0.00,34836.98
83,2020-01-15,2020-01-15,,ATM Withdrawal,413.10,0.00,34423.88
84,2020-01-15,2020-01-15,,Loan EMI,1606.32,0.00,32817.56
85,2020-01-15,2020-01-15,,Groceries - Supermarket,124.87,0.00,32692.69
86,2020-01-15,2020-01-15,,Online Transfer,1719.60,0.00,30973.09
87,2020-01-14,2020-01-15,,Investment - Stocks,740.39,0.00,30232.70
88,2020-01-15,2020-01-15,,Utility Payment,220.47,0.00,30012.23
89,2020-01-16,2020-01-16,,ATM Withdrawal,235.64,0.00,29776.59
90,2020-01-16,2020-01-16,,Transfer Received,0.00,2724.64,32501.23
91,2020-01-15,2020-01-16,,Utility Payment,161.59,0.00,32339.64
92,2020-01-16,2020-01-16,,Salary Credit,0.00,4111.61,36451.25
93,2020-01-16,2020-01-16,,Investment - Mutual Funds,2075.76,0.00,34375.49
94,2020-01-17,2020-01-16,,Coffee Shop,6.11,0.00,34369.38
95,2020-01-17,2020-01-17,,Investment Returns,0.00,196.45,34565.83
96,2020-01-17,2020-01-17,,Takeout,34.33,0.00,34531.50
97,2020-01-17,2020-01-17,,Cash Deposit,0.00,151.13,34682.63
98,2020-01-17,2020-01-17,,Credit Card Payment,889.43,0.00,33793.20
99,2020-01-17,2020-01-17,,Utility Payment,70.19,0.00,33723.01
100,2020-01-17,2020-01-17,,Groceries - Supermarket,115.76,0.00,33607.25
101,2020-01-18,2020-01-17,,Credit Card Payment,816.04,0.00,32791.21
102,2020-01-18,2020-01-17,,Groceries - Supermarket,195.66,0.00,32595.55
103,2020-01-19,2020-01-18,,Credit Card Payment,521.67,0.00,32073.88
104,2020-01-18,2020-01-18,,ATM Withdrawal,400.39,0.00,31673.49
105,2020-01-18,2020-01-18,,ATM Withdrawal,158.08,0.00,31515.41
106,2020-01-18,2020-01-18,,Transfer Received,0.00,1824.65,33340.06
107,2020-01-18,2020-01-18,,Investment Returns,0.00,552.29,33892.35
108,2020-01-18,2020-01-18,,Transfer Received,0.00,1796.72,35689.07
109,2020-01-19,2020-01-19,,Utility Payment,262.42,0.00,35426.65
110,2020-01-20,2020-01-19,,Credit Card Payment,780.38,0.00,34646.27
111,2020-01-18,2020-01-19,,Transfer Received,0.00,1797.49,36443.76
112,2020-01-19,2020-01-19,,Coffee Shop,10.80,0.00,36432.96
113,2020-01-19,2020-01-19,,Credit Card Payment,657.47,0.00,35775.49
114,2020-01-20,2020-01-19,,Rental Income,0.00,2858.84,38634.33
115,2020-01-20,2020-01-19,,Groceries - Online Delivery,123.27,0.00,38511.06
116,2020-01-19,2020-01-19,,Online Transfer,1075.65,0.00,37435.41
117,2020-01-19,2020-01-19,,ATM Withdrawal,381.34,0.00,37054.07
118,2020-01-19,2020-01-19,,Online Transfer,1192.69,0.00,35861.38
119,2020-01-19,2020-01-20,,Loan EMI,733.92,0.00,35127.46
120,2020-01-19,2020-01-20,,ATM Withdrawal,348.37,0.00,34779.09
121,2020-01-19,2020-01-20,,Cash Deposit,0.00,900.84,35679.93
122,2020-01-20,2020-01-20,,Daily Essentials,15.93,0.00,35664.00
123,2020-01-20,2020-01-20,,Credit Card Payment,596.19,0.00,35067.81
124,2020-01-20,2020-01-20,,Salary Credit,0.00,3530.49,38598.30
125,2020-01-20,2020-01-20,,Groceries - Supermarket,123.89,0.00,38474.41
126,2020-01-21,2020-01-20,,Cash Deposit,0.00,764.08,39238.49
127,2020-01-21,2020-01-21,,Salary Credit,0.00,2798.68,42037.17
128,2020-01-21,2020-01-21,,ATM Withdrawal,120.71,0.00,41916.46
129,2020-01-21,2020-01-21,,Salary Credit,0.00,2640.43,44556.89
130,2020-01-21,2020-01-21,,Online Transfer,584.37,0.00,43972.52
131,2020-01-21,2020-01-21,,Credit Card Payment,287.97,0.00,43684.55
132,2020-01-22,2020-01-22,,Transfer Received,0.00,1332.44,45016.99
133,2020-01-23,2020-01-22,,ATM Withdrawal,351.06,0.00,44665.93
134,2020-01-21,2020-01-22,,Dining Out,54.55,0.00,44611.38
135,2020-01-23,2020-01-22,,ATM Withdrawal,319.96,0.00,44291.42
136,2020-01-23,2020-01-22,,Transfer Received,0.00,2433.86,46725.28
137,2020-01-22,2020-01-22,,Transfer Received,0.00,2764.58,49489.86
138,2020-01-23,2020-01-23,,ATM Withdrawal,391.77,0.00,49098.09
139,2020-01-24,2020-01-23,,Dividend Received,0.00,438.52,49536.61
140,2020-01-23,2020-01-23,,Dining Out,11.70,0.00,49524.91
141,2020-01-23,2020-01-23,,Transfer Received,0.00,2576.68,52101.59
142,2020-01-23,2020-01-23,,Credit Card Payment,749.64,0.00,51351.95
143,2020-01-22,2020-01-23,,Online Transfer,1603.50,0.00,49748.45
144,2020-01-23,2020-01-23,,Salary Credit,0.00,2983.36,52731.81
145,2020-01-23,2020-01-23,,Credit Card Payment,332.82,0.00,52398.99
146,2020-01-25,2020-01-24,,Interest Credited,0.00,23.43,52422.42
147,2020-01-25,2020-01-24,,ATM Withdrawal,256.90,0.00,52165.52
148,2020-01-23,2020-01-24,,Interest Credited,0.00,99.66,52265.18
149,2020-01-24,2020-01-24,,Utility Payment,154.35,0.00,52110.83
150,2020-01-25,2020-01-25,,Groceries - Online Delivery,106.52,0.00,52004.31
151,2020-01-25,2020-01-25,,Salary Credit,0.00,2059.88,54064.19
152,2020-01-25,2020-01-25,,Transfer Received,0.00,1409.00,55473.19
153,2020-01-26,2020-01-25,,ATM Withdrawal,246.63,0.00,55226.56
154,2020-01-25,2020-01-25,,Transfer Received,0.00,1276.92,56503.48
155,2020-01-25,2020-01-25,,Transfer Received,0.00,2817.35,59320.83
156,2020-01-25,2020-01-25,,ATM Withdrawal,494.90,0.00,58825.93
157,2020-01-27,2020-01-26,,Salary Credit,0.00,4508.56,63334.49
158,2020-01-26,2020-01-26,,Credit Card Payment,649.59,0.00,62684.90
159,2020-01-26,2020-01-26,,Online Transfer,236.37,0.00,62448.53
160,2020-01-26,2020-01-26,,Groceries - Supermarket,108.39,0.00,62340.14
161,2020-01-26,2020-01-26,,Salary Credit,0.00,2183.49,64523.63
162,2020-01-27,2020-01-26,,Dividend Received,0.00,379.00,64902.63
163,2020-01-25,2020-01-26,100002,Cheque Issued,2326.49,0.00,62576.14
164,2020-01-26,2020-01-26,,Groceries - Supermarket,72.20,0.00,62503.94
165,2020-01-26,2020-01-26,,Salary Credit,0.00,2576.48,65080.42
166,2020-01-26,2020-01-26,,Salary Credit,0.00,4029.06,69109.48
167,2020-01-26,2020-01-26,,Online Transfer,1993.79,0.00,67115.69
168,2020-01-26,2020-01-26,100003,Cheque Issued,2473.49,0.00,64642.20
169,2020-01-27,2020-01-26,,Investment - SIP,950.43,0.00,63691.77
170,2020-01-26,2020-01-26,,Transfer Received,0.00,2667.54,66359.31
171,2020-01-27,2020-01-26,,Online Transfer,1064.83,0.00,65294.48
172,2020-01-26,2020-01-26,,Dining Out,36.62,0.00,65257.86
173,2020-01-27,2020-01-26,,Interest Credited,0.00,12.41,65270.27
174,2020-01-26,2020-01-26,,Investment - SIP,276.88,0.00,64993.39
175,2020-01-27,2020-01-27,,Online Transfer,1053.91,0.00,63939.48
176,2020-01-27,2020-01-27,,Utility Payment,83.94,0.00,63855.54
177,2020-01-27,2020-01-27,,Online Transfer,1570.61,0.00,62284.93
178,2020-01-26,2020-01-27,,Salary Credit,0.00,3644.35,65929.28
179,2020-01-28,2020-01-27,,Salary Credit,0.00,4340.00,70269.28
180,2020-01-27,2020-01-27,,Credit Card Payment,465.13,0.00,69804.15
181,2020-01-27,2020-01-27,,Salary Credit,0.00,3985.67,73789.82
182,2020-01-26,2020-01-27,,Loan EMI,668.38,0.00,73121.44
183,2020-01-27,2020-01-27,,Transfer Received,0.00,2372.18,75493.62
184,2020-01-27,2020-01-27,,Daily Essentials,45.50,0.00,75448.12
185,2020-01-27,2020-01-27,,Daily Essentials,23.94,0.00,75424.18
186,2020-01-27,2020-01-27,,Transfer Received,0.00,2255.66,77679.84
187,2020-01-28,2020-01-28,,Interest Credited,0.00,22.25,77702.09
188,2020-01-27,2020-01-28,,Groceries - Supermarket,165.84,0.00,77536.25
189,2020-01-28,2020-01-28,,Salary Credit,0.00,3782.66,81318.91
190,2020-01-28,2020-01-28,,ATM Withdrawal,56.42,0.00,81262.49
191,2020-01-28,2020-01-28,,Groceries - Supermarket,30.70,0.00,81231.79
192,2020-01-28,2020-01-28,,Transfer Received,0.00,2239.94,83471.73
193,2020-01-28,2020-01-28,,Dining Out,35.43,0.00,83436.30
194,2020-01-28,2020-01-28,,Salary Credit,0.00,2683.13,86119.43
195,2020-01-29,2020-01-28,,Transfer Received,0.00,2619.66,88739.09
196,2020-01-29,2020-01-28,,Transfer Received,0.00,1776.90,90515.99
197,2020-01-29,2020-01-28,,Transfer Received,0.00,2525.52,93041.51
198,2020-01-30,2020-01-29,,Investment - SIP,799.46,0.00,92242.05
199,2020-01-29,2020-01-29,,Transfer Received,0.00,554.80,92796.85
200,2020-01-28,2020-01-29,,Takeout,12.21,0.00,92784.64
201,2020-01-28,2020-01-29,,Cash Deposit,0.00,145.25,92929.89
202,2020-01-29,2020-01-29,,Transfer Received,0.00,1780.77,94710.66
203,2020-01-29,2020-01-29,,Groceries - Supermarket,78.12,0.00,94632.54
204,2020-01-29,2020-01-29,,Online Transfer,1910.62,0.00,92721.92
205,2020-01-30,2020-01-29,,Dividend Received,0.00,391.53,93113.45
206,2020-01-29,2020-01-29,,Salary Credit,0.00,3633.23,96746.68
207,2020-01-29,2020-01-29,,Groceries - Online Delivery,134.34,0.00,96612.34
208,2020-01-29,2020-01-29,,ATM Withdrawal,201.45,0.00,96410.89
209,2020-01-30,2020-01-29,,Takeout,32.94,0.00,96377.95
210,2020-01-29,2020-01-29,,Groceries - Online Delivery,67.25,0.00,96310.70
211,2020-01-31,2020-01-30,,Dining Out,75.88,0.00,96234.82
212,2020-01-30,2020-01-30,,ATM Withdrawal,20.98,0.00,96213.84
213,2020-01-31,2020-01-30,,Rental Income,0.00,1000.13,97213.97
214,2020-01-31,2020-01-30,,Loan EMI,1124.72,0.00,96089.25
215,2020-01-30,2020-01-30,,Online Transfer,1099.97,0.00,94989.28
216,2020-01-30,2020-01-30,,Groceries - Supermarket,118.66,0.00,94870.62
217,2020-01-30,2020-01-30,,Salary Credit,0.00,2802.03,97672.65
218,2020-01-31,2020-01-30,,Transfer Received,0.00,568.93,98241.58
219,2020-01-31,2020-01-31,,Transfer Received,0.00,771.47,99013.05
220,2020-01-31,2020-01-31,100004,Cheque Issued,1062.70,0.00,97950.35
221,2020-01-30,2020-01-31,,Transfer Received,0.00,1699.45,99649.80
222,2020-01-31,2020-01-31,100005,Cheque Issued,1092.73,0.00,98557.07
223,2020-01-31,2020-01-31,,Cash Deposit,0.00,116.97,98674.04
224,2020-02-01,2020-02-01,,Salary Credit,0.00,2173.61,100847.65
225,2020-01-31,2020-02-01,,Transfer Received,0.00,1538.16,102385.81
226,2020-02-03,2020-02-02,,Credit Card Payment,212.17,0.00,102173.64
227,2020-02-02,2020-02-02,,Salary Credit,0.00,3012.28,105185.92
228,2020-02-02,2020-02-02,,Transfer Received,0.00,2068.46,107254.38
229,2020-02-02,2020-02-02,,Transfer Received,0.00,1355.85,108610.23
230,2020-02-02,2020-02-02,,Utility Payment,108.33,0.00,108501.90
231,2020-02-03,2020-02-03,100006,Cheque Issued,2423.06,0.00,106078.84
232,2020-02-03,2020-02-03,,Groceries - Supermarket,185.63,0.00,105893.21
233,2020-02-03,2020-02-03,,Credit Card Payment,764.49,0.00,105128.72
234,2020-02-03,2020-02-03,,Transfer Received,0.00,1678.03,106806.75
235,2020-02-03,2020-02-03,,Dividend Received,0.00,121.97,106928.72
236,2020-02-03,2020-02-03,,ATM Withdrawal,21.15,0.00,106907.57
237,2020-02-03,2020-02-03,,Online Transfer,1155.52,0.00,105752.05
238,2020-02-03,2020-02-03,,Interest Credited,0.00,74.22,105826.27
239,2020-02-03,2020-02-04,,ATM Withdrawal,267.36,0.00,105558.91
240,2020-02-04,2020-02-04,,Transfer Received,0.00,2695.73,108254.64
241,2020-02-04,2020-02-04,,Salary Credit,0.00,3520.04,111774.68
242,2020-02-04,2020-02-04,,Dining Out,11.40,0.00,111763.28
243,2020-02-03,2020-02-04,100007,Cheque Issued,606.21,0.00,111157.07
244,2020-02-05,2020-02-05,,ATM Withdrawal,412.18,0.00,110744.89
245,2020-02-06,2020-02-05,,Dividend Received,0.00,123.65,110868.54
246,2020-02-05,2020-02-05,100008,Cheque Issued,917.32,0.00,109951.22
247,2020-02-06,2020-02-05,,Loan EMI,1004.81,0.00,108946.41
248,2020-02-05,2020-02-05,,Dining Out,59.34,0.00,108887.07
249,2020-02-05,2020-02-05,,Transfer Received,0.00,2494.70,111381.77
250,2020-02-05,2020-02-05,,Rental Income,0.00,2820.83,114202.60
251,2020-02-06,2020-02-05,,Credit Card Payment,997.09,0.00,113205.51
252,2020-02-07,2020-02-06,,ATM Withdrawal,378.00,0.00,112827.51
253,2020-02-07,2020-02-06,,Transfer Received,0.00,525.94,113353.45
254,2020-02-06,2020-02-06,,Investment - Stocks,2233.95,0.00,111119.50
255,2020-02-05,2020-02-06,,Online Transfer,1351.23,0.00,109768.27
256,2020-02-07,2020-02-06,,Interest Credited,0.00,54.48,109822.75
257,2020-02-07,2020-02-07,,Interest Credited,0.00,97.38,109920.13
258,2020-02-06,2020-02-07,,Dining Out,37.36,0.00,109882.77
259,2020-02-06,2020-02-07,,Groceries - Online Delivery,124.86,0.00,109757.91
260,2020-02-06,2020-02-07,,Dining Out,63.77,0.00,109694.14
261,2020-02-07,2020-02-07,,Rental Income,0.00,2409.10,112103.24
262,2020-02-08,2020-02-08,,Investment Returns,0.00,876.20,112979.44
263,2020-02-07,2020-02-08,,Utility Payment,268.80,0.00,112710.64
264,2020-02-07,2020-02-08,,Daily Essentials,30.88,0.00,112679.76
265,2020-02-09,2020-02-08,,Salary Credit,0.00,3567.40,116247.16
266,2020-02-07,2020-02-08,,Credit Card Payment,927.09,0.00,115320.07
267,2020-02-08,2020-02-08,,Transfer Received,0.00,2669.68,117989.75
268,2020-02-08,2020-02-08,,Transfer Received,0.00,1434.05,119423.80
269,2020-02-08,2020-02-08,,Groceries - Supermarket,31.50,0.00,119392.30
270,2020-02-08,2020-02-08,100009,Cheque Issued,1260.61,0.00,118131.69
271,2020-02-09,2020-02-08,,Groceries - Supermarket,186.38,0.00,117945.31
272,2020-02-08,2020-02-08,,ATM Withdrawal,326.08,0.00,117619.23
273,2020-02-09,2020-02-09,,Online Transfer,1909.21,0.00,115710.02
274,2020-02-09,2020-02-09,,Online Transfer,861.75,0.00,114848.27
275,2020-02-10,2020-02-09,,Transfer Received,0.00,725.50,115573.77
276,2020-02-09,2020-02-09,,ATM Withdrawal,239.44,0.00,115334.33
277,2020-02-08,2020-02-09,,Online Transfer,832.97,0.00,114501.36
278,2020-02-09,2020-02-09,,Interest Credited,0.00,91.56,114592.92
279,2020-02-09,2020-02-09,,Utility Payment,283.06,0.00,114309.86
280,2020-02-09,2020-02-09,,Dining Out,90.28,0.00,114219.58
281,2020-02-10,2020-02-10,,Transfer Received,0.00,2260.92,116480.50
282,2020-02-10,2020-02-10,,Transfer Received,0.00,1716.21,118196.71
283,2020-02-10,2020-02-10,,Loan EMI,665.08,0.00,117531.63
284,2020-02-10,2020-02-10,,Interest Credited,0.00,69.53,117601.16
285,2020-02-10,2020-02-10,,Takeout,26.65,0.00,117574.51
286,2020-02-10,2020-02-10,,Loan EMI,1911.42,0.00,115663.09
287,2020-02-11,2020-02-11,,Transfer Received,0.00,1395.73,117058.82
288,2020-02-11,2020-02-11,,Dining Out,87.73,0.00,116971.09
289,2020-02-11,2020-02-11,,Coffee Shop,6.45,0.00,116964.64
290,2020-02-12,2020-02-11,,Loan EMI,1828.36,0.00,115136.28
291,2020-02-11,2020-02-11,,ATM Withdrawal,132.72,0.00,115003.56
292,2020-02-11,2020-02-11,,Online Transfer,761.98,0.00,114241.58
293,2020-02-12,2020-02-12,,Loan EMI,1336.44,0.00,112905.14
294,2020-02-12,2020-02-12,,Utility Payment,129.42,0.00,112775.72
295,2020-02-13,2020-02-12,,Utility Payment,196.94,0.00,112578.78
296,2020-02-12,2020-02-12,,Credit Card Payment,766.28,0.00,111812.50
297,2020-02-12,2020-02-13,,Daily Essentials,10.04,0.00,111802.46
298,2020-02-13,2020-02-13,,Salary Credit,0.00,3269.97,115072.43
299,2020-02-13,2020-02-13,,Credit Card Payment,408.96,0.00,114663.47
300,2020-02-13,2020-02-13,,Salary Credit,0.00,2538.20,117201.67
301,2020-02-14,2020-02-13,,Daily Essentials,7.23,0.00,117194.44
302,2020-02-13,2020-02-13,,Salary Credit,0.00,2932.25,120126.69
303,2020-02-14,2020-02-13,,Rental Income,0.00,2968.75,123095.44
304,2020-02-13,2020-02-13,,Loan EMI,845.74,0.00,122249.70
305,2020-02-13,2020-02-13,,Online Transfer,249.41,0.00,122000.29
306,2020-02-13,2020-02-13,,Transfer Received,0.00,1257.86,123258.15
307,2020-02-14,2020-02-14,,Transfer Received,0.00,1313.55,124571.70
308,2020-02-14,2020-02-14,,Interest Credited,0.00,51.76,124623.46
309,2020-02-15,2020-02-14,,Credit Card Payment,696.03,0.00,123927.43
310,2020-02-14,2020-02-14,,Rental Income,0.00,1101.87,125029.30
311,2020-02-13,2020-02-14,,Transfer Received,0.00,2556.23,127585.53
312,2020-02-14,2020-02-14,,Transfer Received,0.00,2973.89,130559.42
313,2020-02-14,2020-02-14,,Groceries - Supermarket,123.36,0.00,130436.06
314,2020-02-14,2020-02-15,,Investment - Mutual Funds,1289.86,0.00,129146.20
315,2020-02-15,2020-02-15,,Transfer Received,0.00,2954.89,132101.09
316,2020-02-15,2020-02-15,,Salary Credit,0.00,3476.16,135577.25
317,2020-02-16,2020-02-16,,Loan EMI,1102.19,0.00,134475.06
318,2020-02-16,2020-02-16,,Transfer Received,0.00,628.67,135103.73
319,2020-02-16,2020-02-16,,Rental Income,0.00,1533.87,136637.60
320,2020-02-17,2020-02-16,,ATM Withdrawal,309.41,0.00,136328.19
321,2020-02-16,2020-02-16,,Credit Card Payment,658.24,0.00,135669.95
322,2020-02-16,2020-02-16,,Cash Deposit,0.00,286.14,135956.09
323,2020-02-17,2020-02-17,,Dividend Received,0.00,418.75,136374.84
324,2020-02-16,2020-02-17,,Cash Deposit,0.00,124.61,136499.45
325,2020-02-17,2020-02-17,,Transfer Received,0.00,2445.03,138944.48
326,2020-02-17,2020-02-17,,Transfer Received,0.00,2446.08,141390.56
327,2020-02-17,2020-02-17,,Loan EMI,1157.21,0.00,140233.35
328,2020-02-16,2020-02-17,,Transfer Received,0.00,1073.12,141306.47
329,2020-02-18,2020-02-17,,Groceries - Supermarket,71.37,0.00,141235.10
330,2020-02-17,2020-02-17,,Salary Credit,0.00,4616.42,145851.52
331,2020-02-16,2020-02-17,,Credit Card Payment,225.70,0.00,145625.82
332,2020-02-17,2020-02-17,,Takeout,40.81,0.00,145585.01
333,2020-02-17,2020-02-17,,ATM Withdrawal,115.83,0.00,145469.18
334,2020-02-16,2020-02-17,,Transfer Received,0.00,984.69,146453.87
335,2020-02-18,2020-02-18,,Investment Returns,0.00,707.54,147161.41
336,2020-02-17,2020-02-18,,Investment - Mutual Funds,1534.98,0.00,145626.43
337,2020-02-19,2020-02-18,,ATM Withdrawal,470.92,0.00,145155.51
338,2020-02-18,2020-02-18,,Groceries - Online Delivery,82.39,0.00,145073.12
339,2020-02-18,2020-02-18,,Groceries - Online Delivery,75.38,0.00,144997.74
340,2020-02-19,2020-02-19,,Cash Deposit,0.00,495.86,145493.60
341,2020-02-19,2020-02-19,,Salary Credit,0.00,2403.01,147896.61
342,2020-02-19,2020-02-19,,Transfer Received,0.00,870.92,148767.53
343,2020-02-20,2020-02-19,,Credit Card Payment,597.74,0.00,148169.79
344,2020-02-19,2020-02-19,,Groceries - Online Delivery,67.94,0.00,148101.85
345,2020-02-19,2020-02-19,,Salary Credit,0.00,3636.27,151738.12
346,2020-02-19,2020-02-19,,ATM Withdrawal,462.01,0.00,151276.11
347,2020-02-20,2020-02-20,,Interest Credited,0.00,81.31,151357.42
348,2020-02-20,2020-02-20,,Credit Card Payment,605.75,0.00,150751.67
349,2020-02-20,2020-02-20,,Interest Credited,0.00,10.99,150762.66
350,2020-02-19,2020-02-20,,Transfer Received,0.00,2975.86,153738.52
351,2020-02-19,2020-02-20,,ATM Withdrawal,441.21,0.00,153297.31
352,2020-02-19,2020-02-20,,Rental Income,0.00,2351.20,155648.51
353,2020-02-21,2020-02-20,,Transfer Received,0.00,1178.66,156827.17
354,2020-02-20,2020-02-20,,Takeout,19.36,0.00,156807.81
355,2020-02-20,2020-02-21,,Online Transfer,1022.25,0.00,155785.56
356,2020-02-20,2020-02-21,,Online Transfer,1396.76,0.00,154388.80
357,2020-02-21,2020-02-21,,Transfer Received,0.00,2159.90,156548.70
358,2020-02-21,2020-02-21,,Groceries - Supermarket,124.37,0.00,156424.33
359,2020-02-20,2020-02-21,,Transfer Received,0.00,2867.29,159291.62
360,2020-02-21,2020-02-21,,Groceries - Online Delivery,83.85,0.00,159207.77
361,2020-02-20,2020-02-21,,Online Transfer,1848.15,0.00,157359.62
362,2020-02-21,2020-02-21,,Salary Credit,0.00,2172.74,159532.36
363,2020-02-21,2020-02-21,,Dividend Received,0.00,488.24,160020.60
364,2020-02-21,2020-02-21,,Rental Income,0.00,1983.94,162004.54
365,2020-02-21,2020-02-22,,Online Transfer,384.65,0.00,161619.89
366,2020-02-21,2020-02-22,,Investment - SIP,323.41,0.00,161296.48
367,2020-02-23,2020-02-22,,Salary Credit,0.00,2740.76,164037.24
368,2020-02-22,2020-02-22,,Salary Credit,0.00,4607.60,168644.84
369,2020-02-23,2020-02-23,,Loan EMI,927.94,0.00,167716.90
370,2020-02-22,2020-02-23,,Utility Payment,150.26,0.00,167566.64
371,2020-02-22,2020-02-23,,Investment - Stocks,1329.67,0.00,166236.97
372,2020-02-23,2020-02-23,,Utility Payment,86.00,0.00,166150.97
373,2020-02-23,2020-02-23,,Groceries - Supermarket,159.10,0.00,165991.87
374,2020-02-23,2020-02-24,,Utility Payment,285.61,0.00,165706.26
375,2020-02-25,2020-02-24,,ATM Withdrawal,38.24,0.00,165668.02
376,2020-02-24,2020-02-24,,ATM Withdrawal,86.07,0.00,165581.95
377,2020-02-24,2020-02-24,,Online Transfer,1184.32,0.00,164397.63
378,2020-02-24,2020-02-24,,ATM Withdrawal,114.63,0.00,164283.00
379,2020-02-25,2020-02-25,,Credit Card Payment,544.32,0.00,163738.68
380,2020-02-25,2020-02-25,,ATM Withdrawal,212.19,0.00,163526.49
381,2020-02-26,2020-02-25,,Daily Essentials,7.09,0.00,163519.40
382,2020-02-25,2020-02-25,,Takeout,17.63,0.00,163501.77
383,2020-02-25,2020-02-25,,ATM Withdrawal,271.93,0.00,163229.84
384,2020-02-25,2020-02-25,,Transfer Received,0.00,1374.85,164604.69
385,2020-02-24,2020-02-25,,Interest Credited,0.00,38.29,164642.98
386,2020-02-26,2020-02-26,,Interest Credited,0.00,59.01,164701.99
387,2020-02-26,2020-02-26,,ATM Withdrawal,327.33,0.00,164374.66
388,2020-02-26,2020-02-26,,Transfer Received,0.00,2486.76,166861.42
389,2020-02-26,2020-02-26,,Salary Credit,0.00,2452.85,169314.27
390,2020-02-26,2020-02-26,,Daily Essentials,17.99,0.00,169296.28
391,2020-02-26,2020-02-26,,Salary Credit,0.00,4312.95,173609.23
392,2020-02-26,2020-02-27,,Utility Payment,158.47,0.00,173450.76
393,2020-02-27,2020-02-27,,Takeout,40.86,0.00,173409.90
394,2020-02-27,2020-02-27,,Credit Card Payment,816.48,0.00,172593.42
395,2020-02-27,2020-02-27,,Groceries - Online Delivery,128.57,0.00,172464.85
396,2020-02-27,2020-02-27,,ATM Withdrawal,236.42,0.00,172228.43
397,2020-02-26,2020-02-27,,Transfer Received,0.00,505.57,172734.00
398,2020-02-27,2020-02-27,,Transfer Received,0.00,2010.42,174744.42
399,2020-02-27,2020-02-27,,Transfer Received,0.00,1295.85,176040.27
400,2020-02-27,2020-02-27,,Credit Card Payment,910.77,0.00,175129.50
401,2020-02-27,2020-02-27,,Groceries - Online Delivery,109.74,0.00,175019.76
402,2020-02-27,2020-02-27,,Groceries - Supermarket,48.45,0.00,174971.31
403,2020-02-27,2020-02-27,,Daily Essentials,32.78,0.00,174938.53
404,2020-02-27,2020-02-27,,Groceries - Supermarket,184.24,0.00,174754.29
405,2020-02-28,2020-02-28,,ATM Withdrawal,451.58,0.00,174302.71
406,2020-02-28,2020-02-28,,Salary Credit,0.00,2288.71,176591.42
407,2020-02-28,2020-02-28,,Groceries - Supermarket,69.35,0.00,176522.07
408,2020-02-28,2020-02-28,,Online Transfer,1594.94,0.00,174927.13
409,2020-02-27,2020-02-28,,Dividend Received,0.00,139.31,175066.44
410,2020-02-28,2020-02-28,,Dining Out,86.82,0.00,174979.62
411,2020-02-28,2020-02-28,,Cash Deposit,0.00,923.88,175903.50
412,2020-02-27,2020-02-28,,Investment Returns,0.00,844.93,176748.43
413,2020-02-29,2020-02-29,,Transfer Received,0.00,591.09,177339.52
414,2020-02-29,2020-02-29,,Salary Credit,0.00,4729.72,182069.24
415,2020-02-29,2020-02-29,,Dining Out,68.07,0.00,182001.17
416,2020-03-01,2020-02-29,,Investment Returns,0.00,514.89,182516.06
417,2020-02-29,2020-02-29,,Groceries - Online Delivery,126.97,0.00,182389.09
418,2020-02-29,2020-02-29,,Online Transfer,161.36,0.00,182227.73
419,2020-03-02,2020-03-01,,Salary Credit,0.00,2572.90,184800.63
420,2020-03-01,2020-03-01,,Groceries - Supermarket,171.43,0.00,184629.20
421,2020-03-01,2020-03-01,,Online Transfer,639.34,0.00,183989.86
422,2020-03-02,2020-03-01,,Cash Deposit,0.00,149.61,184139.47
423,2020-03-01,2020-03-01,,Transfer Received,0.00,1327.45,185466.92
424,2020-03-01,2020-03-01,,Online Transfer,1428.13,0.00,184038.79
425,2020-03-01,2020-03-01,,Utility Payment,180.38,0.00,183858.41
426,2020-03-01,2020-03-01,,Salary Credit,0.00,4670.72,188529.13
427,2020-02-29,2020-03-01,,Groceries - Supermarket,173.02,0.00,188356.11
428,2020-03-01,2020-03-01,,Groceries - Online Delivery,77.34,0.00,188278.77
429,2020-03-02,2020-03-01,,Utility Payment,162.68,0.00,188116.09
430,2020-03-02,2020-03-01,,Credit Card Payment,980.24,0.00,187135.85
431,2020-03-02,2020-03-02,,Groceries - Online Delivery,64.87,0.00,187070.98
432,2020-03-02,2020-03-02,,Loan EMI,1145.29,0.00,185925.69
433,2020-03-01,2020-03-02,,Groceries - Supermarket,86.45,0.00,185839.24
434,2020-03-02,2020-03-02,,Salary Credit,0.00,4722.49,190561.73
435,2020-03-03,2020-03-03,,Transfer Received,0.00,630.31,191192.04
436,2020-03-03,2020-03-03,,Credit Card Payment,376.92,0.00,190815.12
437,2020-03-03,2020-03-03,,Takeout,29.30,0.00,190785.82
438,2020-03-03,2020-03-03,,Utility Payment,233.87,0.00,190551.95
439,2020-03-03,2020-03-03,,Transfer Received,0.00,2639.79,193191.74
440,2020-03-03,2020-03-03,,Online Transfer,1713.36,0.00,191478.38
441,2020-03-04,2020-03-04,,Transfer Received,0.00,810.35,192288.73
442,2020-03-04,2020-03-04,,Transfer Received,0.00,2783.21,195071.94
443,2020-03-04,2020-03-04,,Groceries - Supermarket,164.95,0.00,194906.99
444,2020-03-04,2020-03-04,,Transfer Received,0.00,608.81,195515.80
445,2020-03-04,2020-03-04,,Rental Income,0.00,1451.54,196967.34
446,2020-03-05,2020-03-05,,Groceries - Online Delivery,55.32,0.00,196912.02
447,2020-03-05,2020-03-05,,Transfer Received,0.00,1606.75,198518.77
448,2020-03-06,2020-03-05,,Investment - Mutual Funds,2826.76,0.00,195692.01
449,2020-03-05,2020-03-05,,Dividend Received,0.00,330.53,196022.54
450,2020-03-06,2020-03-05,,Transfer Received,0.00,1635.14,197657.68
451,2020-03-06,2020-03-06,,Salary Credit,0.00,3873.55,201531.23
452,2020-03-06,2020-03-06,,Transfer Received,0.00,901.27,202432.50
453,2020-03-06,2020-03-06,,Rental Income,0.00,1500.54,203933.04
454,2020-03-07,2020-03-06,,Investment - Stocks,4731.15,0.00,199201.89
455,2020-03-05,2020-03-06,,Interest Credited,0.00,19.08,199220.97
456,2020-03-07,2020-03-07,,Groceries - Supermarket,66.00,0.00,199154.97
457,2020-03-07,2020-03-07,,Dining Out,20.17,0.00,199134.80
458,2020-03-07,2020-03-07,,Rental Income,0.00,2774.29,201909.09
459,2020-03-07,2020-03-07,,Salary Credit,0.00,3164.39,205073.48
460,2020-03-06,2020-03-07,,Salary Credit,0.00,3177.51,208250.99
461,2020-03-07,2020-03-07,,Loan EMI,551.92,0.00,207699.07
462,2020-03-08,2020-03-08,,Transfer Received,0.00,2861.99,210561.06
463,2020-03-08,2020-03-08,,ATM Withdrawal,107.46,0.00,210453.60
464,2020-03-08,2020-03-08,,Online Transfer,1386.56,0.00,209067.04
465,2020-03-08,2020-03-08,,Groceries - Supermarket,130.59,0.00,208936.45
466,2020-03-08,2020-03-08,,Salary Credit,0.00,3993.65,212930.10
467,2020-03-08,2020-03-08,,ATM Withdrawal,60.06,0.00,212870.04
468,2020-03-08,2020-03-08,,Online Transfer,1286.06,0.00,211583.98
469,2020-03-10,2020-03-09,,Salary Credit,0.00,3184.05,214768.03
470,2020-03-10,2020-03-09,,Cash Deposit,0.00,294.02,215062.05
471,2020-03-10,2020-03-09,,Takeout,30.59,0.00,215031.46
472,2020-03-09,2020-03-09,,ATM Withdrawal,170.45,0.00,214861.01
473,2020-03-09,2020-03-09,,ATM Withdrawal,23.79,0.00,214837.22
474,2020-03-09,2020-03-09,,ATM Withdrawal,333.06,0.00,214504.16
475,2020-03-10,2020-03-10,,Groceries - Online Delivery,140.51,0.00,214363.65
476,2020-03-10,2020-03-10,,Utility Payment,294.35,0.00,214069.30
477,2020-03-10,2020-03-10,,Groceries - Supermarket,65.49,0.00,214003.81
478,2020-03-11,2020-03-11,,ATM Withdrawal,498.19,0.00,213505.62
479,2020-03-12,2020-03-11,,Groceries - Supermarket,48.27,0.00,213457.35
480,2020-03-11,2020-03-11,,Groceries - Online Delivery,104.93,0.00,213352.42
481,2020-03-11,2020-03-11,,Transfer Received,0.00,892.89,214245.31
482,2020-03-10,2020-03-11,,Transfer Received,0.00,1071.88,215317.19
483,2020-03-10,2020-03-11,,Transfer Received,0.00,1650.21,216967.40
484,2020-03-12,2020-03-11,,Groceries - Online Delivery,73.90,0.00,216893.50
485,2020-03-12,2020-03-12,100010,Cheque Issued,2537.55,0.00,214355.95
486,2020-03-13,2020-03-12,,Groceries - Supermarket,37.78,0.00,214318.17
487,2020-03-12,2020-03-12,,Dividend Received,0.00,325.16,214643.33
488,2020-03-11,2020-03-12,,Rental Income,0.00,1601.66,216244.99
489,2020-03-11,2020-03-12,,ATM Withdrawal,268.58,0.00,215976.41
490,2020-03-12,2020-03-12,,ATM Withdrawal,454.17,0.00,215522.24
491,2020-03-12,2020-03-12,,Salary Credit,0.00,3689.50,219211.74
492,2020-03-13,2020-03-12,,Credit Card Payment,768.14,0.00,218443.60
493,2020-03-12,2020-03-12,,Credit Card Payment,981.18,0.00,217462.42
494,2020-03-13,2020-03-13,,Online Transfer,1755.69,0.00,215706.73
495,2020-03-12,2020-03-13,,Online Transfer,1771.57,0.00,213935.16
496,2020-03-13,2020-03-13,,Salary Credit,0.00,4740.73,218675.89
497,2020-03-14,2020-03-13,,Transfer Received,0.00,1387.72,220063.61
498,2020-03-14,2020-03-13,,ATM Withdrawal,22.07,0.00,220041.54
499,2020-03-14,2020-03-13,,Transfer Received,0.00,1161.66,221203.20
500,2020-03-13,2020-03-13,,Transfer Received,0.00,946.36,222149.56
501,2020-03-13,2020-03-13,,Coffee Shop,5.22,0.00,222144.34
502,2020-03-14,2020-03-14,,Salary Credit,0.00,4101.41,226245.75
503,2020-03-15,2020-03-14,,Salary Credit,0.00,4521.84,230767.59
504,2020-03-13,2020-03-14,,Interest Credited,0.00,72.98,230840.57
505,2020-03-15,2020-03-14,,Investment Returns,0.00,950.04,231790.61
506,2020-03-14,2020-03-14,,Groceries - Supermarket,126.39,0.00,231664.22
507,2020-03-15,2020-03-15,,Utility Payment,88.62,0.00,231575.60
508,2020-03-16,2020-03-15,,Investment - SIP,350.02,0.00,231225.58
509,2020-03-15,2020-03-15,,Online Transfer,110.50,0.00,231115.08
510,2020-03-15,2020-03-15,,Dividend Received,0.00,229.81,231344.89
511,2020-03-15,2020-03-15,,Groceries - Supermarket,101.52,0.00,231243.37
512,2020-03-15,2020-03-16,,Dividend Received,0.00,323.08,231566.45
513,2020-03-16,2020-03-16,,Online Transfer,741.05,0.00,230825.40
514,2020-03-16,2020-03-16,,Dividend Received,0.00,452.90,231278.30
515,2020-03-16,2020-03-16,,ATM Withdrawal,32.63,0.00,231245.67
516,2020-03-16,2020-03-16,,Transfer Received,0.00,944.76,232190.43
517,2020-03-16,2020-03-16,,Investment - SIP,346.83,0.00,231843.60
518,2020-03-17,2020-03-16,,Groceries - Supermarket,199.72,0.00,231643.88
519,2020-03-16,2020-03-17,,Credit Card Payment,369.61,0.00,231274.27
520,2020-03-17,2020-03-17,100011,Cheque Issued,534.61,0.00,230739.66
521,2020-03-17,2020-03-17,,Transfer Received,0.00,2567.58,233307.24
522,2020-03-18,2020-03-17,,Daily Essentials,24.99,0.00,233282.25
523,2020-03-17,2020-03-17,,Investment - Mutual Funds,640.24,0.00,232642.01
524,2020-03-17,2020-03-17,,Salary Credit,0.00,2226.51,234868.52
525,2020-03-17,2020-03-17,,Dividend Received,0.00,328.94,235197.46
526,2020-03-18,2020-03-17,,Salary Credit,0.00,2603.11,237800.57
527,2020-03-16,2020-03-17,,Transfer Received,0.00,2770.64,240571.21
528,2020-03-17,2020-03-17,,Cash Deposit,0.00,810.21,241381.42
529,2020-03-17,2020-03-17,,Transfer Received,0.00,1307.77,242689.19
530,2020-03-17,2020-03-17,,Groceries - Supermarket,74.81,0.00,242614.38
531,2020-03-17,2020-03-17,,Investment - Mutual Funds,655.48,0.00,241958.90
532,2020-03-17,2020-03-17,,ATM Withdrawal,493.81,0.00,241465.09
533,2020-03-19,2020-03-18,,Groceries - Supermarket,68.82,0.00,241396.27
534,2020-03-17,2020-03-18,,Transfer Received,0.00,2526.43,243922.70
535,2020-03-17,2020-03-18,,Interest Credited,0.00,95.92,244018.62
536,2020-03-18,2020-03-18,,Online Transfer,1041.46,0.00,242977.16
537,2020-03-19,2020-03-18,,Daily Essentials,18.34,0.00,242958.82
538,2020-03-18,2020-03-18,,Groceries - Supermarket,126.92,0.00,242831.90
539,2020-03-17,2020-03-18,,Dividend Received,0.00,257.87,243089.77
540,2020-03-19,2020-03-19,,Credit Card Payment,795.73,0.00,242294.04
541,2020-03-19,2020-03-19,,Groceries - Supermarket,73.82,0.00,242220.22
542,2020-03-19,2020-03-19,,ATM Withdrawal,447.91,0.00,241772.31
543,2020-03-19,2020-03-19,,Transfer Received,0.00,1802.90,243575.21
544,2020-03-19,2020-03-19,,Dining Out,35.97,0.00,243539.24
545,2020-03-19,2020-03-19,,Groceries - Supermarket,112.86,0.00,243426.38
546,2020-03-20,2020-03-20,100012,Cheque Issued,2285.88,0.00,241140.50
547,2020-03-19,2020-03-20,,Investment - Mutual Funds,2124.21,0.00,239016.29
548,2020-03-20,2020-03-20,,Credit Card Payment,210.84,0.00,238805.45
549,2020-03-19,2020-03-20,,Credit Card Payment,384.51,0.00,238420.94
550,2020-03-20,2020-03-20,,Rental Income,0.00,1407.68,239828.62
551,2020-03-20,2020-03-20,,Transfer Received,0.00,1910.90,241739.52
552,2020-03-21,2020-03-20,,Interest Credited,0.00,41.42,241780.94
553,2020-03-21,2020-03-20,,Dividend Received,0.00,415.81,242196.75
554,2020-03-21,2020-03-21,,Groceries - Supermarket,94.41,0.00,242102.34
555,2020-03-21,2020-03-21,,Online Transfer,1230.51,0.00,240871.83
556,2020-03-21,2020-03-21,,Investment Returns,0.00,949.03,241820.86
557,2020-03-21,2020-03-21,,Groceries - Online Delivery,57.35,0.00,241763.51
558,2020-03-21,2020-03-21,,Loan EMI,1703.65,0.00,240059.86
559,2020-03-21,2020-03-21,,Groceries - Supermarket,146.89,0.00,239912.97
560,2020-03-22,2020-03-22,,Online Transfer,1644.96,0.00,238268.01
561,2020-03-22,2020-03-22,,Utility Payment,89.97,0.00,238178.04
562,2020-03-22,2020-03-22,,Online Transfer,1566.01,0.00,236612.03
563,2020-03-22,2020-03-22,100013,Cheque Issued,1859.27,0.00,234752.76
564,2020-03-23,2020-03-22,,ATM Withdrawal,20.07,0.00,234732.69
565,2020-03-22,2020-03-22,,Utility Payment,181.08,0.00,234551.61
566,2020-03-22,2020-03-22,,Rental Income,0.00,1691.37,236242.98
567,2020-03-23,2020-03-22,,Online Transfer,1044.02,0.00,235198.96
568,2020-03-23,2020-03-23,,Transfer Received,0.00,1581.57,236780.53
569,2020-03-23,2020-03-23,,Salary Credit,0.00,2579.81,239360.34
570,2020-03-23,2020-03-23,,Transfer Received,0.00,2057.35,241417.69
571,2020-03-23,2020-03-23,,Transfer Received,0.00,1030.35,242448.04
572,2020-03-23,2020-03-23,,Transfer Received,0.00,1302.40,243750.44
573,2020-03-22,2020-03-23,,Salary Credit,0.00,2313.54,246063.98
574,2020-03-23,2020-03-23,,Salary Credit,0.00,3147.76,249211.74
575,2020-03-23,2020-03-23,,Loan EMI,996.18,0.00,248215.56
576,2020-03-24,2020-03-24,,Salary Credit,0.00,3651.92,251867.48
577,2020-03-24,2020-03-24,,Interest Credited,0.00,21.23,251888.71
578,2020-03-25,2020-03-24,100014,Cheque Issued,952.02,0.00,250936.69
579,2020-03-24,2020-03-24,,Credit Card Payment,571.69,0.00,250365.00
580,2020-03-25,2020-03-24,,Investment - Mutual Funds,1372.20,0.00,248992.80
581,2020-03-23,2020-03-24,,Salary Credit,0.00,4088.42,253081.22
582,2020-03-24,2020-03-24,,Salary Credit,0.00,4998.17,258079.39
583,2020-03-23,2020-03-24,,Salary Credit,0.00,2617.52,260696.91
584,2020-03-25,2020-03-24,,Transfer Received,0.00,1355.11,262052.02
585,2020-03-26,2020-03-25,,Rental Income,0.00,2179.49,264231.51
586,2020-03-25,2020-03-25,,Rental Income,0.00,2688.81,266920.32
587,2020-03-25,2020-03-25,,Credit Card Payment,811.15,0.00,266109.17
588,2020-03-25,2020-03-25,,Cash Deposit,0.00,764.33,266873.50
589,2020-03-25,2020-03-25,,Salary Credit,0.00,4117.81,270991.31
590,2020-03-25,2020-03-25,,Investment - Stocks,2006.53,0.00,268984.78
591,2020-03-24,2020-03-25,,Credit Card Payment,690.83,0.00,268293.95
592,2020-03-26,2020-03-25,,Groceries - Supermarket,194.74,0.00,268099.21
593,2020-03-26,2020-03-26,,Groceries - Supermarket,156.78,0.00,267942.43
594,2020-03-26,2020-03-26,,Transfer Received,0.00,2760.57,270703.00
595,2020-03-26,2020-03-26,,ATM Withdrawal,88.41,0.00,270614.59
596,2020-03-26,2020-03-26,,Transfer Received,0.00,2396.37,273010.96
597,2020-03-26,2020-03-26,,Utility Payment,160.81,0.00,272850.15
598,2020-03-27,2020-03-27,,Utility Payment,294.90,0.00,272555.25
599,2020-03-27,2020-03-27,,Transfer Received,0.00,2282.11,274837.36
600,2020-03-26,2020-03-27,,Salary Credit,0.00,4635.59,279472.95
601,2020-03-27,2020-03-27,,ATM Withdrawal,420.07,0.00,279052.88
602,2020-03-28,2020-03-28,,Transfer Received,0.00,2895.66,281948.54
603,2020-03-29,2020-03-28,,Online Transfer,1536.03,0.00,280412.51
604,2020-03-29,2020-03-28,,Transfer Received,0.00,1342.86,281755.37
605,2020-03-29,2020-03-28,,Salary Credit,0.00,3705.14,285460.51
606,2020-03-27,2020-03-28,,Groceries - Online Delivery,68.65,0.00,285391.86
607,2020-03-30,2020-03-29,,ATM Withdrawal,293.78,0.00,285098.08
608,2020-03-30,2020-03-30,,Salary Credit,0.00,4079.16,289177.24
609,2020-03-30,2020-03-30,,Online Transfer,695.34,0.00,288481.90
610,2020-03-30,2020-03-30,,Transfer Received,0.00,2533.00,291014.90
611,2020-03-30,2020-03-30,,Loan EMI,916.60,0.00,290098.30
612,2020-03-30,2020-03-30,,Daily Essentials,47.40,0.00,290050.90
613,2020-03-31,2020-03-30,,ATM Withdrawal,284.39,0.00,289766.51
614,2020-03-30,2020-03-30,,Online Transfer,1350.06,0.00,288416.45
615,2020-03-30,2020-03-30,,Salary Credit,0.00,3447.05,291863.50
616,2020-03-31,2020-03-31,,Groceries - Online Delivery,57.52,0.00,291805.98
617,2020-03-31,2020-03-31,,Transfer Received,0.00,2652.73,294458.71
618,2020-03-30,2020-03-31,,Groceries - Supermarket,74.95,0.00,294383.76
619,2020-03-31,2020-03-31,,Dividend Received,0.00,140.82,294524.58
620,2020-03-31,2020-03-31,,Transfer Received,0.00,940.33,295464.91
621,2020-03-31,2020-03-31,,Transfer Received,0.00,1768.77,297233.68
622,2020-03-31,2020-03-31,,Credit Card Payment,992.88,0.00,296240.80
623,2020-03-30,2020-03-31,,Interest Credited,0.00,82.69,296323.49
624,2020-03-30,2020-03-31,,Groceries - Supermarket,53.74,0.00,296269.75
625,2020-03-31,2020-04-01,,Cash Deposit,0.00,818.95,297088.70
626,2020-04-01,2020-04-01,100015,Cheque Issued,2760.40,0.00,294328.30
627,2020-04-01,2020-04-01,,Interest Credited,0.00,90.45,294418.75
628,2020-04-01,2020-04-01,,Utility Payment,77.19,0.00,294341.56
629,2020-04-01,2020-04-01,,ATM Withdrawal,236.50,0.00,294105.06
630,2020-04-01,2020-04-01,,Salary Credit,0.00,3840.77,297945.83
631,2020-04-01,2020-04-01,,Cash Deposit,0.00,202.37,298148.20
632,2020-04-01,2020-04-01,,Interest Credited,0.00,45.34,298193.54
633,2020-03-31,2020-04-01,,Groceries - Supermarket,108.27,0.00,298085.27
634,2020-04-02,2020-04-02,,Investment Returns,0.00,593.15,298678.42
635,2020-04-01,2020-04-02,,Interest Credited,0.00,31.54,298709.96
636,2020-04-03,2020-04-02,,Transfer Received,0.00,2772.41,301482.37
637,2020-04-01,2020-04-02,,Takeout,34.22,0.00,301448.15
638,2020-04-02,2020-04-02,,ATM Withdrawal,434.40,0.00,301013.75
639,2020-04-02,2020-04-02,100016,Cheque Issued,1139.27,0.00,299874.48
640,2020-04-03,2020-04-03,,Investment Returns,0.00,587.82,300462.30
641,2020-04-03,2020-04-03,,Utility Payment,62.75,0.00,300399.55
642,2020-04-03,2020-04-03,,Transfer Received,0.00,672.75,301072.30
643,2020-04-03,2020-04-03,,Salary Credit,0.00,2433.80,303506.10
644,2020-04-03,2020-04-03,,Transfer Received,0.00,2020.18,305526.28
645,2020-04-03,2020-04-03,,Loan EMI,888.70,0.00,304637.58
646,2020-04-03,2020-04-03,,Utility Payment,99.03,0.00,304538.55
647,2020-04-03,2020-04-04,,ATM Withdrawal,43.06,0.00,304495.49
648,2020-04-04,2020-04-04,,Salary Credit,0.00,4669.30,309164.79
649,2020-04-04,2020-04-04,,Salary Credit,0.00,3924.40,313089.19
650,2020-04-03,2020-04-04,,Utility Payment,70.03,0.00,313019.16
651,2020-04-05,2020-04-05,,Online Transfer,1816.09,0.00,311203.07
652,2020-04-05,2020-04-05,,Transfer Received,0.00,1334.19,312537.26
653,2020-04-05,2020-04-05,,Transfer Received,0.00,1327.20,313864.46
654,2020-04-05,2020-04-05,,ATM Withdrawal,498.15,0.00,313366.31
655,2020-04-05,2020-04-05,,Utility Payment,222.43,0.00,313143.88
656,2020-04-04,2020-04-05,,Loan EMI,1823.06,0.00,311320.82
657,2020-04-05,2020-04-05,,Groceries - Supermarket,116.63,0.00,311204.19
658,2020-04-05,2020-04-05,,Groceries - Supermarket,173.08,0.00,311031.11
659,2020-04-04,2020-04-05,,Utility Payment,77.96,0.00,310953.15
660,2020-04-04,2020-04-05,100017,Cheque Issued,2688.45,0.00,308264.70
661,2020-04-06,2020-04-06,,Transfer Received,0.00,2263.54,310528.24
662,2020-04-07,2020-04-06,,Groceries - Supermarket,129.81,0.00,310398.43
663,2020-04-06,2020-04-06,,Dividend Received,0.00,400.31,310798.74
664,2020-04-06,2020-04-06,,Transfer Received,0.00,1389.44,312188.18
665,2020-04-06,2020-04-06,,Rental Income,0.00,1246.97,313435.15
666,2020-04-05,2020-04-06,,Salary Credit,0.00,2192.76,315627.91
667,2020-04-06,2020-04-06,,Groceries - Supermarket,144.15,0.00,315483.76
668,2020-04-07,2020-04-06,,Daily Essentials,5.14,0.00,315478.62
669,2020-04-08,2020-04-07,,Investment - SIP,952.36,0.00,314526.26
670,2020-04-07,2020-04-07,,Interest Credited,0.00,44.25,314570.51
671,2020-04-07,2020-04-07,,Salary Credit,0.00,4829.34,319399.85
672,2020-04-07,2020-04-07,,Groceries - Supermarket,31.81,0.00,319368.04
673,2020-04-07,2020-04-07,,Groceries - Supermarket,123.00,0.00,319245.04
674,2020-04-07,2020-04-08,,Credit Card Payment,806.18,0.00,318438.86
675,2020-04-07,2020-04-08,,Transfer Received,0.00,1947.39,320386.25
676,2020-04-09,2020-04-08,,ATM Withdrawal,468.75,0.00,319917.50
677,2020-04-09,2020-04-08,,Transfer Received,0.00,1539.54,321457.04
678,2020-04-07,2020-04-08,,Online Transfer,753.22,0.00,320703.82
679,2020-04-08,2020-04-08,100018,Cheque Issued,692.64,0.00,320011.18
680,2020-04-09,2020-04-08,,Investment - Mutual Funds,754.22,0.00,319256.96
681,2020-04-08,2020-04-08,,Salary Credit,0.00,3143.75,322400.71
682,2020-04-09,2020-04-08,,ATM Withdrawal,198.82,0.00,322201.89
683,2020-04-09,2020-04-08,,Cash Deposit,0.00,707.25,322909.14
684,2020-04-09,2020-04-09,,Groceries - Supermarket,53.68,0.00,322855.46
685,2020-04-09,2020-04-09,,Interest Credited,0.00,30.83,322886.29
686,2020-04-09,2020-04-09,,Investment - Stocks,862.56,0.00,322023.73
687,2020-04-09,2020-04-09,,Transfer Received,0.00,1033.42,323057.15
688,2020-04-09,2020-04-09,,ATM Withdrawal,78.42,0.00,322978.73
689,2020-04-10,2020-04-10,,Transfer Received,0.00,1701.61,324680.34
690,2020-04-10,2020-04-10,,Online Transfer,1857.07,0.00,322823.27
691,2020-04-10,2020-04-10,,Transfer Received,0.00,1272.53,324095.80
692,2020-04-10,2020-04-10,,Salary Credit,0.00,3660.45,327756.25
693,2020-04-10,2020-04-10,,ATM Withdrawal,451.45,0.00,327304.80
694,2020-04-11,2020-04-11,,Salary Credit,0.00,2475.97,329780.77
695,2020-04-11,2020-04-11,,Salary Credit,0.00,3745.06,333525.83
696,2020-04-11,2020-04-11,,ATM Withdrawal,450.12,0.00,333075.71
697,2020-04-11,2020-04-11,,ATM Withdrawal,413.25,0.00,332662.46
698,2020-04-12,2020-04-12,,Transfer Received,0.00,2243.86,334906.32
699,2020-04-12,2020-04-12,,Dining Out,18.12,0.00,334888.20
700,2020-04-12,2020-04-12,,Credit Card Payment,328.32,0.00,334559.88
701,2020-04-12,2020-04-12,,Utility Payment,74.84,0.00,334485.04
702,2020-04-11,2020-04-12,,Salary Credit,0.00,4977.75,339462.79
703,2020-04-12,2020-04-13,100019,Cheque Issued,2112.76,0.00,337350.03
704,2020-04-13,2020-04-13,,Investment - SIP,331.53,0.00,337018.50
705,2020-04-12,2020-04-13,,Groceries - Supermarket,99.36,0.00,336919.14
706,2020-04-13,2020-04-13,,Investment - Mutual Funds,1050.87,0.00,335868.27
707,2020-04-14,2020-04-14,,ATM Withdrawal,155.39,0.00,335712.88
708,2020-04-14,2020-04-14,,Rental Income,0.00,2558.11,338270.99
709,2020-04-14,2020-04-14,,Utility Payment,130.12,0.00,338140.87
710,2020-04-15,2020-04-14,,ATM Withdrawal,71.66,0.00,338069.21
711,2020-04-14,2020-04-14,,ATM Withdrawal,70.21,0.00,337999.00
712,2020-04-13,2020-04-14,,Credit Card Payment,978.33,0.00,337020.67
713,2020-04-15,2020-04-14,,ATM Withdrawal,304.30,0.00,336716.37
714,2020-04-14,2020-04-14,,Cash Deposit,0.00,816.74,337533.11
715,2020-04-14,2020-04-14,,Takeout,40.98,0.00,337492.13
716,2020-04-15,2020-04-15,,Salary Credit,0.00,3625.17,341117.30
717,2020-04-15,2020-04-15,,ATM Withdrawal,421.06,0.00,340696.24
718,2020-04-14,2020-04-15,,Online Transfer,1109.09,0.00,339587.15
719,2020-04-15,2020-04-15,,Groceries - Supermarket,51.59,0.00,339535.56
720,2020-04-16,2020-04-16,,Daily Essentials,20.38,0.00,339515.18
721,2020-04-17,2020-04-16,,Groceries - Supermarket,23.41,0.00,339491.77
722,2020-04-17,2020-04-16,,Salary Credit,0.00,4988.31,344480.08
723,2020-04-17,2020-04-16,,ATM Withdrawal,420.91,0.00,344059.17
724,2020-04-17,2020-04-16,,Credit Card Payment,942.55,0.00,343116.62
725,2020-04-17,2020-04-16,,Online Transfer,322.75,0.00,342793.87
726,2020-04-17,2020-04-17,,Credit Card Payment,661.28,0.00,342132.59
727,2020-04-17,2020-04-17,,Loan EMI,1223.25,0.00,340909.34
728,2020-04-17,2020-04-17,,Salary Credit,0.00,3080.80,343990.14
729,2020-04-17,2020-04-17,,Salary Credit,0.00,3874.97,347865.11
730,2020-04-16,2020-04-17,,Groceries - Online Delivery,144.34,0.00,347720.77
731,2020-04-17,2020-04-18,,Interest Credited,0.00,24.19,347744.96
732,2020-04-17,2020-04-18,,Transfer Received,0.00,1866.91,349611.87
733,2020-04-18,2020-04-18,,ATM Withdrawal,333.61,0.00,349278.26
734,2020-04-18,2020-04-18,,Loan EMI,1714.64,0.00,347563.62
735,2020-04-18,2020-04-18,,Utility Payment,155.37,0.00,347408.25
736,2020-04-18,2020-04-18,,Transfer Received,0.00,1388.85,348797.10
737,2020-04-18,2020-04-18,,Investment - SIP,299.25,0.00,348497.85
738,2020-04-18,2020-04-18,,Transfer Received,0.00,1212.06,349709.91
739,2020-04-18,2020-04-18,,Transfer Received,0.00,518.25,350228.16
740,2020-04-19,2020-04-19,,Salary Credit,0.00,2129.06,352357.22
741,2020-04-19,2020-04-19,,Transfer Received,0.00,2977.70,355334.92
742,2020-04-19,2020-04-19,,ATM Withdrawal,267.37,0.00,355067.55
743,2020-04-19,2020-04-19,,Interest Credited,0.00,93.78,355161.33
744,2020-04-20,2020-04-19,,Takeout,11.36,0.00,355149.97
745,2020-04-19,2020-04-19,,Utility Payment,145.01,0.00,355004.96
746,2020-04-20,2020-04-19,,Transfer Received,0.00,1962.55,356967.51
747,2020-04-19,2020-04-19,,Interest Credited,0.00,55.24,357022.75
748,2020-04-19,2020-04-19,,Groceries - Supermarket,81.64,0.00,356941.11
749,2020-04-20,2020-04-20,,Salary Credit,0.00,3313.01,360254.12
750,2020-04-20,2020-04-20,,Groceries - Supermarket,106.61,0.00,360147.51
751,2020-04-21,2020-04-20,,Utility Payment,87.49,0.00,360060.02
752,2020-04-21,2020-04-20,,Groceries - Supermarket,96.33,0.00,359963.69
753,2020-04-19,2020-04-20,,Investment - SIP,962.78,0.00,359000.91
754,2020-04-21,2020-04-21,,Investment - Mutual Funds,1728.32,0.00,357272.59
755,2020-04-21,2020-04-21,,ATM Withdrawal,197.02,0.00,357075.57
756,2020-04-20,2020-04-21,,Coffee Shop,5.61,0.00,357069.96
757,2020-04-21,2020-04-21,,Online Transfer,479.72,0.00,356590.24
758,2020-04-23,2020-04-22,,Dividend Received,0.00,247.12,356837.36
759,2020-04-21,2020-04-22,,Credit Card Payment,957.51,0.00,355879.85
760,2020-04-22,2020-04-22,,Salary Credit,0.00,3246.50,359126.35
761,2020-04-22,2020-04-22,,Salary Credit,0.00,4745.52,363871.87
762,2020-04-22,2020-04-22,,Credit Card Payment,614.24,0.00,363257.63
763,2020-04-22,2020-04-22,,ATM Withdrawal,149.86,0.00,363107.77
764,2020-04-22,2020-04-23,,Transfer Received,0.00,2284.81,365392.58
765,2020-04-23,2020-04-23,,ATM Withdrawal,335.11,0.00,365057.47
766,2020-04-23,2020-04-23,,Credit Card Payment,203.90,0.00,364853.57
767,2020-04-23,2020-04-23,,ATM Withdrawal,314.06,0.00,364539.51
768,2020-04-23,2020-04-23,,Takeout,39.96,0.00,364499.55
769,2020-04-24,2020-04-24,,Online Transfer,1470.50,0.00,363029.05
770,2020-04-24,2020-04-24,,Utility Payment,83.99,0.00,362945.06
771,2020-04-25,2020-04-24,,Salary Credit,0.00,3477.16,366422.22
772,2020-04-23,2020-04-24,100020,Cheque Issued,880.24,0.00,365541.98
773,2020-04-24,2020-04-24,,Groceries - Supermarket,57.07,0.00,365484.91
774,2020-04-24,2020-04-25,,Investment - Mutual Funds,547.22,0.00,364937.69
775,2020-04-25,2020-04-25,,ATM Withdrawal,41.58,0.00,364896.11
776,2020-04-25,2020-04-25,,Dining Out,62.29,0.00,364833.82
777,2020-04-24,2020-04-25,,Credit Card Payment,634.02,0.00,364199.80
778,2020-04-24,2020-04-25,,Online Transfer,117.49,0.00,364082.31
779,2020-04-25,2020-04-25,,Groceries - Supermarket,194.40,0.00,363887.91
780,2020-04-24,2020-04-25,,Groceries - Online Delivery,106.31,0.00,363781.60
781,2020-04-26,2020-04-26,,Online Transfer,1422.70,0.00,362358.90
782,2020-04-27,2020-04-26,,Daily Essentials,24.64,0.00,362334.26
783,2020-04-26,2020-04-26,,Salary Credit,0.00,2246.25,364580.51
784,2020-04-26,2020-04-26,,Utility Payment,297.48,0.00,364283.03
785,2020-04-27,2020-04-27,100021,Cheque Issued,2881.53,0.00,361401.50
786,2020-04-27,2020-04-27,,Online Transfer,1778.14,0.00,359623.36
787,2020-04-28,2020-04-27,,Cash Deposit,0.00,227.10,359850.46
788,2020-04-27,2020-04-27,,Daily Essentials,22.35,0.00,359828.11
789,2020-04-27,2020-04-27,,Salary Credit,0.00,3180.95,363009.06
790,2020-04-27,2020-04-27,,Groceries - Supermarket,27.92,0.00,362981.14
791,2020-04-27,2020-04-28,,Utility Payment,74.13,0.00,362907.01
792,2020-04-29,2020-04-28,,Transfer Received,0.00,2214.30,365121.31
793,2020-04-28,2020-04-28,,Rental Income,0.00,2353.15,367474.46
794,2020-04-28,2020-04-28,,Salary Credit,0.00,2146.25,369620.71
795,2020-04-29,2020-04-28,,Utility Payment,283.29,0.00,369337.42
796,2020-04-28,2020-04-28,,Transfer Received,0.00,1136.73,370474.15
797,2020-04-27,2020-04-28,,Groceries - Supermarket,99.87,0.00,370374.28
798,2020-04-27,2020-04-28,,Dining Out,49.94,0.00,370324.34
799,2020-04-28,2020-04-28,,Rental Income,0.00,2127.67,372452.01
800,2020-04-28,2020-04-28,,Transfer Received,0.00,2373.00,374825.01
801,2020-04-28,2020-04-28,,Transfer Received,0.00,1935.98,376760.99
802,2020-04-30,2020-04-29,,Credit Card Payment,590.63,0.00,376170.36
803,2020-04-29,2020-04-29,,Groceries - Supermarket,177.13,0.00,375993.23
804,2020-04-29,2020-04-29,,Online Transfer,1887.74,0.00,374105.49
805,2020-04-30,2020-04-30,,Utility Payment,289.80,0.00,373815.69
806,2020-04-30,2020-04-30,,Credit Card Payment,908.60,0.00,372907.09
807,2020-04-30,2020-04-30,,ATM Withdrawal,162.72,0.00,372744.37
808,2020-04-30,2020-04-30,,Transfer Received,0.00,2509.93,375254.30
809,2020-05-01,2020-04-30,,Groceries - Supermarket,169.75,0.00,375084.55
810,2020-04-30,2020-04-30,,Transfer Received,0.00,2691.88,377776.43
811,2020-04-30,2020-04-30,,ATM Withdrawal,121.51,0.00,377654.92
812,2020-04-30,2020-04-30,,Loan EMI,1040.37,0.00,376614.55
813,2020-05-01,2020-05-01,,Transfer Received,0.00,648.18,377262.73
814,2020-05-01,2020-05-01,,Online Transfer,1012.92,0.00,376249.81
815,2020-05-01,2020-05-01,,Transfer Received,0.00,2973.33,379223.14
816,2020-05-01,2020-05-01,,Utility Payment,221.59,0.00,379001.55
817,2020-05-02,2020-05-01,,Salary Credit,0.00,3275.32,382276.87
818,2020-05-01,2020-05-01,,Transfer Received,0.00,2215.69,384492.56
819,2020-05-01,2020-05-01,,ATM Withdrawal,400.99,0.00,384091.57
820,2020-05-02,2020-05-01,,Investment - Mutual Funds,612.39,0.00,383479.18
821,2020-05-02,2020-05-02,,Online Transfer,1968.33,0.00,381510.85
822,2020-05-01,2020-05-02,,Dining Out,62.40,0.00,381448.45
823,2020-05-03,2020-05-02,,Transfer Received,0.00,2611.51,384059.96
824,2020-05-03,2020-05-02,,Salary Credit,0.00,4162.02,388221.98
825,2020-05-03,2020-05-02,,Groceries - Supermarket,44.73,0.00,388177.25
826,2020-05-03,2020-05-02,,Groceries - Supermarket,186.25,0.00,387991.00
827,2020-05-03,2020-05-03,,ATM Withdrawal,138.98,0.00,387852.02
828,2020-05-03,2020-05-03,,Salary Credit,0.00,2441.08,390293.10
829,2020-05-03,2020-05-03,,Rental Income,0.00,1521.89,391814.99
830,2020-05-03,2020-05-03,,Transfer Received,0.00,1817.49,393632.48
831,2020-05-02,2020-05-03,,Rental Income,0.00,2786.29,396418.77
832,2020-05-03,2020-05-03,,Credit Card Payment,573.28,0.00,395845.49
833,2020-05-02,2020-05-03,,Utility Payment,161.26,0.00,395684.23
834,2020-05-02,2020-05-03,,Dining Out,32.38,0.00,395651.85
835,2020-05-04,2020-05-03,,Transfer Received,0.00,2394.47,398046.32
836,2020-05-03,2020-05-03,,ATM Withdrawal,147.30,0.00,397899.02
837,2020-05-03,2020-05-03,,ATM Withdrawal,163.48,0.00,397735.54
838,2020-05-02,2020-05-03,,Takeout,14.64,0.00,397720.90
839,2020-05-03,2020-05-03,,Utility Payment,222.60,0.00,397498.30
840,2020-05-04,2020-05-04,,Transfer Received,0.00,1213.20,398711.50
841,2020-05-04,2020-05-04,,Credit Card Payment,910.11,0.00,397801.39
842,2020-05-04,2020-05-04,,Utility Payment,229.55,0.00,397571.84
843,2020-05-04,2020-05-04,,Transfer Received,0.00,1967.60,399539.44
844,2020-05-04,2020-05-04,,Groceries - Supermarket,87.44,0.00,399452.00
845,2020-05-05,2020-05-04,100022,Cheque Issued,2753.73,0.00,396698.27
846,2020-05-04,2020-05-04,,Transfer Received,0.00,1328.45,398026.72
847,2020-05-04,2020-05-04,,Utility Payment,71.43,0.00,397955.29
848,2020-05-04,2020-05-04,,Investment Returns,0.00,836.49,398791.78
849,2020-05-03,2020-05-04,,Transfer Received,0.00,864.63,399656.41
850,2020-05-05,2020-05-05,,Online Transfer,1232.99,0.00,398423.42
851,2020-05-06,2020-05-05,,Interest Credited,0.00,73.24,398496.66
852,2020-05-05,2020-05-05,,ATM Withdrawal,380.70,0.00,398115.96
853,2020-05-06,2020-05-06,,Online Transfer,353.26,0.00,397762.70
854,2020-05-06,2020-05-06,,Cash Deposit,0.00,244.39,398007.09
855,2020-05-05,2020-05-06,,Online Transfer,1124.51,0.00,396882.58
856,2020-05-07,2020-05-06,,Transfer Received,0.00,1672.08,398554.66
857,2020-05-06,2020-05-06,,Investment - SIP,671.39,0.00,397883.27
858,2020-05-06,2020-05-06,,ATM Withdrawal,203.97,0.00,397679.30
859,2020-05-07,2020-05-07,,Groceries - Online Delivery,115.44,0.00,397563.86
860,2020-05-07,2020-05-07,,ATM Withdrawal,251.57,0.00,397312.29
861,2020-05-07,2020-05-07,,ATM Withdrawal,374.63,0.00,396937.66
862,2020-05-06,2020-05-07,,Interest Credited,0.00,79.27,397016.93
863,2020-05-07,2020-05-07,,Online Transfer,576.35,0.00,396440.58
864,2020-05-07,2020-05-07,,ATM Withdrawal,25.42,0.00,396415.16
865,2020-05-07,2020-05-07,,Utility Payment,269.04,0.00,396146.12
866,2020-05-07,2020-05-07,,ATM Withdrawal,493.82,0.00,395652.30
867,2020-05-08,2020-05-08,,Dividend Received,0.00,218.04,395870.34
868,2020-05-07,2020-05-08,,Online Transfer,886.62,0.00,394983.72
869,2020-05-08,2020-05-08,,ATM Withdrawal,147.36,0.00,394836.36
870,2020-05-08,2020-05-08,,Salary Credit,0.00,2841.68,397678.04
871,2020-05-07,2020-05-08,100023,Cheque Issued,1383.06,0.00,396294.98
872,2020-05-09,2020-05-09,,Salary Credit,0.00,4593.87,400888.85
873,2020-05-09,2020-05-09,,Investment - SIP,386.93,0.00,400501.92
874,2020-05-08,2020-05-09,,Loan EMI,1225.09,0.00,399276.83
875,2020-05-09,2020-05-09,,Groceries - Online Delivery,114.48,0.00,399162.35
876,2020-05-10,2020-05-09,,Cash Deposit,0.00,703.90,399866.25
877,2020-05-10,2020-05-10,,Dining Out,71.10,0.00,399795.15
878,2020-05-09,2020-05-10,,Salary Credit,0.00,2894.65,402689.80
879,2020-05-11,2020-05-10,,Salary Credit,0.00,2670.63,405360.43
880,2020-05-10,2020-05-10,,Transfer Received,0.00,1183.92,406544.35
881,2020-05-10,2020-05-10,,Transfer Received,0.00,2823.91,409368.26
882,2020-05-10,2020-05-11,,Transfer Received,0.00,2235.36,411603.62
883,2020-05-11,2020-05-11,,ATM Withdrawal,300.84,0.00,411302.78
884,2020-05-12,2020-05-11,,Investment Returns,0.00,284.36,411587.14
885,2020-05-10,2020-05-11,,Dining Out,60.29,0.00,411526.85
886,2020-05-12,2020-05-11,,Online Transfer,1877.68,0.00,409649.17
887,2020-05-10,2020-05-11,,Takeout,49.58,0.00,409599.59
888,2020-05-11,2020-05-11,,Salary Credit,0.00,3060.97,412660.56
889,2020-05-12,2020-05-11,,Groceries - Supermarket,24.78,0.00,412635.78
890,2020-05-11,2020-05-11,,Utility Payment,245.33,0.00,412390.45
891,2020-05-12,2020-05-12,,Credit Card Payment,492.66,0.00,411897.79
892,2020-05-12,2020-05-12,,Credit Card Payment,950.64,0.00,410947.15
893,2020-05-12,2020-05-12,,Transfer Received,0.00,1483.35,412430.50
894,2020-05-12,2020-05-12,,Online Transfer,390.98,0.00,412039.52
895,2020-05-12,2020-05-12,,Investment - Mutual Funds,403.14,0.00,411636.38
896,2020-05-12,2020-05-12,,Interest Credited,0.00,59.82,411696.20
897,2020-05-13,2020-05-13,,Groceries - Supermarket,106.88,0.00,411589.32
898,2020-05-13,2020-05-13,,Online Transfer,1147.29,0.00,410442.03
899,2020-05-13,2020-05-13,,Transfer Received,0.00,728.62,411170.65
900,2020-05-13,2020-05-13,,Credit Card Payment,873.84,0.00,410296.81
901,2020-05-12,2020-05-13,,ATM Withdrawal,224.97,0.00,410071.84
902,2020-05-13,2020-05-13,,Cash Deposit,0.00,587.45,410659.29
903,2020-05-13,2020-05-13,,Groceries - Online Delivery,140.46,0.00,410518.83
904,2020-05-13,2020-05-13,,Salary Credit,0.00,3472.79,413991.62
905,2020-05-13,2020-05-13,,Salary Credit,0.00,3987.13,417978.75
906,2020-05-13,2020-05-13,,Investment Returns,0.00,50.53,418029.28
907,2020-05-14,2020-05-14,,Credit Card Payment,553.13,0.00,417476.15
908,2020-05-14,2020-05-14,,Investment Returns,0.00,122.77,417598.92
909,2020-05-14,2020-05-14,,Transfer Received,0.00,2843.82,420442.74
910,2020-05-16,2020-05-15,,Online Transfer,939.00,0.00,419503.74
911,2020-05-15,2020-05-15,,Dividend Received,0.00,490.82,419994.56
912,2020-05-14,2020-05-15,,Salary Credit,0.00,3199.33,423193.89
913,2020-05-15,2020-05-15,,Interest Credited,0.00,13.01,423206.90
914,2020-05-15,2020-05-15,,Interest Credited,0.00,49.63,423256.53
915,2020-05-16,2020-05-15,,Investment Returns,0.00,699.49,423956.02
916,2020-05-16,2020-05-15,,Online Transfer,1659.72,0.00,422296.30
917,2020-05-15,2020-05-15,,ATM Withdrawal,254.30,0.00,422042.00
918,2020-05-14,2020-05-15,,Dividend Received,0.00,373.64,422415.64
919,2020-05-15,2020-05-15,,ATM Withdrawal,48.92,0.00,422366.72
920,2020-05-14,2020-05-15,,Investment Returns,0.00,940.23,423306.95
921,2020-05-15,2020-05-16,,Investment - SIP,814.89,0.00,422492.06
922,2020-05-16,2020-05-16,,Investment - SIP,954.04,0.00,421538.02
923,2020-05-17,2020-05-16,,Groceries - Supermarket,142.61,0.00,421395.41
924,2020-05-16,2020-05-16,,Takeout,48.79,0.00,421346.62
925,2020-05-16,2020-05-16,,Transfer Received,0.00,2419.45,423766.07
926,2020-05-16,2020-05-16,,Credit Card Payment,999.81,0.00,422766.26
927,2020-05-16,2020-05-16,,Transfer Received,0.00,2361.54,425127.80
928,2020-05-16,2020-05-16,,Dividend Received,0.00,183.63,425311.43
929,2020-05-17,2020-05-16,,Credit Card Payment,325.51,0.00,424985.92
930,2020-05-17,2020-05-17,,Takeout,11.92,0.00,424974.00
931,2020-05-17,2020-05-17,,Groceries - Supermarket,109.00,0.00,424865.00
932,2020-05-17,2020-05-17,,Credit Card Payment,737.66,0.00,424127.34
933,2020-05-17,2020-05-17,,Online Transfer,164.94,0.00,423962.40
934,2020-05-16,2020-05-17,,Daily Essentials,28.80,0.00,423933.60
935,2020-05-19,2020-05-18,,Groceries - Supermarket,105.83,0.00,423827.77
936,2020-05-18,2020-05-18,,Online Transfer,1506.86,0.00,422320.91
937,2020-05-18,2020-05-18,,Salary Credit,0.00,2043.20,424364.11
938,2020-05-18,2020-05-18,,Salary Credit,0.00,2354.16,426718.27
939,2020-05-17,2020-05-18,,Salary Credit,0.00,3591.08,430309.35
940,2020-05-19,2020-05-19,,ATM Withdrawal,32.66,0.00,430276.69
941,2020-05-19,2020-05-19,,Groceries - Supermarket,151.16,0.00,430125.53
942,2020-05-19,2020-05-19,,Credit Card Payment,512.92,0.00,429612.61
943,2020-05-20,2020-05-19,,Transfer Received,0.00,692.21,430304.82
944,2020-05-19,2020-05-19,,ATM Withdrawal,397.95,0.00,429906.87
945,2020-05-18,2020-05-19,100024,Cheque Issued,1583.60,0.00,428323.27
946,2020-05-19,2020-05-19,,Utility Payment,199.39,0.00,428123.88
947,2020-05-20,2020-05-19,,Salary Credit,0.00,2976.00,431099.88
948,2020-05-19,2020-05-19,,Online Transfer,1172.99,0.00,429926.89
949,2020-05-20,2020-05-20,,Credit Card Payment,496.11,0.00,429430.78
950,2020-05-21,2020-05-20,,Transfer Received,0.00,2515.47,431946.25
951,2020-05-20,2020-05-20,,Coffee Shop,18.41,0.00,431927.84
952,2020-05-21,2020-05-20,,ATM Withdrawal,376.84,0.00,431551.00
953,2020-05-20,2020-05-20,,Salary Credit,0.00,3101.03,434652.03
954,2020-05-21,2020-05-20,,Transfer Received,0.00,2907.51,437559.54
955,2020-05-21,2020-05-21,,Transfer Received,0.00,2861.22,440420.76
956,2020-05-21,2020-05-21,,Online Transfer,1219.64,0.00,439201.12
957,2020-05-21,2020-05-21,,Transfer Received,0.00,2782.37,441983.49
958,2020-05-20,2020-05-21,,Utility Payment,250.79,0.00,441732.70
959,2020-05-21,2020-05-21,,ATM Withdrawal,245.55,0.00,441487.15
960,2020-05-21,2020-05-21,,Utility Payment,71.01,0.00,441416.14
961,2020-05-22,2020-05-22,,Transfer Received,0.00,1369.41,442785.55
962,2020-05-22,2020-05-22,,ATM Withdrawal,453.28,0.00,442332.27
963,2020-05-22,2020-05-22,,Salary Credit,0.00,4289.10,446621.37
964,2020-05-22,2020-05-22,,Transfer Received,0.00,704.75,447326.12
965,2020-05-21,2020-05-22,,Groceries - Supermarket,43.96,0.00,447282.16
966,2020-05-22,2020-05-22,,Utility Payment,58.52,0.00,447223.64
967,2020-05-22,2020-05-22,,ATM Withdrawal,174.86,0.00,447048.78
968,2020-05-22,2020-05-22,,Transfer Received,0.00,2110.70,449159.48
969,2020-05-22,2020-05-22,,ATM Withdrawal,463.01,0.00,448696.47
970,2020-05-22,2020-05-22,,Transfer Received,0.00,2150.27,450846.74
971,2020-05-23,2020-05-23,,Groceries - Online Delivery,83.65,0.00,450763.09
972,2020-05-23,2020-05-23,,Transfer Received,0.00,744.16,451507.25
973,2020-05-22,2020-05-23,,Salary Credit,0.00,3572.39,455079.64
974,2020-05-23,2020-05-23,,Transfer Received,0.00,1919.52,456999.16
975,2020-05-22,2020-05-23,,Interest Credited,0.00,43.19,457042.35
976,2020-05-23,2020-05-23,,Transfer Received,0.00,790.61,457832.96
977,2020-05-24,2020-05-23,,Groceries - Supermarket,90.15,0.00,457742.81
978,2020-05-24,2020-05-24,,Online Transfer,224.22,0.00,457518.59
979,2020-05-24,2020-05-24,,Credit Card Payment,764.63,0.00,456753.96
980,2020-05-24,2020-05-24,,Salary Credit,0.00,3186.82,459940.78
981,2020-05-25,2020-05-24,,Investment - Mutual Funds,1232.32,0.00,458708.46
982,2020-05-24,2020-05-24,,Online Transfer,1429.41,0.00,457279.05
983,2020-05-24,2020-05-24,,ATM Withdrawal,101.81,0.00,457177.24
984,2020-05-24,2020-05-24,,Utility Payment,214.68,0.00,456962.56
985,2020-05-26,2020-05-25,100025,Cheque Issued,1665.48,0.00,455297.08
986,2020-05-25,2020-05-25,,Transfer Received,0.00,852.60,456149.68
987,2020-05-25,2020-05-25,,Utility Payment,133.24,0.00,456016.44
988,2020-05-25,2020-05-25,,ATM Withdrawal,380.90,0.00,455635.54
989,2020-05-24,2020-05-25,,Takeout,42.27,0.00,455593.27
990,2020-05-26,2020-05-25,,Online Transfer,290.46,0.00,455302.81
991,2020-05-25,2020-05-25,,Salary Credit,0.00,4208.37,459511.18
992,2020-05-25,2020-05-25,,Investment - Mutual Funds,706.79,0.00,458804.39
993,2020-05-24,2020-05-25,,Transfer Received,0.00,1362.06,460166.45
994,2020-05-26,2020-05-26,,Dining Out,17.22,0.00,460149.23
995,2020-05-26,2020-05-26,,Online Transfer,1246.36,0.00,458902.87
996,2020-05-26,2020-05-26,,Transfer Received,0.00,2355.99,461258.86
997,2020-05-27,2020-05-26,,Salary Credit,0.00,4546.69,465805.55
998,2020-05-26,2020-05-26,,Online Transfer,1432.90,0.00,464372.65
999,2020-05-27,2020-05-27,,Credit Card Payment,677.36,0.00,463695.29
1000,2020-05-27,2020-05-27,,ATM Withdrawal,496.20,0.00,463199.09
1001,2020-05-27,2020-05-27,,Credit Card Payment,902.80,0.00,462296.29
1002,2020-05-28,2020-05-28,,Salary Credit,0.00,3757.04,466053.33
1003,2020-05-28,2020-05-28,,ATM Withdrawal,343.50,0.00,465709.83
1004,2020-05-27,2020-05-28,,Interest Credited,0.00,22.88,465732.71
1005,2020-05-29,2020-05-28,,Credit Card Payment,541.22,0.00,465191.49
1006,2020-05-28,2020-05-28,,Interest Credited,0.00,84.01,465275.50
1007,2020-05-28,2020-05-28,,Credit Card Payment,500.45,0.00,464775.05
1008,2020-05-29,2020-05-29,,Rental Income,0.00,2921.63,467696.68
1009,2020-05-29,2020-05-29,,Cash Deposit,0.00,373.49,468070.17
1010,2020-05-29,2020-05-29,,Daily Essentials,6.69,0.00,468063.48
1011,2020-05-29,2020-05-29,,ATM Withdrawal,44.70,0.00,468018.78
1012,2020-05-28,2020-05-29,,Transfer Received,0.00,755.04,468773.82
1013,2020-05-29,2020-05-29,,Online Transfer,1261.96,0.00,467511.86
1014,2020-05-30,2020-05-30,,Groceries - Supermarket,85.65,0.00,467426.21
1015,2020-05-30,2020-05-30,,Takeout,13.98,0.00,467412.23
1016,2020-05-30,2020-05-30,,Transfer Received,0.00,1411.07,468823.30
1017,2020-05-30,2020-05-30,,Transfer Received,0.00,2948.09,471771.39
1018,2020-05-30,2020-05-30,,ATM Withdrawal,427.83,0.00,471343.56
1019,2020-05-29,2020-05-30,,Salary Credit,0.00,3057.25,474400.81
1020,2020-05-30,2020-05-30,,Online Transfer,1314.81,0.00,473086.00
1021,2020-05-31,2020-05-31,,Groceries - Supermarket,135.93,0.00,472950.07
1022,2020-05-31,2020-05-31,,Transfer Received,0.00,2195.63,475145.70
1023,2020-05-31,2020-05-31,,Online Transfer,1175.04,0.00,473970.66
1024,2020-05-31,2020-05-31,,Groceries - Online Delivery,102.68,0.00,473867.98
1025,2020-05-31,2020-05-31,100026,Cheque Issued,771.25,0.00,473096.73
1026,2020-05-31,2020-05-31,,Utility Payment,283.06,0.00,472813.67
1027,2020-06-01,2020-05-31,,Salary Credit,0.00,2112.51,474926.18
1028,2020-06-01,2020-05-31,,Credit Card Payment,548.32,0.00,474377.86
1029,2020-05-30,2020-05-31,,Groceries - Supermarket,173.62,0.00,474204.24
1030,2020-05-30,2020-05-31,,Salary Credit,0.00,4078.82,478283.06
1031,2020-05-31,2020-05-31,,Salary Credit,0.00,4939.89,483222.95
1032,2020-05-31,2020-05-31,,Investment - Stocks,3405.19,0.00,479817.76
1033,2020-05-31,2020-05-31,,Rental Income,0.00,2194.90,482012.66
1034,2020-05-31,2020-05-31,,Transfer Received,0.00,923.26,482935.92
1035,2020-06-01,2020-05-31,,Loan EMI,1332.69,0.00,481603.23
1036,2020-05-31,2020-06-01,,ATM Withdrawal,216.92,0.00,481386.31
1037,2020-06-01,2020-06-01,,ATM Withdrawal,97.66,0.00,481288.65
1038,2020-06-01,2020-06-01,,Salary Credit,0.00,4833.23,486121.88
1039,2020-06-01,2020-06-01,,Transfer Received,0.00,1385.99,487507.87
1040,2020-06-01,2020-06-01,,Credit Card Payment,647.95,0.00,486859.92
1041,2020-06-01,2020-06-01,,Groceries - Supermarket,62.51,0.00,486797.41
1042,2020-05-31,2020-06-01,,Dining Out,86.99,0.00,486710.42
1043,2020-06-02,2020-06-01,,ATM Withdrawal,251.14,0.00,486459.28
1044,2020-06-01,2020-06-01,,Groceries - Online Delivery,144.69,0.00,486314.59
1045,2020-06-02,2020-06-02,,Rental Income,0.00,1887.87,488202.46
1046,2020-06-03,2020-06-02,,Dining Out,28.60,0.00,488173.86
1047,2020-06-02,2020-06-02,,Groceries - Supermarket,91.68,0.00,488082.18
1048,2020-06-03,2020-06-02,,Transfer Received,0.00,1090.32,489172.50
1049,2020-06-02,2020-06-02,,Transfer Received,0.00,2245.31,491417.81
1050,2020-06-03,2020-06-02,,Transfer Received,0.00,1174.09,492591.90
1051,2020-06-03,2020-06-03,,Salary Credit,0.00,4172.91,496764.81
1052,2020-06-03,2020-06-03,,Salary Credit,0.00,4715.56,501480.37
1053,2020-06-02,2020-06-03,,Salary Credit,0.00,2854.37,504334.74
1054,2020-06-02,2020-06-03,,Transfer Received,0.00,1445.84,505780.58
1055,2020-06-03,2020-06-03,,Salary Credit,0.00,2924.55,508705.13
1056,2020-06-03,2020-06-03,,Utility Payment,281.44,0.00,508423.69
1057,2020-06-03,2020-06-03,,Credit Card Payment,231.25,0.00,508192.44
1058,2020-06-04,2020-06-03,,ATM Withdrawal,401.95,0.00,507790.49
1059,2020-06-04,2020-06-04,,Rental Income,0.00,1471.39,509261.88
1060,2020-06-04,2020-06-04,,Daily Essentials,29.80,0.00,509232.08
1061,2020-06-05,2020-06-04,,Credit Card Payment,492.49,0.00,508739.59
1062,2020-06-05,2020-06-05,,Investment - Mutual Funds,1677.74,0.00,507061.85
1063,2020-06-05,2020-06-05,,Transfer Received,0.00,1973.27,509035.12
1064,2020-06-04,2020-06-05,,Dining Out,89.08,0.00,508946.04
1065,2020-06-05,2020-06-05,,Credit Card Payment,864.98,0.00,508081.06
1066,2020-06-05,2020-06-05,,Daily Essentials,6.20,0.00,508074.86
1067,2020-06-06,2020-06-05,,Transfer Received,0.00,1047.88,509122.74
1068,2020-06-06,2020-06-05,,Salary Credit,0.00,2768.27,511891.01
1069,2020-06-06,2020-06-06,,Rental Income,0.00,1137.72,513028.73
1070,2020-06-06,2020-06-06,,ATM Withdrawal,408.51,0.00,512620.22
1071,2020-06-06,2020-06-06,,Transfer Received,0.00,2398.44,515018.66
1072,2020-06-06,2020-06-06,,ATM Withdrawal,157.20,0.00,514861.46
1073,2020-06-06,2020-06-06,,Groceries - Online Delivery,118.47,0.00,514742.99
1074,2020-06-05,2020-06-06,,Transfer Received,0.00,1329.72,516072.71
1075,2020-06-08,2020-06-07,,Groceries - Online Delivery,75.90,0.00,515996.81
1076,2020-06-07,2020-06-07,,Transfer Received,0.00,2259.49,518256.30
1077,2020-06-07,2020-06-07,,Transfer Received,0.00,1698.56,519954.86
1078,2020-06-06,2020-06-07,,Transfer Received,0.00,2411.73,522366.59
1079,2020-06-07,2020-06-07,,Transfer Received,0.00,2111.72,524478.31
1080,2020-06-07,2020-06-07,,ATM Withdrawal,217.51,0.00,524260.80
1081,2020-06-06,2020-06-07,,Groceries - Supermarket,44.24,0.00,524216.56
1082,2020-06-08,2020-06-08,,Salary Credit,0.00,4855.48,529072.04
1083,2020-06-08,2020-06-08,,Online Transfer,1294.11,0.00,527777.93
1084,2020-06-08,2020-06-08,,Transfer Received,0.00,2534.63,530312.56
1085,2020-06-08,2020-06-08,,Credit Card Payment,495.14,0.00,529817.42
1086,2020-06-08,2020-06-08,,Credit Card Payment,562.33,0.00,529255.09
1087,2020-06-08,2020-06-08,,Transfer Received,0.00,605.65,529860.74
1088,2020-06-09,2020-06-08,,Groceries - Supermarket,38.48,0.00,529822.26
1089,2020-06-08,2020-06-08,,Credit Card Payment,554.93,0.00,529267.33
1090,2020-06-09,2020-06-09,,Salary Credit,0.00,4343.73,533611.06
1091,2020-06-09,2020-06-09,,Credit Card Payment,916.90,0.00,532694.16
1092,2020-06-09,2020-06-09,,Transfer Received,0.00,669.19,533363.35
1093,2020-06-09,2020-06-09,,Transfer Received,0.00,1578.35,534941.70
1094,2020-06-09,2020-06-09,,Salary Credit,0.00,4772.49,539714.19
1095,2020-06-09,2020-06-09,,Interest Credited,0.00,42.01,539756.20
1096,2020-06-09,2020-06-09,,Rental Income,0.00,2926.72,542682.92
1097,2020-06-09,2020-06-09,,Salary Credit,0.00,2044.89,544727.81
1098,2020-06-09,2020-06-09,,Transfer Received,0.00,1169.52,545897.33
1099,2020-06-10,2020-06-10,,ATM Withdrawal,273.68,0.00,545623.65
1100,2020-06-10,2020-06-10,,Utility Payment,292.57,0.00,545331.08
1101,2020-06-10,2020-06-10,,Takeout,17.92,0.00,545313.16
1102,2020-06-10,2020-06-10,,Transfer Received,0.00,1736.16,547049.32
1103,2020-06-10,2020-06-10,,Dining Out,26.69,0.00,547022.63
1104,2020-06-11,2020-06-10,,Credit Card Payment,659.39,0.00,546363.24
1105,2020-06-11,2020-06-10,,Online Transfer,1111.69,0.00,545251.55
1106,2020-06-11,2020-06-11,,Loan EMI,1202.69,0.00,544048.86
1107,2020-06-11,2020-06-11,,Salary Credit,0.00,2566.38,546615.24
1108,2020-06-11,2020-06-11,,Investment Returns,0.00,480.89,547096.13
1109,2020-06-10,2020-06-11,,Salary Credit,0.00,3189.97,550286.10
1110,2020-06-11,2020-06-12,,Interest Credited,0.00,98.56,550384.66
1111,2020-06-11,2020-06-12,,Salary Credit,0.00,2550.25,552934.91
1112,2020-06-12,2020-06-12,,Groceries - Supermarket,186.60,0.00,552748.31
1113,2020-06-13,2020-06-12,,Online Transfer,1000.05,0.00,551748.26
1114,2020-06-12,2020-06-13,,Loan EMI,850.14,0.00,550898.12
1115,2020-06-13,2020-06-13,,Transfer Received,0.00,2426.08,553324.20
1116,2020-06-12,2020-06-13,,Interest Credited,0.00,97.59,553421.79
1117,2020-06-13,2020-06-13,,Transfer Received,0.00,633.82,554055.61
1118,2020-06-13,2020-06-13,,Groceries - Supermarket,161.79,0.00,553893.82
1119,2020-06-13,2020-06-13,,Transfer Received,0.00,861.15,554754.97
1120,2020-06-13,2020-06-13,,Transfer Received,0.00,889.06,555644.03
1121,2020-06-13,2020-06-14,,Salary Credit,0.00,4833.07,560477.10
1122,2020-06-14,2020-06-14,,Salary Credit,0.00,2596.79,563073.89
1123,2020-06-13,2020-06-14,,Loan EMI,1860.44,0.00,561213.45
1124,2020-06-13,2020-06-14,,Salary Credit,0.00,4052.80,565266.25
1125,2020-06-15,2020-06-15,,Loan EMI,576.38,0.00,564689.87
1126,2020-06-15,2020-06-15,,Groceries - Supermarket,104.10,0.00,564585.77
1127,2020-06-14,2020-06-15,,Interest Credited,0.00,68.72,564654.49
1128,2020-06-15,2020-06-15,,ATM Withdrawal,264.74,0.00,564389.75
1129,2020-06-15,2020-06-15,,Dividend Received,0.00,322.46,564712.21
1130,2020-06-15,2020-06-15,100027,Cheque Issued,763.64,0.00,563948.57
1131,2020-06-15,2020-06-15,,Online Transfer,1552.00,0.00,562396.57
1132,2020-06-15,2020-06-15,,Salary Credit,0.00,3102.01,565498.58
1133,2020-06-15,2020-06-15,,Loan EMI,1369.29,0.00,564129.29
1134,2020-06-14,2020-06-15,,Credit Card Payment,895.71,0.00,563233.58
1135,2020-06-15,2020-06-15,,Online Transfer,101.65,0.00,563131.93
1136,2020-06-15,2020-06-15,,Transfer Received,0.00,2829.93,565961.86
1137,2020-06-16,2020-06-16,,Utility Payment,78.09,0.00,565883.77
1138,2020-06-16,2020-06-16,,Transfer Received,0.00,524.76,566408.53
1139,2020-06-16,2020-06-16,,ATM Withdrawal,272.92,0.00,566135.61
1140,2020-06-16,2020-06-16,,Transfer Received,0.00,1451.88,567587.49
1141,2020-06-16,2020-06-16,,ATM Withdrawal,274.46,0.00,567313.03
1142,2020-06-16,2020-06-16,,Credit Card Payment,320.94,0.00,566992.09
1143,2020-06-17,2020-06-17,,Salary Credit,0.00,4695.47,571687.56
1144,2020-06-16,2020-06-17,,Transfer Received,0.00,1946.76,573634.32
1145,2020-06-17,2020-06-17,,Online Transfer,277.96,0.00,573356.36
1146,2020-06-18,2020-06-17,,ATM Withdrawal,185.79,0.00,573170.57
1147,2020-06-17,2020-06-17,,Groceries - Supermarket,178.90,0.00,572991.67
1148,2020-06-17,2020-06-17,,Transfer Received,0.00,1887.66,574879.33
1149,2020-06-17,2020-06-17,,Salary Credit,0.00,2062.53,576941.86
1150,2020-06-17,2020-06-18,,Transfer Received,0.00,1415.99,578357.85
1151,2020-06-18,2020-06-19,,Investment - SIP,109.31,0.00,578248.54
1152,2020-06-20,2020-06-19,,ATM Withdrawal,230.16,0.00,578018.38
1153,2020-06-19,2020-06-19,,Transfer Received,0.00,2942.97,580961.35
1154,2020-06-18,2020-06-19,,Credit Card Payment,342.01,0.00,580619.34
1155,2020-06-18,2020-06-19,,Salary Credit,0.00,4080.31,584699.65
1156,2020-06-18,2020-06-19,,ATM Withdrawal,162.81,0.00,584536.84
1157,2020-06-19,2020-06-19,,Groceries - Supermarket,37.20,0.00,584499.64
1158,2020-06-20,2020-06-20,,ATM Withdrawal,441.11,0.00,584058.53
1159,2020-06-20,2020-06-20,,Salary Credit,0.00,3289.94,587348.47
1160,2020-06-19,2020-06-20,,Takeout,27.47,0.00,587321.00
1161,2020-06-19,2020-06-20,,Groceries - Supermarket,29.91,0.00,587291.09
1162,2020-06-20,2020-06-20,,Interest Credited,0.00,14.99,587306.08
1163,2020-06-20,2020-06-20,,Groceries - Supermarket,172.99,0.00,587133.09
1164,2020-06-20,2020-06-20,,Transfer Received,0.00,2945.78,590078.87
1165,2020-06-21,2020-06-21,,Groceries - Supermarket,115.54,0.00,589963.33
1166,2020-06-21,2020-06-21,,Takeout,10.81,0.00,589952.52
1167,2020-06-21,2020-06-21,,Transfer Received,0.00,2589.74,592542.26
1168,2020-06-20,2020-06-21,,Transfer Received,0.00,868.71,593410.97
1169,2020-06-21,2020-06-21,,Credit Card Payment,305.97,0.00,593105.00
1170,2020-06-23,2020-06-22,,Salary Credit,0.00,4291.63,597396.63
1171,2020-06-22,2020-06-22,,ATM Withdrawal,53.19,0.00,597343.44
1172,2020-06-22,2020-06-22,,Utility Payment,100.15,0.00,597243.29
1173,2020-06-23,2020-06-23,,Dividend Received,0.00,153.32,597396.61
1174,2020-06-23,2020-06-23,,ATM Withdrawal,132.23,0.00,597264.38
1175,2020-06-23,2020-06-23,,Online Transfer,1143.45,0.00,596120.93
1176,2020-06-22,2020-06-23,,Dining Out,95.90,0.00,596025.03
1177,2020-06-23,2020-06-23,,ATM Withdrawal,197.60,0.00,595827.43
1178,2020-06-23,2020-06-24,,Groceries - Supermarket,25.06,0.00,595802.37
1179,2020-06-23,2020-06-24,,Investment - SIP,792.54,0.00,595009.83
1180,2020-06-24,2020-06-24,,Cash Deposit,0.00,200.61,595210.44
1181,2020-06-24,2020-06-24,,Salary Credit,0.00,2483.43,597693.87
1182,2020-06-24,2020-06-24,,Groceries - Supermarket,112.45,0.00,597581.42
1183,2020-06-24,2020-06-24,,Credit Card Payment,692.75,0.00,596888.67
1184,2020-06-23,2020-06-24,,Transfer Received,0.00,1710.84,598599.51
1185,2020-06-25,2020-06-25,,Interest Credited,0.00,68.98,598668.49
1186,2020-06-25,2020-06-25,,Transfer Received,0.00,2673.68,601342.17
1187,2020-06-25,2020-06-25,,Transfer Received,0.00,1624.19,602966.36
1188,2020-06-26,2020-06-25,,Online Transfer,927.66,0.00,602038.70
1189,2020-06-25,2020-06-25,,Utility Payment,207.68,0.00,601831.02
1190,2020-06-25,2020-06-25,,Loan EMI,1521.85,0.00,600309.17
1191,2020-06-25,2020-06-25,,Dining Out,96.91,0.00,600212.26
1192,2020-06-26,2020-06-26,,Groceries - Supermarket,61.45,0.00,600150.81
1193,2020-06-26,2020-06-26,,Interest Credited,0.00,52.41,600203.22
1194,2020-06-25,2020-06-26,,ATM Withdrawal,352.81,0.00,599850.41
1195,2020-06-26,2020-06-26,,Online Transfer,456.81,0.00,599393.60
1196,2020-06-26,2020-06-26,,Investment - Mutual Funds,758.65,0.00,598634.95
1197,2020-06-28,2020-06-27,,Groceries - Supermarket,126.56,0.00,598508.39
1198,2020-06-27,2020-06-27,,Groceries - Supermarket,75.48,0.00,598432.91
1199,2020-06-27,2020-06-27,100028,Cheque Issued,2475.29,0.00,595957.62
1200,2020-06-27,2020-06-27,,ATM Withdrawal,412.35,0.00,595545.27
1201,2020-06-27,2020-06-27,,Loan EMI,1189.66,0.00,594355.61
1202,2020-06-27,2020-06-27,,Groceries - Supermarket,115.38,0.00,594240.23
1203,2020-06-27,2020-06-27,,Takeout,35.03,0.00,594205.20
1204,2020-06-29,2020-06-28,,Takeout,10.20,0.00,594195.00
1205,2020-06-28,2020-06-28,,Credit Card Payment,690.80,0.00,593504.20
1206,2020-06-29,2020-06-28,,Investment Returns,0.00,472.44,593976.64
1207,2020-06-28,2020-06-28,,ATM Withdrawal,425.81,0.00,593550.83
1208,2020-06-28,2020-06-28,,ATM Withdrawal,69.48,0.00,593481.35
1209,2020-06-29,2020-06-29,100029,Cheque Issued,547.47,0.00,592933.88
1210,2020-06-29,2020-06-29,,Interest Credited,0.00,57.40,592991.28
1211,2020-06-29,2020-06-29,,ATM Withdrawal,335.74,0.00,592655.54
1212,2020-06-30,2020-06-29,,Groceries - Supermarket,27.37,0.00,592628.17
1213,2020-06-30,2020-06-29,,Utility Payment,144.79,0.00,592483.38
1214,2020-06-30,2020-06-29,,Cash Deposit,0.00,460.76,592944.14
1215,2020-06-29,2020-06-29,,Interest Credited,0.00,83.81,593027.95
1216,2020-06-30,2020-06-30,,Groceries - Supermarket,50.09,0.00,592977.86
1217,2020-06-30,2020-06-30,,Groceries - Supermarket,75.33,0.00,592902.53
1218,2020-07-01,2020-06-30,,ATM Withdrawal,227.45,0.00,592675.08
1219,2020-06-30,2020-06-30,,Transfer Received,0.00,2263.93,594939.01
1220,2020-06-29,2020-06-30,,Transfer Received,0.00,2182.56,597121.57
1221,2020-07-01,2020-07-01,,ATM Withdrawal,88.01,0.00,597033.56
1222,2020-07-01,2020-07-01,,Groceries - Supermarket,133.75,0.00,596899.81
1223,2020-07-02,2020-07-01,,Salary Credit,0.00,4898.87,601798.68
1224,2020-07-01,2020-07-01,,ATM Withdrawal,293.47,0.00,601505.21
1225,2020-07-01,2020-07-01,,Investment Returns,0.00,849.34,602354.55
1226,2020-07-01,2020-07-01,,Transfer Received,0.00,942.24,603296.79
1227,2020-07-01,2020-07-01,,ATM Withdrawal,300.33,0.00,602996.46
1228,2020-07-01,2020-07-01,,Credit Card Payment,895.98,0.00,602100.48
1229,2020-07-02,2020-07-02,,Transfer Received,0.00,1284.85,603385.33
1230,2020-07-02,2020-07-02,,Transfer Received,0.00,1771.25,605156.58
1231,2020-07-03,2020-07-02,,Daily Essentials,39.21,0.00,605117.37
1232,2020-07-03,2020-07-02,,Online Transfer,939.03,0.00,604178.34
1233,2020-07-02,2020-07-02,,ATM Withdrawal,489.46,0.00,603688.88
1234,2020-07-03,2020-07-03,,Salary Credit,0.00,3542.74,607231.62
1235,2020-07-03,2020-07-03,,Cash Deposit,0.00,250.63,607482.25
1236,2020-07-03,2020-07-03,100030,Cheque Issued,1898.10,0.00,605584.15
1237,2020-07-03,2020-07-03,,Salary Credit,0.00,2360.59,607944.74
1238,2020-07-03,2020-07-03,,Investment Returns,0.00,528.55,608473.29
1239,2020-07-04,2020-07-03,,Cash Deposit,0.00,521.57,608994.86
1240,2020-07-02,2020-07-03,,Groceries - Online Delivery,53.45,0.00,608941.41
1241,2020-07-04,2020-07-03,,Investment Returns,0.00,106.69,609048.10
1242,2020-07-03,2020-07-03,,Transfer Received,0.00,1264.60,610312.70
1243,2020-07-04,2020-07-04,,Investment Returns,0.00,167.26,610479.96
1244,2020-07-04,2020-07-04,,Transfer Received,0.00,1245.72,611725.68
1245,2020-07-03,2020-07-04,,Investment - Stocks,2208.33,0.00,609517.35
1246,2020-07-04,2020-07-04,,Groceries - Supermarket,28.94,0.00,609488.41
1247,2020-07-03,2020-07-04,,Groceries - Supermarket,24.91,0.00,609463.50
1248,2020-07-05,2020-07-05,,Rental Income,0.00,2306.82,611770.32
1249,2020-07-05,2020-07-05,,Transfer Received,0.00,2855.15,614625.47
1250,2020-07-04,2020-07-05,,Transfer Received,0.00,1101.75,615727.22
1251,2020-07-04,2020-07-05,,Loan EMI,1898.77,0.00,613828.45
1252,2020-07-04,2020-07-05,,Online Transfer,739.53,0.00,613088.92
1253,2020-07-06,2020-07-05,,Credit Card Payment,754.23,0.00,612334.69
1254,2020-07-05,2020-07-05,,Groceries - Supermarket,87.91,0.00,612246.78
1255,2020-07-05,2020-07-05,,Transfer Received,0.00,2527.09,614773.87
1256,2020-07-05,2020-07-05,,Investment Returns,0.00,218.35,614992.22
1257,2020-07-06,2020-07-06,,Transfer Received,0.00,1203.58,616195.80
1258,2020-07-06,2020-07-06,,Transfer Received,0.00,2411.17,618606.97
1259,2020-07-06,2020-07-07,,Online Transfer,1150.13,0.00,617456.84
1260,2020-07-07,2020-07-07,,Investment - Mutual Funds,2618.27,0.00,614838.57
1261,2020-07-07,2020-07-07,,Dividend Received,0.00,287.45,615126.02
1262,2020-07-06,2020-07-07,,Utility Payment,189.52,0.00,614936.50
1263,2020-07-06,2020-07-07,,ATM Withdrawal,423.54,0.00,614512.96
1264,2020-07-07,2020-07-07,,Interest Credited,0.00,22.39,614535.35
1265,2020-07-07,2020-07-07,,Groceries - Online Delivery,57.42,0.00,614477.93
1266,2020-07-06,2020-07-07,,Takeout,19.37,0.00,614458.56
1267,2020-07-06,2020-07-07,,Transfer Received,0.00,2771.08,617229.64
1268,2020-07-08,2020-07-08,,Credit Card Payment,504.40,0.00,616725.24
1269,2020-07-08,2020-07-08,,ATM Withdrawal,395.27,0.00,616329.97
1270,2020-07-08,2020-07-08,,Salary Credit,0.00,2136.31,618466.28
1271,2020-07-09,2020-07-09,,Utility Payment,258.30,0.00,618207.98
1272,2020-07-10,2020-07-09,,Utility Payment,215.85,0.00,617992.13
1273,2020-07-09,2020-07-09,,Investment - SIP,962.02,0.00,617030.11
1274,2020-07-09,2020-07-09,,Rental Income,0.00,1749.48,618779.59
1275,2020-07-09,2020-07-09,,ATM Withdrawal,69.68,0.00,618709.91
1276,2020-07-09,2020-07-09,,Groceries - Supermarket,149.21,0.00,618560.70
1277,2020-07-09,2020-07-09,,Investment - Mutual Funds,2658.05,0.00,615902.65
1278,2020-07-09,2020-07-09,,Cash Deposit,0.00,100.73,616003.38
1279,2020-07-10,2020-07-09,,Utility Payment,124.69,0.00,615878.69
1280,2020-07-09,2020-07-09,,Transfer Received,0.00,2920.92,618799.61
1281,2020-07-10,2020-07-10,,Salary Credit,0.00,3732.44,622532.05
1282,2020-07-09,2020-07-10,,Credit Card Payment,848.79,0.00,621683.26
1283,2020-07-10,2020-07-10,,Transfer Received,0.00,1037.65,622720.91
1284,2020-07-09,2020-07-10,,Groceries - Supermarket,65.13,0.00,622655.78
1285,2020-07-10,2020-07-10,,Credit Card Payment,447.99,0.00,622207.79
1286,2020-07-11,2020-07-10,,Salary Credit,0.00,3030.92,625238.71
1287,2020-07-10,2020-07-10,,Transfer Received,0.00,1298.18,626536.89
1288,2020-07-09,2020-07-10,,Transfer Received,0.00,2838.35,629375.24
1289,2020-07-11,2020-07-11,,Credit Card Payment,574.08,0.00,628801.16
1290,2020-07-11,2020-07-11,,Daily Essentials,14.71,0.00,628786.45
1291,2020-07-11,2020-07-11,,Dividend Received,0.00,364.01,629150.46
1292,2020-07-11,2020-07-11,,Salary Credit,0.00,3725.82,632876.28
1293,2020-07-12,2020-07-12,,Rental Income,0.00,2432.94,635309.22
1294,2020-07-12,2020-07-12,,ATM Withdrawal,327.15,0.00,634982.07
1295,2020-07-12,2020-07-12,,Groceries - Supermarket,58.70,0.00,634923.37
1296,2020-07-12,2020-07-12,,Loan EMI,654.88,0.00,634268.49
1297,2020-07-12,2020-07-12,,Transfer Received,0.00,1669.03,635937.52
1298,2020-07-13,2020-07-12,,Rental Income,0.00,2625.33,638562.85
1299,2020-07-13,2020-07-12,,Interest Credited,0.00,77.40,638640.25
1300,2020-07-12,2020-07-13,,Transfer Received,0.00,2483.28,641123.53
1301,2020-07-14,2020-07-13,,Transfer Received,0.00,624.33,641747.86
1302,2020-07-13,2020-07-13,,ATM Withdrawal,239.13,0.00,641508.73
1303,2020-07-13,2020-07-13,,Groceries - Online Delivery,51.83,0.00,641456.90
1304,2020-07-12,2020-07-13,,Interest Credited,0.00,90.55,641547.45
1305,2020-07-13,2020-07-13,,Transfer Received,0.00,789.56,642337.01
1306,2020-07-13,2020-07-13,,ATM Withdrawal,31.77,0.00,642305.24
1307,2020-07-13,2020-07-13,,Transfer Received,0.00,818.56,643123.80
1308,2020-07-13,2020-07-13,,Dining Out,57.68,0.00,643066.12
1309,2020-07-14,2020-07-14,,Dining Out,97.86,0.00,642968.26
1310,2020-07-14,2020-07-14,,Salary Credit,0.00,2490.49,645458.75
1311,2020-07-15,2020-07-14,,Salary Credit,0.00,2561.25,648020.00
1312,2020-07-13,2020-07-14,,ATM Withdrawal,463.00,0.00,647557.00
1313,2020-07-14,2020-07-14,,Interest Credited,0.00,21.58,647578.58
1314,2020-07-14,2020-07-14,,Transfer Received,0.00,741.37,648319.95
1315,2020-07-14,2020-07-14,,Investment Returns,0.00,149.96,648469.91
1316,2020-07-16,2020-07-15,,Transfer Received,0.00,1438.03,649907.94
1317,2020-07-16,2020-07-15,,Salary Credit,0.00,3402.53,653310.47
1318,2020-07-15,2020-07-15,,Groceries - Supermarket,194.60,0.00,653115.87
1319,2020-07-16,2020-07-15,,Credit Card Payment,508.13,0.00,652607.74
1320,2020-07-14,2020-07-15,,ATM Withdrawal,378.65,0.00,652229.09
1321,2020-07-14,2020-07-15,,Groceries - Supermarket,31.85,0.00,652197.24
1322,2020-07-14,2020-07-15,,Online Transfer,326.24,0.00,651871.00
1323,2020-07-15,2020-07-15,,Credit Card Payment,444.10,0.00,651426.90
1324,2020-07-15,2020-07-15,,Transfer Received,0.00,2016.12,653443.02
1325,2020-07-16,2020-07-16,,Salary Credit,0.00,3722.47,657165.49
1326,2020-07-17,2020-07-16,100031,Cheque Issued,1668.30,0.00,655497.19
1327,2020-07-16,2020-07-16,,Transfer Received,0.00,1060.38,656557.57
1328,2020-07-16,2020-07-16,,Utility Payment,70.65,0.00,656486.92
1329,2020-07-16,2020-07-16,,Dining Out,50.51,0.00,656436.41
1330,2020-07-17,2020-07-16,,Dividend Received,0.00,236.26,656672.67
1331,2020-07-15,2020-07-16,,ATM Withdrawal,72.55,0.00,656600.12
1332,2020-07-16,2020-07-16,,ATM Withdrawal,385.02,0.00,656215.10
1333,2020-07-16,2020-07-16,100032,Cheque Issued,2257.96,0.00,653957.14
1334,2020-07-15,2020-07-16,,Groceries - Supermarket,90.97,0.00,653866.17
1335,2020-07-16,2020-07-16,,Utility Payment,70.75,0.00,653795.42
1336,2020-07-16,2020-07-16,100033,Cheque Issued,1932.98,0.00,651862.44
1337,2020-07-15,2020-07-16,,Groceries - Online Delivery,55.92,0.00,651806.52
1338,2020-07-15,2020-07-16,,Online Transfer,395.01,0.00,651411.51
1339,2020-07-18,2020-07-17,,Transfer Received,0.00,1339.62,652751.13
1340,2020-07-17,2020-07-17,,ATM Withdrawal,406.69,0.00,652344.44
1341,2020-07-17,2020-07-17,,Transfer Received,0.00,2443.82,654788.26
1342,2020-07-18,2020-07-17,,Transfer Received,0.00,989.23,655777.49
1343,2020-07-17,2020-07-17,,Dining Out,69.18,0.00,655708.31
1344,2020-07-17,2020-07-17,,Transfer Received,0.00,661.68,656369.99
1345,2020-07-18,2020-07-17,,Investment - SIP,949.51,0.00,655420.48
1346,2020-07-17,2020-07-17,,Salary Credit,0.00,4400.68,659821.16
1347,2020-07-17,2020-07-17,,ATM Withdrawal,496.02,0.00,659325.14
1348,2020-07-17,2020-07-17,,ATM Withdrawal,282.03,0.00,659043.11
1349,2020-07-16,2020-07-17,,Groceries - Supermarket,189.59,0.00,658853.52
1350,2020-07-18,2020-07-18,,ATM Withdrawal,102.40,0.00,658751.12
1351,2020-07-18,2020-07-18,,ATM Withdrawal,89.53,0.00,658661.59
1352,2020-07-18,2020-07-18,,Investment - Stocks,3839.90,0.00,654821.69
1353,2020-07-19,2020-07-18,,Online Transfer,1648.23,0.00,653173.46
1354,2020-07-18,2020-07-18,,Salary Credit,0.00,4269.90,657443.36
1355,2020-07-19,2020-07-19,,Cash Deposit,0.00,124.64,657568.00
1356,2020-07-19,2020-07-19,,Daily Essentials,7.20,0.00,657560.80
1357,2020-07-19,2020-07-19,,Salary Credit,0.00,4340.92,661901.72
1358,2020-07-19,2020-07-19,,Salary Credit,0.00,4126.78,666028.50
1359,2020-07-19,2020-07-19,,Salary Credit,0.00,3205.46,669233.96
1360,2020-07-19,2020-07-19,,Transfer Received,0.00,1939.33,671173.29
1361,2020-07-18,2020-07-19,,Credit Card Payment,642.98,0.00,670530.31
1362,2020-07-20,2020-07-20,100034,Cheque Issued,1770.36,0.00,668759.95
1363,2020-07-20,2020-07-20,,Credit Card Payment,811.65,0.00,667948.30
1364,2020-07-19,2020-07-20,,Salary Credit,0.00,3613.96,671562.26
1365,2020-07-20,2020-07-20,,Groceries - Supermarket,48.32,0.00,671513.94
1366,2020-07-20,2020-07-20,,Dining Out,77.65,0.00,671436.29
1367,2020-07-21,2020-07-20,,ATM Withdrawal,146.70,0.00,671289.59
1368,2020-07-20,2020-07-20,,Salary Credit,0.00,3155.56,674445.15
1369,2020-07-21,2020-07-20,,Transfer Received,0.00,2615.21,677060.36
1370,2020-07-20,2020-07-20,,Salary Credit,0.00,3367.75,680428.11
1371,2020-07-21,2020-07-21,,Transfer Received,0.00,906.54,681334.65
1372,2020-07-22,2020-07-21,,Transfer Received,0.00,1027.76,682362.41
1373,2020-07-21,2020-07-21,,ATM Withdrawal,124.53,0.00,682237.88
1374,2020-07-21,2020-07-21,,Utility Payment,169.54,0.00,682068.34
1375,2020-07-22,2020-07-21,,Credit Card Payment,619.97,0.00,681448.37
1376,2020-07-21,2020-07-21,,ATM Withdrawal,33.11,0.00,681415.26
1377,2020-07-22,2020-07-21,,Salary Credit,0.00,3127.68,684542.94
1378,2020-07-21,2020-07-21,,Online Transfer,1650.14,0.00,682892.80
1379,2020-07-22,2020-07-21,,Transfer Received,0.00,2419.59,685312.39
1380,2020-07-20,2020-07-21,,Salary Credit,0.00,3487.28,688799.67
1381,2020-07-22,2020-07-22,,Credit Card Payment,934.37,0.00,687865.30
1382,2020-07-21,2020-07-22,,ATM Withdrawal,68.98,0.00,687796.32
1383,2020-07-21,2020-07-22,,Coffee Shop,11.34,0.00,687784.98
1384,2020-07-23,2020-07-22,,Transfer Received,0.00,1067.07,688852.05
1385,2020-07-22,2020-07-22,,Transfer Received,0.00,1717.47,690569.52
1386,2020-07-22,2020-07-22,,Takeout,40.14,0.00,690529.38
1387,2020-07-22,2020-07-22,,Transfer Received,0.00,1126.41,691655.79
1388,2020-07-22,2020-07-22,,Groceries - Online Delivery,71.55,0.00,691584.24
1389,2020-07-22,2020-07-22,,Salary Credit,0.00,2089.68,693673.92
1390,2020-07-22,2020-07-22,,ATM Withdrawal,114.02,0.00,693559.90
1391,2020-07-22,2020-07-22,,Dividend Received,0.00,185.45,693745.35
1392,2020-07-22,2020-07-22,,Transfer Received,0.00,2153.36,695898.71
1393,2020-07-22,2020-07-22,,Transfer Received,0.00,1126.90,697025.61
1394,2020-07-23,2020-07-23,,Online Transfer,503.37,0.00,696522.24
1395,2020-07-22,2020-07-23,,Interest Credited,0.00,17.05,696539.29
1396,2020-07-23,2020-07-23,,Cash Deposit,0.00,157.02,696696.31
1397,2020-07-23,2020-07-23,,ATM Withdrawal,120.92,0.00,696575.39
1398,2020-07-23,2020-07-23,,ATM Withdrawal,447.78,0.00,696127.61
1399,2020-07-23,2020-07-23,,Transfer Received,0.00,823.50,696951.11
1400,2020-07-23,2020-07-23,,Coffee Shop,7.20,0.00,696943.91
1401,2020-07-23,2020-07-23,,Groceries - Supermarket,92.12,0.00,696851.79
1402,2020-07-23,2020-07-23,,Utility Payment,161.75,0.00,696690.04
1403,2020-07-22,2020-07-23,,Utility Payment,187.81,0.00,696502.23
1404,2020-07-25,2020-07-24,,Credit Card Payment,575.76,0.00,695926.47
1405,2020-07-25,2020-07-24,,Groceries - Supermarket,140.84,0.00,695785.63
1406,2020-07-24,2020-07-24,,ATM Withdrawal,249.49,0.00,695536.14
1407,2020-07-24,2020-07-24,,Transfer Received,0.00,920.71,696456.85
1408,2020-07-24,2020-07-24,,Transfer Received,0.00,1991.06,698447.91
1409,2020-07-24,2020-07-24,,Transfer Received,0.00,2340.61,700788.52
1410,2020-07-25,2020-07-25,,ATM Withdrawal,106.73,0.00,700681.79
1411,2020-07-24,2020-07-25,,Transfer Received,0.00,1694.48,702376.27
1412,2020-07-25,2020-07-25,,Interest Credited,0.00,12.98,702389.25
1413,2020-07-24,2020-07-25,,Dividend Received,0.00,280.80,702670.05
1414,2020-07-26,2020-07-26,,Loan EMI,892.12,0.00,701777.93
1415,2020-07-26,2020-07-26,,Takeout,16.98,0.00,701760.95
1416,2020-07-26,2020-07-26,,Loan EMI,1931.55,0.00,699829.40
1417,2020-07-27,2020-07-26,,Investment - Mutual Funds,1009.06,0.00,698820.34
1418,2020-07-26,2020-07-26,,Groceries - Supermarket,105.38,0.00,698714.96
1419,2020-07-26,2020-07-26,,Online Transfer,1169.69,0.00,697545.27
1420,2020-07-27,2020-07-27,,Investment - Stocks,3921.86,0.00,693623.41
1421,2020-07-27,2020-07-27,,Credit Card Payment,539.36,0.00,693084.05
1422,2020-07-27,2020-07-27,,Takeout,12.69,0.00,693071.36
1423,2020-07-28,2020-07-27,,Salary Credit,0.00,4632.28,697703.64
1424,2020-07-27,2020-07-28,,Transfer Received,0.00,2993.42,700697.06
1425,2020-07-28,2020-07-28,,Takeout,32.26,0.00,700664.80
1426,2020-07-28,2020-07-28,,Transfer Received,0.00,1271.71,701936.51
1427,2020-07-28,2020-07-28,,Dividend Received,0.00,134.62,702071.13
1428,2020-07-27,2020-07-28,,Rental Income,0.00,2126.81,704197.94
1429,2020-07-28,2020-07-28,,ATM Withdrawal,236.35,0.00,703961.59
1430,2020-07-27,2020-07-28,,Online Transfer,330.20,0.00,703631.39
1431,2020-07-28,2020-07-28,,ATM Withdrawal,313.52,0.00,703317.87
1432,2020-07-29,2020-07-28,100035,Cheque Issued,1100.83,0.00,702217.04
1433,2020-07-28,2020-07-28,,Salary Credit,0.00,2769.92,704986.96
1434,2020-07-29,2020-07-29,,ATM Withdrawal,317.04,0.00,704669.92
1435,2020-07-29,2020-07-29,,Credit Card Payment,553.50,0.00,704116.42
1436,2020-07-29,2020-07-29,,Groceries - Supermarket,144.84,0.00,703971.58
1437,2020-07-29,2020-07-29,,Transfer Received,0.00,1668.12,705639.70
1438,2020-07-30,2020-07-30,,Loan EMI,933.90,0.00,704705.80
1439,2020-07-30,2020-07-30,,Credit Card Payment,764.60,0.00,703941.20
1440,2020-07-30,2020-07-30,,Utility Payment,135.37,0.00,703805.83
1441,2020-07-30,2020-07-30,,Utility Payment,273.49,0.00,703532.34
1442,2020-07-30,2020-07-30,,ATM Withdrawal,269.05,0.00,703263.29
1443,2020-07-30,2020-07-30,,Rental Income,0.00,1624.78,704888.07
1444,2020-07-29,2020-07-30,,Loan EMI,747.86,0.00,704140.21
1445,2020-07-29,2020-07-30,,Transfer Received,0.00,1011.65,705151.86
1446,2020-07-30,2020-07-30,,Takeout,38.03,0.00,705113.83
1447,2020-07-30,2020-07-30,,Dining Out,34.92,0.00,705078.91
1448,2020-07-31,2020-07-31,,Groceries - Online Delivery,113.54,0.00,704965.37
1449,2020-07-31,2020-07-31,,ATM Withdrawal,190.55,0.00,704774.82
1450,2020-07-30,2020-07-31,,ATM Withdrawal,360.50,0.00,704414.32
1451,2020-08-01,2020-07-31,,Transfer Received,0.00,2032.79,706447.11
1452,2020-07-31,2020-07-31,,Groceries - Supermarket,38.78,0.00,706408.33
1453,2020-07-30,2020-07-31,,Dividend Received,0.00,108.54,706516.87
1454,2020-07-31,2020-07-31,,Interest Credited,0.00,75.51,706592.38
1455,2020-07-31,2020-07-31,,Transfer Received,0.00,592.25,707184.63
1456,2020-07-30,2020-07-31,,Salary Credit,0.00,4779.50,711964.13
1457,2020-07-30,2020-07-31,,Transfer Received,0.00,2709.05,714673.18
1458,2020-08-01,2020-08-01,,Online Transfer,515.48,0.00,714157.70
1459,2020-08-01,2020-08-01,,Credit Card Payment,686.21,0.00,713471.49
1460,2020-08-01,2020-08-01,,Salary Credit,0.00,3208.20,716679.69
1461,2020-08-01,2020-08-01,,ATM Withdrawal,168.88,0.00,716510.81
1462,2020-08-02,2020-08-02,,Utility Payment,61.28,0.00,716449.53
1463,2020-08-03,2020-08-02,,Salary Credit,0.00,3317.29,719766.82
1464,2020-08-02,2020-08-02,,ATM Withdrawal,102.58,0.00,719664.24
1465,2020-08-02,2020-08-02,,ATM Withdrawal,151.35,0.00,719512.89
1466,2020-08-02,2020-08-02,,Groceries - Supermarket,182.79,0.00,719330.10
1467,2020-08-01,2020-08-02,,ATM Withdrawal,246.51,0.00,719083.59
1468,2020-08-02,2020-08-02,,Transfer Received,0.00,2078.66,721162.25
1469,2020-08-03,2020-08-02,,ATM Withdrawal,102.10,0.00,721060.15
1470,2020-08-02,2020-08-02,,Investment - Mutual Funds,907.59,0.00,720152.56
1471,2020-08-02,2020-08-02,,Coffee Shop,14.03,0.00,720138.53
1472,2020-08-04,2020-08-03,,Salary Credit,0.00,2229.15,722367.68
1473,2020-08-03,2020-08-03,,Investment - Mutual Funds,1669.86,0.00,720697.82
1474,2020-08-03,2020-08-03,,Groceries - Supermarket,131.94,0.00,720565.88
1475,2020-08-04,2020-08-03,,Online Transfer,735.03,0.00,719830.85
1476,2020-08-03,2020-08-03,,Salary Credit,0.00,4957.71,724788.56
1477,2020-08-03,2020-08-03,,Investment Returns,0.00,735.93,725524.49
1478,2020-08-02,2020-08-03,,Investment - SIP,575.29,0.00,724949.20
1479,2020-08-04,2020-08-04,,Groceries - Supermarket,131.51,0.00,724817.69
1480,2020-08-04,2020-08-04,,Loan EMI,1773.41,0.00,723044.28
1481,2020-08-03,2020-08-04,,Cash Deposit,0.00,845.17,723889.45
1482,2020-08-04,2020-08-04,,ATM Withdrawal,488.24,0.00,723401.21
1483,2020-08-05,2020-08-05,,Rental Income,0.00,2938.94,726340.15
1484,2020-08-05,2020-08-05,,Loan EMI,1468.06,0.00,724872.09
1485,2020-08-05,2020-08-05,,Transfer Received,0.00,1581.40,726453.49
1486,2020-08-06,2020-08-06,,Salary Credit,0.00,4600.85,731054.34
1487,2020-08-06,2020-08-06,,Salary Credit,0.00,2978.08,734032.42
1488,2020-08-05,2020-08-06,,Interest Credited,0.00,22.01,734054.43
1489,2020-08-06,2020-08-06,,Credit Card Payment,401.94,0.00,733652.49
1490,2020-08-06,2020-08-07,,Groceries - Supermarket,22.74,0.00,733629.75
1491,2020-08-07,2020-08-07,,Credit Card Payment,513.92,0.00,733115.83
1492,2020-08-07,2020-08-07,,Salary Credit,0.00,2705.09,735820.92
1493,2020-08-07,2020-08-07,,ATM Withdrawal,317.10,0.00,735503.82
1494,2020-08-07,2020-08-07,,Online Transfer,815.61,0.00,734688.21
1495,2020-08-07,2020-08-07,,Salary Credit,0.00,3353.43,738041.64
1496,2020-08-08,2020-08-07,,Salary Credit,0.00,3072.49,741114.13
1497,2020-08-07,2020-08-07,,Transfer Received,0.00,2104.26,743218.39
1498,2020-08-07,2020-08-07,,Transfer Received,0.00,2561.07,745779.46
1499,2020-08-07,2020-08-07,,Transfer Received,0.00,2699.31,748478.77
1500,2020-08-07,2020-08-07,,Dining Out,80.18,0.00,748398.59
1501,2020-08-08,2020-08-08,,Investment Returns,0.00,114.26,748512.85
1502,2020-08-08,2020-08-08,,Online Transfer,1127.79,0.00,747385.06
1503,2020-08-08,2020-08-08,,Transfer Received,0.00,1171.82,748556.88
1504,2020-08-08,2020-08-08,,Groceries - Supermarket,27.52,0.00,748529.36
1505,2020-08-08,2020-08-08,,ATM Withdrawal,209.50,0.00,748319.86
1506,2020-08-07,2020-08-08,,Investment - Mutual Funds,289.13,0.00,748030.73
1507,2020-08-08,2020-08-08,,Groceries - Supermarket,191.67,0.00,747839.06
1508,2020-08-08,2020-08-08,,ATM Withdrawal,25.10,0.00,747813.96
1509,2020-08-08,2020-08-08,,Salary Credit,0.00,3648.97,751462.93
1510,2020-08-09,2020-08-09,,Online Transfer,462.85,0.00,751000.08
1511,2020-08-09,2020-08-09,,Transfer Received,0.00,1484.40,752484.48
1512,2020-08-09,2020-08-09,,Salary Credit,0.00,2591.69,755076.17
1513,2020-08-09,2020-08-09,,ATM Withdrawal,340.99,0.00,754735.18
1514,2020-08-09,2020-08-09,,Credit Card Payment,943.46,0.00,753791.72
1515,2020-08-09,2020-08-09,,Dining Out,69.27,0.00,753722.45
1516,2020-08-08,2020-08-09,,Dining Out,90.01,0.00,753632.44
1517,2020-08-09,2020-08-09,,Interest Credited,0.00,65.79,753698.23
1518,2020-08-09,2020-08-09,,Transfer Received,0.00,1539.03,755237.26
1519,2020-08-08,2020-08-09,,Salary Credit,0.00,2043.08,757280.34
1520,2020-08-09,2020-08-09,,Transfer Received,0.00,2537.51,759817.85
1521,2020-08-09,2020-08-09,,Investment Returns,0.00,350.95,760168.80
1522,2020-08-10,2020-08-10,,Transfer Received,0.00,1729.74,761898.54
1523,2020-08-10,2020-08-10,,Online Transfer,1011.98,0.00,760886.56
1524,2020-08-10,2020-08-10,,Salary Credit,0.00,3780.42,764666.98
1525,2020-08-09,2020-08-10,,Transfer Received,0.00,1266.38,765933.36
1526,2020-08-09,2020-08-10,,Utility Payment,206.27,0.00,765727.09
1527,2020-08-10,2020-08-10,,Groceries - Supermarket,69.94,0.00,765657.15
1528,2020-08-10,2020-08-10,,Salary Credit,0.00,2659.47,768316.62
1529,2020-08-10,2020-08-10,,Salary Credit,0.00,3253.41,771570.03
1530,2020-08-10,2020-08-10,,ATM Withdrawal,260.89,0.00,771309.14
1531,2020-08-10,2020-08-10,,Online Transfer,1074.54,0.00,770234.60
1532,2020-08-11,2020-08-11,,Transfer Received,0.00,2454.68,772689.28
1533,2020-08-11,2020-08-11,,Transfer Received,0.00,2443.77,775133.05
1534,2020-08-10,2020-08-11,,Transfer Received,0.00,1247.49,776380.54
1535,2020-08-13,2020-08-12,,Salary Credit,0.00,3334.18,779714.72
1536,2020-08-11,2020-08-12,,Investment Returns,0.00,905.68,780620.40
1537,2020-08-12,2020-08-12,,Groceries - Supermarket,145.02,0.00,780475.38
1538,2020-08-13,2020-08-12,,Dividend Received,0.00,308.93,780784.31
1539,2020-08-13,2020-08-13,,Investment - Mutual Funds,240.26,0.00,780544.05
1540,2020-08-13,2020-08-13,,Transfer Received,0.00,1609.14,782153.19
1541,2020-08-13,2020-08-13,,Transfer Received,0.00,1227.09,783380.28
1542,2020-08-13,2020-08-13,,Utility Payment,294.63,0.00,783085.65
1543,2020-08-15,2020-08-14,,Transfer Received,0.00,808.19,783893.84
1544,2020-08-15,2020-08-14,,Utility Payment,229.95,0.00,783663.89
1545,2020-08-14,2020-08-14,,Online Transfer,1499.02,0.00,782164.87
1546,2020-08-13,2020-08-14,,Utility Payment,217.14,0.00,781947.73
1547,2020-08-14,2020-08-14,,Transfer Received,0.00,2030.19,783977.92
1548,2020-08-14,2020-08-14,,Transfer Received,0.00,890.86,784868.78
1549,2020-08-15,2020-08-14,,Transfer Received,0.00,973.91,785842.69
1550,2020-08-14,2020-08-14,,ATM Withdrawal,81.64,0.00,785761.05
1551,2020-08-15,2020-08-15,,Transfer Received,0.00,1972.43,787733.48
1552,2020-08-15,2020-08-15,,Online Transfer,661.56,0.00,787071.92
1553,2020-08-15,2020-08-15,,Transfer Received,0.00,1444.41,788516.33
1554,2020-08-15,2020-08-16,,Interest Credited,0.00,65.07,788581.40
1555,2020-08-16,2020-08-16,,Salary Credit,0.00,3493.56,792074.96
1556,2020-08-15,2020-08-16,100036,Cheque Issued,1455.08,0.00,790619.88
1557,2020-08-16,2020-08-16,,Utility Payment,206.02,0.00,790413.86
1558,2020-08-16,2020-08-16,100037,Cheque Issued,2604.99,0.00,787808.87
1559,2020-08-16,2020-08-16,,Rental Income,0.00,1660.77,789469.64
1560,2020-08-16,2020-08-16,,Transfer Received,0.00,956.48,790426.12
1561,2020-08-16,2020-08-17,,Investment - Stocks,3698.41,0.00,786727.71
1562,2020-08-18,2020-08-17,,Utility Payment,146.61,0.00,786581.10
1563,2020-08-17,2020-08-17,,Transfer Received,0.00,2986.56,789567.66
1564,2020-08-16,2020-08-17,,Daily Essentials,41.60,0.00,789526.06
1565,2020-08-16,2020-08-17,,Transfer Received,0.00,1867.97,791394.03
1566,2020-08-18,2020-08-17,,Salary Credit,0.00,4025.15,795419.18
1567,2020-08-18,2020-08-18,,Investment - SIP,870.55,0.00,794548.63
1568,2020-08-19,2020-08-18,,Groceries - Supermarket,189.77,0.00,794358.86
1569,2020-08-18,2020-08-18,,Transfer Received,0.00,1431.96,795790.82
1570,2020-08-18,2020-08-18,,Transfer Received,0.00,2565.93,798356.75
1571,2020-08-18,2020-08-18,,Groceries - Supermarket,23.73,0.00,798333.02
1572,2020-08-18,2020-08-18,,Dining Out,51.10,0.00,798281.92
1573,2020-08-18,2020-08-18,,Groceries - Supermarket,172.75,0.00,798109.17
1574,2020-08-19,2020-08-18,,Groceries - Supermarket,138.30,0.00,797970.87
1575,2020-08-18,2020-08-18,,Transfer Received,0.00,2343.63,800314.50
1576,2020-08-18,2020-08-18,,Online Transfer,834.87,0.00,799479.63
1577,2020-08-19,2020-08-19,,Groceries - Online Delivery,75.22,0.00,799404.41
1578,2020-08-19,2020-08-19,,Utility Payment,79.35,0.00,799325.06
1579,2020-08-19,2020-08-19,,Investment - Stocks,3757.11,0.00,795567.95
1580,2020-08-18,2020-08-19,,Rental Income,0.00,2581.99,798149.94
1581,2020-08-19,2020-08-19,,Transfer Received,0.00,2523.57,800673.51
1582,2020-08-20,2020-08-20,,Interest Credited,0.00,19.39,800692.90
1583,2020-08-19,2020-08-20,,Groceries - Online Delivery,126.60,0.00,800566.30
1584,2020-08-20,2020-08-20,,ATM Withdrawal,319.97,0.00,800246.33
1585,2020-08-20,2020-08-20,,Dividend Received,0.00,458.51,800704.84
1586,2020-08-20,2020-08-20,,Rental Income,0.00,2426.26,803131.10
1587,2020-08-20,2020-08-20,,Transfer Received,0.00,2202.80,805333.90
1588,2020-08-20,2020-08-20,,Transfer Received,0.00,2345.00,807678.90
1589,2020-08-19,2020-08-20,,Credit Card Payment,289.43,0.00,807389.47
1590,2020-08-20,2020-08-20,,Salary Credit,0.00,4412.02,811801.49
1591,2020-08-20,2020-08-21,,Transfer Received,0.00,2064.36,813865.85
1592,2020-08-20,2020-08-21,,Investment Returns,0.00,572.69,814438.54
1593,2020-08-22,2020-08-21,,Salary Credit,0.00,2288.56,816727.10
1594,2020-08-21,2020-08-21,,Rental Income,0.00,1542.95,818270.05
1595,2020-08-22,2020-08-21,,Salary Credit,0.00,2779.93,821049.98
1596,2020-08-21,2020-08-22,,Transfer Received,0.00,849.86,821899.84
1597,2020-08-21,2020-08-22,,Daily Essentials,21.61,0.00,821878.23
1598,2020-08-22,2020-08-22,,Online Transfer,595.45,0.00,821282.78
1599,2020-08-21,2020-08-22,,Transfer Received,0.00,1436.24,822719.02
1600,2020-08-22,2020-08-22,,Groceries - Online Delivery,106.62,0.00,822612.40
1601,2020-08-23,2020-08-22,,Groceries - Supermarket,100.50,0.00,822511.90
1602,2020-08-22,2020-08-22,,Utility Payment,258.06,0.00,822253.84
1603,2020-08-23,2020-08-23,,Investment - SIP,105.12,0.00,822148.72
1604,2020-08-23,2020-08-23,,Transfer Received,0.00,1708.66,823857.38
1605,2020-08-23,2020-08-23,,ATM Withdrawal,453.54,0.00,823403.84
1606,2020-08-23,2020-08-23,,ATM Withdrawal,41.53,0.00,823362.31
1607,2020-08-23,2020-08-23,,Online Transfer,1159.79,0.00,822202.52
1608,2020-08-23,2020-08-23,,Online Transfer,1716.19,0.00,820486.33
1609,2020-08-23,2020-08-23,,Investment - SIP,623.74,0.00,819862.59
1610,2020-08-22,2020-08-23,,Utility Payment,249.53,0.00,819613.06
1611,2020-08-23,2020-08-23,,Credit Card Payment,730.07,0.00,818882.99
1612,2020-08-23,2020-08-23,,Transfer Received,0.00,761.91,819644.90
1613,2020-08-24,2020-08-24,,Online Transfer,1619.62,0.00,818025.28
1614,2020-08-25,2020-08-24,,Transfer Received,0.00,640.81,818666.09
1615,2020-08-24,2020-08-24,,Utility Payment,182.91,0.00,818483.18
1616,2020-08-24,2020-08-24,,Salary Credit,0.00,3192.58,821675.76
1617,2020-08-24,2020-08-24,,Loan EMI,1955.30,0.00,819720.46
1618,2020-08-24,2020-08-24,,Loan EMI,1924.44,0.00,817796.02
1619,2020-08-25,2020-08-25,,Interest Credited,0.00,34.24,817830.26
1620,2020-08-24,2020-08-25,,Salary Credit,0.00,3944.99,821775.25
1621,2020-08-25,2020-08-25,,ATM Withdrawal,261.37,0.00,821513.88
1622,2020-08-25,2020-08-25,,Transfer Received,0.00,1127.95,822641.83
1623,2020-08-25,2020-08-25,,Takeout,31.59,0.00,822610.24
1624,2020-08-25,2020-08-25,,Credit Card Payment,572.88,0.00,822037.36
1625,2020-08-26,2020-08-25,,Dining Out,72.49,0.00,821964.87
1626,2020-08-25,2020-08-25,,Transfer Received,0.00,2085.88,824050.75
1627,2020-08-25,2020-08-26,,Transfer Received,0.00,2782.75,826833.50
1628,2020-08-26,2020-08-26,,Transfer Received,0.00,1114.23,827947.73
1629,2020-08-27,2020-08-26,,Investment Returns,0.00,694.94,828642.67
1630,2020-08-26,2020-08-26,,Groceries - Supermarket,169.41,0.00,828473.26
1631,2020-08-26,2020-08-26,,Groceries - Supermarket,182.38,0.00,828290.88
1632,2020-08-26,2020-08-26,,Credit Card Payment,990.14,0.00,827300.74
1633,2020-08-27,2020-08-26,,Credit Card Payment,702.27,0.00,826598.47
1634,2020-08-28,2020-08-27,,ATM Withdrawal,73.68,0.00,826524.79
1635,2020-08-27,2020-08-27,,Groceries - Supermarket,103.49,0.00,826421.30
1636,2020-08-27,2020-08-27,,Investment Returns,0.00,453.48,826874.78
1637,2020-08-27,2020-08-27,,Online Transfer,1782.26,0.00,825092.52
1638,2020-08-27,2020-08-28,,Investment - SIP,541.29,0.00,824551.23
1639,2020-08-29,2020-08-28,,Credit Card Payment,762.83,0.00,823788.40
1640,2020-08-28,2020-08-28,,Dining Out,47.92,0.00,823740.48
1641,2020-08-28,2020-08-28,,Daily Essentials,12.87,0.00,823727.61
1642,2020-08-28,2020-08-28,,Salary Credit,0.00,3098.57,826826.18
1643,2020-08-28,2020-08-28,,Cash Deposit,0.00,272.94,827099.12
1644,2020-08-28,2020-08-28,,Online Transfer,1172.52,0.00,825926.60
1645,2020-08-28,2020-08-28,,Transfer Received,0.00,2882.65,828809.25
1646,2020-08-27,2020-08-28,,Online Transfer,1226.47,0.00,827582.78
1647,2020-08-28,2020-08-28,,ATM Withdrawal,430.67,0.00,827152.11
1648,2020-08-29,2020-08-29,,Investment - SIP,774.25,0.00,826377.86
1649,2020-08-29,2020-08-29,,Groceries - Online Delivery,115.14,0.00,826262.72
1650,2020-08-29,2020-08-29,,Utility Payment,195.77,0.00,826066.95
1651,2020-08-29,2020-08-29,,Salary Credit,0.00,2730.31,828797.26
1652,2020-08-29,2020-08-29,,ATM Withdrawal,476.51,0.00,828320.75
1653,2020-08-29,2020-08-29,,Online Transfer,984.40,0.00,827336.35
1654,2020-08-29,2020-08-29,,Daily Essentials,45.27,0.00,827291.08
1655,2020-08-29,2020-08-29,,Investment Returns,0.00,774.86,828065.94
1656,2020-08-29,2020-08-29,,Transfer Received,0.00,650.41,828716.35
1657,2020-08-29,2020-08-29,,Groceries - Supermarket,165.38,0.00,828550.97
1658,2020-08-29,2020-08-29,,Interest Credited,0.00,24.56,828575.53
1659,2020-08-31,2020-08-30,,Groceries - Supermarket,97.70,0.00,828477.83
1660,2020-08-30,2020-08-30,,Transfer Received,0.00,2167.42,830645.25
1661,2020-08-30,2020-08-30,,Transfer Received,0.00,2081.70,832726.95
1662,2020-08-30,2020-08-30,,Interest Credited,0.00,47.75,832774.70
1663,2020-08-31,2020-08-30,,Dividend Received,0.00,407.63,833182.33
1664,2020-08-31,2020-08-30,,Utility Payment,120.35,0.00,833061.98
1665,2020-08-31,2020-08-30,,Transfer Received,0.00,2454.91,835516.89
1666,2020-08-30,2020-08-30,,Groceries - Supermarket,21.92,0.00,835494.97
1667,2020-08-29,2020-08-30,,Transfer Received,0.00,615.86,836110.83
1668,2020-09-01,2020-08-31,,ATM Withdrawal,247.96,0.00,835862.87
1669,2020-08-31,2020-08-31,,Online Transfer,1126.83,0.00,834736.04
1670,2020-08-31,2020-08-31,,Utility Payment,103.90,0.00,834632.14
1671,2020-08-31,2020-08-31,,Takeout,33.78,0.00,834598.36
1672,2020-08-31,2020-08-31,,Utility Payment,296.12,0.00,834302.24
1673,2020-08-31,2020-08-31,,Groceries - Supermarket,199.33,0.00,834102.91
1674,2020-09-01,2020-09-01,,ATM Withdrawal,323.60,0.00,833779.31
1675,2020-09-01,2020-09-01,,Online Transfer,161.18,0.00,833618.13
1676,2020-09-01,2020-09-01,,Salary Credit,0.00,4683.89,838302.02
1677,2020-09-02,2020-09-01,,Salary Credit,0.00,3814.66,842116.68
1678,2020-08-31,2020-09-01,,Online Transfer,790.58,0.00,841326.10
1679,2020-09-01,2020-09-01,,ATM Withdrawal,401.52,0.00,840924.58
1680,2020-09-01,2020-09-01,,Groceries - Supermarket,190.38,0.00,840734.20
1681,2020-09-01,2020-09-02,,Loan EMI,1063.03,0.00,839671.17
1682,2020-09-02,2020-09-02,,Groceries - Supermarket,192.31,0.00,839478.86
1683,2020-09-02,2020-09-02,,Dining Out,50.77,0.00,839428.09
1684,2020-09-02,2020-09-02,,Groceries - Supermarket,180.72,0.00,839247.37
1685,2020-09-02,2020-09-02,,Dining Out,80.77,0.00,839166.60
1686,2020-09-02,2020-09-02,,Utility Payment,178.81,0.00,838987.79
1687,2020-09-02,2020-09-02,,Groceries - Supermarket,161.58,0.00,838826.21
1688,2020-09-03,2020-09-03,,Dining Out,86.17,0.00,838740.04
1689,2020-09-03,2020-09-03,,ATM Withdrawal,61.77,0.00,838678.27
1690,2020-09-04,2020-09-03,100038,Cheque Issued,1781.38,0.00,836896.89
1691,2020-09-04,2020-09-04,,Online Transfer,1606.12,0.00,835290.77
1692,2020-09-04,2020-09-04,,Transfer Received,0.00,2433.26,837724.03
1693,2020-09-04,2020-09-04,,Credit Card Payment,774.27,0.00,836949.76
1694,2020-09-03,2020-09-04,,ATM Withdrawal,185.06,0.00,836764.70
1695,2020-09-04,2020-09-04,,Online Transfer,355.34,0.00,836409.36
1696,2020-09-05,2020-09-04,,Interest Credited,0.00,52.90,836462.26
1697,2020-09-04,2020-09-04,,Transfer Received,0.00,559.09,837021.35
1698,2020-09-03,2020-09-04,,Credit Card Payment,691.62,0.00,836329.73
1699,2020-09-03,2020-09-04,,Dividend Received,0.00,289.04,836618.77
1700,2020-09-04,2020-09-04,,ATM Withdrawal,60.76,0.00,836558.01
1701,2020-09-05,2020-09-05,,Takeout,17.28,0.00,836540.73
1702,2020-09-05,2020-09-05,,ATM Withdrawal,81.11,0.00,836459.62
1703,2020-09-06,2020-09-05,,Dining Out,72.11,0.00,836387.51
1704,2020-09-05,2020-09-05,100039,Cheque Issued,2157.01,0.00,834230.50
1705,2020-09-06,2020-09-05,,Credit Card Payment,853.16,0.00,833377.34
1706,2020-09-05,2020-09-05,,Groceries - Online Delivery,116.10,0.00,833261.24
1707,2020-09-06,2020-09-06,,Transfer Received,0.00,878.81,834140.05
1708,2020-09-05,2020-09-06,,Cash Deposit,0.00,720.44,834860.49
1709,2020-09-06,2020-09-06,,Credit Card Payment,795.85,0.00,834064.64
1710,2020-09-06,2020-09-06,,Utility Payment,218.00,0.00,833846.64
1711,2020-09-07,2020-09-07,,Takeout,11.81,0.00,833834.83
1712,2020-09-07,2020-09-07,,Daily Essentials,7.67,0.00,833827.16
1713,2020-09-07,2020-09-07,,ATM Withdrawal,328.68,0.00,833498.48
1714,2020-09-07,2020-09-07,,Transfer Received,0.00,1702.75,835201.23
1715,2020-09-07,2020-09-07,,Transfer Received,0.00,1686.93,836888.16
1716,2020-09-08,2020-09-07,,Transfer Received,0.00,2706.02,839594.18
1717,2020-09-08,2020-09-08,,Groceries - Supermarket,93.93,0.00,839500.25
1718,2020-09-07,2020-09-08,,ATM Withdrawal,58.00,0.00,839442.25
1719,2020-09-08,2020-09-08,,Transfer Received,0.00,1068.59,840510.84
1720,2020-09-08,2020-09-08,,Salary Credit,0.00,2415.65,842926.49
1721,2020-09-08,2020-09-08,,Salary Credit,0.00,2045.37,844971.86
1722,2020-09-08,2020-09-08,,Groceries - Supermarket,31.51,0.00,844940.35
1723,2020-09-08,2020-09-08,,Dining Out,94.51,0.00,844845.84
1724,2020-09-09,2020-09-08,,Utility Payment,231.72,0.00,844614.12
1725,2020-09-08,2020-09-08,,Rental Income,0.00,2020.14,846634.26
1726,2020-09-09,2020-09-08,,Online Transfer,1692.54,0.00,844941.72
1727,2020-09-08,2020-09-08,,ATM Withdrawal,162.87,0.00,844778.85
1728,2020-09-09,2020-09-09,,ATM Withdrawal,73.71,0.00,844705.14
1729,2020-09-09,2020-09-09,,Investment - SIP,305.94,0.00,844399.20
1730,2020-09-08,2020-09-09,,Rental Income,0.00,2900.92,847300.12
1731,2020-09-09,2020-09-09,,ATM Withdrawal,389.23,0.00,846910.89
1732,2020-09-09,2020-09-09,,Salary Credit,0.00,2912.49,849823.38
1733,2020-09-09,2020-09-09,,Dividend Received,0.00,188.77,850012.15
1734,2020-09-10,2020-09-10,,Credit Card Payment,528.58,0.00,849483.57
1735,2020-09-10,2020-09-10,,Utility Payment,168.45,0.00,849315.12
1736,2020-09-10,2020-09-10,,Groceries - Online Delivery,122.23,0.00,849192.89
1737,2020-09-11,2020-09-10,,Transfer Received,0.00,2388.04,851580.93
1738,2020-09-11,2020-09-10,,Credit Card Payment,836.45,0.00,850744.48
1739,2020-09-09,2020-09-10,,Transfer Received,0.00,2242.95,852987.43
1740,2020-09-11,2020-09-10,,Salary Credit,0.00,4661.66,857649.09
1741,2020-09-10,2020-09-11,,Salary Credit,0.00,3135.06,860784.15
1742,2020-09-10,2020-09-11,,Salary Credit,0.00,4486.30,865270.45
1743,2020-09-11,2020-09-11,,Transfer Received,0.00,2295.91,867566.36
1744,2020-09-12,2020-09-11,,ATM Withdrawal,252.84,0.00,867313.52
1745,2020-09-11,2020-09-11,,Transfer Received,0.00,1268.00,868581.52
1746,2020-09-11,2020-09-11,,Salary Credit,0.00,3589.88,872171.40
1747,2020-09-11,2020-09-12,,Loan EMI,957.92,0.00,871213.48
1748,2020-09-12,2020-09-12,,Transfer Received,0.00,1319.83,872533.31
1749,2020-09-13,2020-09-13,,Salary Credit,0.00,2975.32,875508.63
1750,2020-09-13,2020-09-13,,Utility Payment,69.20,0.00,875439.43
1751,2020-09-13,2020-09-13,,Groceries - Online Delivery,143.31,0.00,875296.12
1752,2020-09-13,2020-09-13,,Utility Payment,61.38,0.00,875234.74
1753,2020-09-12,2020-09-13,,Investment - Mutual Funds,821.35,0.00,874413.39
1754,2020-09-14,2020-09-14,,ATM Withdrawal,388.17,0.00,874025.22
1755,2020-09-14,2020-09-14,,ATM Withdrawal,484.20,0.00,873541.02
1756,2020-09-14,2020-09-14,,Groceries - Online Delivery,100.96,0.00,873440.06
1757,2020-09-14,2020-09-14,,Transfer Received,0.00,1834.51,875274.57
1758,2020-09-14,2020-09-14,,Groceries - Supermarket,88.41,0.00,875186.16
1759,2020-09-13,2020-09-14,,Groceries - Online Delivery,136.45,0.00,875049.71
1760,2020-09-14,2020-09-14,,Salary Credit,0.00,4944.30,879994.01
1761,2020-09-15,2020-09-14,,Dining Out,93.14,0.00,879900.87
1762,2020-09-14,2020-09-14,,Investment - Stocks,3499.11,0.00,876401.76
1763,2020-09-14,2020-09-14,,Cash Deposit,0.00,170.48,876572.24
1764,2020-09-15,2020-09-15,,ATM Withdrawal,211.69,0.00,876360.55
1765,2020-09-14,2020-09-15,,ATM Withdrawal,29.67,0.00,876330.88
1766,2020-09-15,2020-09-15,,Transfer Received,0.00,874.00,877204.88
1767,2020-09-15,2020-09-15,100040,Cheque Issued,1154.33,0.00,876050.55
1768,2020-09-15,2020-09-15,,Transfer Received,0.00,2001.93,878052.48
1769,2020-09-16,2020-09-15,,Utility Payment,70.49,0.00,877981.99
1770,2020-09-15,2020-09-15,,Salary Credit,0.00,3242.80,881224.79
1771,2020-09-15,2020-09-15,,Cash Deposit,0.00,620.14,881844.93
1772,2020-09-17,2020-09-16,,Loan EMI,1082.92,0.00,880762.01
1773,2020-09-15,2020-09-16,,Transfer Received,0.00,798.55,881560.56
1774,2020-09-17,2020-09-16,,Online Transfer,1526.98,0.00,880033.58
1775,2020-09-17,2020-09-16,,Online Transfer,466.26,0.00,879567.32
1776,2020-09-17,2020-09-17,,Investment - Mutual Funds,2423.01,0.00,877144.31
1777,2020-09-17,2020-09-17,,Online Transfer,1605.82,0.00,875538.49
1778,2020-09-17,2020-09-17,,Interest Credited,0.00,22.98,875561.47
1779,2020-09-17,2020-09-17,,ATM Withdrawal,272.76,0.00,875288.71
1780,2020-09-17,2020-09-17,,Daily Essentials,12.81,0.00,875275.90
1781,2020-09-18,2020-09-18,,Transfer Received,0.00,1881.75,877157.65
1782,2020-09-18,2020-09-18,,Interest Credited,0.00,73.72,877231.37
1783,2020-09-19,2020-09-19,,Utility Payment,112.10,0.00,877119.27
1784,2020-09-20,2020-09-19,,Utility Payment,185.09,0.00,876934.18
1785,2020-09-18,2020-09-19,,Transfer Received,0.00,2091.48,879025.66
1786,2020-09-20,2020-09-19,,Rental Income,0.00,2213.68,881239.34
1787,2020-09-19,2020-09-19,,Dining Out,13.64,0.00,881225.70
1788,2020-09-21,2020-09-20,,Credit Card Payment,403.40,0.00,880822.30
1789,2020-09-20,2020-09-20,,Dining Out,78.25,0.00,880744.05
1790,2020-09-21,2020-09-20,,Salary Credit,0.00,2014.23,882758.28
1791,2020-09-19,2020-09-20,,Groceries - Supermarket,147.98,0.00,882610.30
1792,2020-09-20,2020-09-20,,ATM Withdrawal,418.39,0.00,882191.91
1793,2020-09-20,2020-09-20,,Daily Essentials,35.67,0.00,882156.24
1794,2020-09-19,2020-09-20,,Utility Payment,106.34,0.00,882049.90
1795,2020-09-19,2020-09-20,,Transfer Received,0.00,1063.12,883113.02
1796,2020-09-21,2020-09-20,,Salary Credit,0.00,4900.59,888013.61
1797,2020-09-21,2020-09-21,,Salary Credit,0.00,2137.65,890151.26
1798,2020-09-21,2020-09-21,,Interest Credited,0.00,96.17,890247.43
1799,2020-09-21,2020-09-21,,Utility Payment,277.96,0.00,889969.47
1800,2020-09-21,2020-09-21,,ATM Withdrawal,247.27,0.00,889722.20
1801,2020-09-21,2020-09-21,,Interest Credited,0.00,54.62,889776.82
1802,2020-09-23,2020-09-22,,Groceries - Supermarket,66.30,0.00,889710.52
1803,2020-09-23,2020-09-22,,Investment - Stocks,4982.41,0.00,884728.11
1804,2020-09-23,2020-09-22,,Online Transfer,1858.63,0.00,882869.48
1805,2020-09-22,2020-09-22,,Groceries - Supermarket,169.76,0.00,882699.72
1806,2020-09-21,2020-09-22,,Groceries - Supermarket,62.04,0.00,882637.68
1807,2020-09-21,2020-09-22,,Rental Income,0.00,2138.22,884775.90
1808,2020-09-22,2020-09-22,,Interest Credited,0.00,33.38,884809.28
1809,2020-09-21,2020-09-22,,Online Transfer,1506.41,0.00,883302.87
1810,2020-09-23,2020-09-23,,Takeout,43.13,0.00,883259.74
1811,2020-09-23,2020-09-23,,Transfer Received,0.00,514.01,883773.75
1812,2020-09-23,2020-09-23,,Groceries - Supermarket,196.48,0.00,883577.27
1813,2020-09-23,2020-09-23,,Utility Payment,126.59,0.00,883450.68
1814,2020-09-23,2020-09-23,,Online Transfer,1524.41,0.00,881926.27
1815,2020-09-23,2020-09-23,,Salary Credit,0.00,4427.82,886354.09
1816,2020-09-23,2020-09-24,,Transfer Received,0.00,2735.38,889089.47
1817,2020-09-24,2020-09-24,,Groceries - Supermarket,133.07,0.00,888956.40
1818,2020-09-24,2020-09-24,,Transfer Received,0.00,1941.74,890898.14
1819,2020-09-24,2020-09-24,,Rental Income,0.00,2801.03,893699.17
1820,2020-09-24,2020-09-24,,ATM Withdrawal,223.32,0.00,893475.85
1821,2020-09-25,2020-09-24,,Investment - Mutual Funds,2685.54,0.00,890790.31
1822,2020-09-24,2020-09-24,,Utility Payment,123.96,0.00,890666.35
1823,2020-09-24,2020-09-24,,Transfer Received,0.00,1903.98,892570.33
1824,2020-09-26,2020-09-25,,Groceries - Supermarket,36.30,0.00,892534.03
1825,2020-09-25,2020-09-25,,Online Transfer,1822.45,0.00,890711.58
1826,2020-09-25,2020-09-25,,Utility Payment,101.25,0.00,890610.33
1827,2020-09-25,2020-09-25,,Transfer Received,0.00,2234.59,892844.92
1828,2020-09-25,2020-09-25,,Transfer Received,0.00,2055.65,894900.57
1829,2020-09-26,2020-09-26,,ATM Withdrawal,98.22,0.00,894802.35
1830,2020-09-25,2020-09-26,,Transfer Received,0.00,2916.55,897718.90
1831,2020-09-26,2020-09-26,,Transfer Received,0.00,2006.67,899725.57
1832,2020-09-26,2020-09-27,,Salary Credit,0.00,2846.07,902571.64
1833,2020-09-26,2020-09-27,,Credit Card Payment,855.38,0.00,901716.26
1834,2020-09-27,2020-09-27,,Salary Credit,0.00,3267.14,904983.40
1835,2020-09-27,2020-09-27,,Utility Payment,62.15,0.00,904921.25
1836,2020-09-28,2020-09-27,,ATM Withdrawal,318.27,0.00,904602.98
1837,2020-09-27,2020-09-27,,Salary Credit,0.00,4962.27,909565.25
1838,2020-09-27,2020-09-27,,Dining Out,79.60,0.00,909485.65
1839,2020-09-28,2020-09-27,,Dining Out,44.13,0.00,909441.52
1840,2020-09-26,2020-09-27,,Salary Credit,0.00,3626.25,913067.77
1841,2020-09-27,2020-09-27,,ATM Withdrawal,438.90,0.00,912628.87
1842,2020-09-28,2020-09-28,100041,Cheque Issued,1180.32,0.00,911448.55
1843,2020-09-28,2020-09-28,,Transfer Received,0.00,670.88,912119.43
1844,2020-09-29,2020-09-28,,Transfer Received,0.00,2158.28,914277.71
1845,2020-09-28,2020-09-28,,ATM Withdrawal,376.01,0.00,913901.70
1846,2020-09-28,2020-09-28,,ATM Withdrawal,354.44,0.00,913547.26
1847,2020-09-27,2020-09-28,,Interest Credited,0.00,41.08,913588.34
1848,2020-09-28,2020-09-28,,Loan EMI,1604.13,0.00,911984.21
1849,2020-09-27,2020-09-28,,Utility Payment,292.09,0.00,911692.12
1850,2020-09-28,2020-09-28,,Salary Credit,0.00,3945.01,915637.13
1851,2020-09-29,2020-09-29,,Credit Card Payment,507.97,0.00,915129.16
1852,2020-09-29,2020-09-29,,Credit Card Payment,806.04,0.00,914323.12
1853,2020-09-29,2020-09-29,,Groceries - Supermarket,61.13,0.00,914261.99
1854,2020-09-28,2020-09-29,,Transfer Received,0.00,2342.96,916604.95
1855,2020-09-29,2020-09-29,,Dining Out,21.60,0.00,916583.35
1856,2020-09-29,2020-09-29,,Dividend Received,0.00,498.66,917082.01
1857,2020-09-28,2020-09-29,,Transfer Received,0.00,1814.31,918896.32
1858,2020-09-29,2020-09-29,,Investment - Mutual Funds,382.59,0.00,918513.73
1859,2020-09-29,2020-09-29,,ATM Withdrawal,462.94,0.00,918050.79
1860,2020-09-30,2020-09-30,,ATM Withdrawal,30.34,0.00,918020.45
1861,2020-10-01,2020-09-30,,Transfer Received,0.00,1070.11,919090.56
1862,2020-09-30,2020-09-30,,Groceries - Supermarket,45.06,0.00,919045.50
1863,2020-09-29,2020-09-30,,Transfer Received,0.00,2070.59,921116.09
1864,2020-09-30,2020-09-30,,Dividend Received,0.00,294.81,921410.90
1865,2020-09-30,2020-09-30,,Groceries - Supermarket,80.88,0.00,921330.02
1866,2020-09-30,2020-09-30,,Groceries - Supermarket,141.49,0.00,921188.53
1867,2020-10-01,2020-09-30,,Investment - Stocks,3653.64,0.00,917534.89
1868,2020-09-30,2020-09-30,,Utility Payment,124.94,0.00,917409.95
1869,2020-10-02,2020-10-01,,Credit Card Payment,457.62,0.00,916952.33
1870,2020-10-02,2020-10-01,,ATM Withdrawal,116.96,0.00,916835.37
1871,2020-09-30,2020-10-01,,ATM Withdrawal,278.96,0.00,916556.41
1872,2020-10-01,2020-10-01,,Salary Credit,0.00,2421.31,918977.72
1873,2020-10-01,2020-10-01,,Takeout,20.11,0.00,918957.61
1874,2020-10-01,2020-10-01,,Coffee Shop,7.60,0.00,918950.01
1875,2020-09-30,2020-10-01,,ATM Withdrawal,338.66,0.00,918611.35
1876,2020-10-01,2020-10-01,,Transfer Received,0.00,1483.21,920094.56
1877,2020-10-03,2020-10-02,,Interest Credited,0.00,32.75,920127.31
1878,2020-10-02,2020-10-02,,Credit Card Payment,283.82,0.00,919843.49
1879,2020-10-01,2020-10-02,,Coffee Shop,8.49,0.00,919835.00
1880,2020-10-02,2020-10-02,,Investment - Mutual Funds,1361.70,0.00,918473.30
1881,2020-10-02,2020-10-02,,Interest Credited,0.00,73.45,918546.75
1882,2020-10-02,2020-10-02,,Transfer Received,0.00,2223.71,920770.46
1883,2020-10-02,2020-10-02,,Online Transfer,569.61,0.00,920200.85
1884,2020-10-02,2020-10-03,,Transfer Received,0.00,2543.03,922743.88
1885,2020-10-03,2020-10-03,,Interest Credited,0.00,92.19,922836.07
1886,2020-10-03,2020-10-03,,Salary Credit,0.00,3319.96,926156.03
1887,2020-10-03,2020-10-03,,Groceries - Supermarket,45.03,0.00,926111.00
1888,2020-10-03,2020-10-03,,Transfer Received,0.00,1572.20,927683.20
1889,2020-10-02,2020-10-03,,Daily Essentials,40.20,0.00,927643.00
1890,2020-10-02,2020-10-03,,Investment - Mutual Funds,2389.66,0.00,925253.34
1891,2020-10-04,2020-10-04,,Groceries - Supermarket,151.32,0.00,925102.02
1892,2020-10-04,2020-10-04,,Credit Card Payment,914.57,0.00,924187.45
1893,2020-10-04,2020-10-04,,Groceries - Supermarket,120.30,0.00,924067.15
1894,2020-10-04,2020-10-04,,ATM Withdrawal,217.44,0.00,923849.71
1895,2020-10-04,2020-10-04,,Salary Credit,0.00,2006.97,925856.68
1896,2020-10-04,2020-10-04,,Transfer Received,0.00,2642.82,928499.50
1897,2020-10-04,2020-10-04,,Transfer Received,0.00,1891.61,930391.11
1898,2020-10-04,2020-10-04,,Groceries - Supermarket,83.82,0.00,930307.29
1899,2020-10-04,2020-10-04,,Rental Income,0.00,2225.59,932532.88
1900,2020-10-06,2020-10-05,,Daily Essentials,40.77,0.00,932492.11
1901,2020-10-05,2020-10-05,,Groceries - Online Delivery,145.32,0.00,932346.79
1902,2020-10-06,2020-10-05,,Credit Card Payment,549.18,0.00,931797.61
1903,2020-10-04,2020-10-05,,ATM Withdrawal,481.59,0.00,931316.02
1904,2020-10-05,2020-10-05,,Transfer Received,0.00,2098.12,933414.14
1905,2020-10-05,2020-10-06,,ATM Withdrawal,317.61,0.00,933096.53
1906,2020-10-06,2020-10-06,,Investment Returns,0.00,778.18,933874.71
1907,2020-10-06,2020-10-06,,Transfer Received,0.00,2463.09,936337.80
1908,2020-10-07,2020-10-06,,Interest Credited,0.00,41.91,936379.71
1909,2020-10-05,2020-10-06,,Utility Payment,113.20,0.00,936266.51
1910,2020-10-06,2020-10-06,,Dividend Received,0.00,269.90,936536.41
1911,2020-10-06,2020-10-06,,Dividend Received,0.00,187.68,936724.09
1912,2020-10-06,2020-10-06,,Groceries - Supermarket,159.21,0.00,936564.88
1913,2020-10-05,2020-10-06,,Salary Credit,0.00,4827.23,941392.11
1914,2020-10-07,2020-10-07,,Interest Credited,0.00,10.76,941402.87
1915,2020-10-07,2020-10-07,,Salary Credit,0.00,4353.51,945756.38
1916,2020-10-06,2020-10-07,,Investment Returns,0.00,138.04,945894.42
1917,2020-10-07,2020-10-07,,Salary Credit,0.00,2739.14,948633.56
1918,2020-10-07,2020-10-08,,ATM Withdrawal,162.96,0.00,948470.60
1919,2020-10-09,2020-10-08,,Investment Returns,0.00,475.33,948945.93
1920,2020-10-08,2020-10-08,,Transfer Received,0.00,2109.36,951055.29
1921,2020-10-08,2020-10-08,,Rental Income,0.00,1234.47,952289.76
1922,2020-10-08,2020-10-08,100042,Cheque Issued,1041.06,0.00,951248.70
1923,2020-10-07,2020-10-08,,Transfer Received,0.00,1627.34,952876.04
1924,2020-10-08,2020-10-09,,Online Transfer,511.41,0.00,952364.63
1925,2020-10-09,2020-10-09,,Groceries - Supermarket,75.37,0.00,952289.26
1926,2020-10-09,2020-10-09,,Utility Payment,196.09,0.00,952093.17
1927,2020-10-08,2020-10-09,,Takeout,13.01,0.00,952080.16
1928,2020-10-09,2020-10-09,,Interest Credited,0.00,28.57,952108.73
1929,2020-10-10,2020-10-10,,Investment Returns,0.00,375.15,952483.88
1930,2020-10-10,2020-10-10,,Cash Deposit,0.00,389.54,952873.42
1931,2020-10-09,2020-10-10,,Groceries - Supermarket,146.47,0.00,952726.95
1932,2020-10-10,2020-10-10,100043,Cheque Issued,990.52,0.00,951736.43
1933,2020-10-10,2020-10-10,,Utility Payment,102.34,0.00,951634.09
1934,2020-10-11,2020-10-10,,Interest Credited,0.00,58.81,951692.90
1935,2020-10-10,2020-10-10,,Credit Card Payment,410.82,0.00,951282.08
1936,2020-10-10,2020-10-10,,Transfer Received,0.00,1494.49,952776.57
1937,2020-10-10,2020-10-10,,Groceries - Supermarket,148.04,0.00,952628.53
1938,2020-10-10,2020-10-10,,Loan EMI,792.49,0.00,951836.04
1939,2020-10-10,2020-10-10,,ATM Withdrawal,455.20,0.00,951380.84
1940,2020-10-11,2020-10-10,,ATM Withdrawal,148.26,0.00,951232.58
1941,2020-10-10,2020-10-10,,Salary Credit,0.00,2435.75,953668.33
1942,2020-10-10,2020-10-10,,Online Transfer,564.00,0.00,953104.33
1943,2020-10-10,2020-10-10,,ATM Withdrawal,199.35,0.00,952904.98
1944,2020-10-11,2020-10-10,,ATM Withdrawal,326.33,0.00,952578.65
1945,2020-10-09,2020-10-10,,Dining Out,82.68,0.00,952495.97
1946,2020-10-10,2020-10-10,,Online Transfer,1615.96,0.00,950880.01
1947,2020-10-10,2020-10-10,,Utility Payment,229.03,0.00,950650.98
1948,2020-10-12,2020-10-11,,Transfer Received,0.00,2489.85,953140.83
1949,2020-10-11,2020-10-11,,Investment - Stocks,4257.06,0.00,948883.77
1950,2020-10-10,2020-10-11,,ATM Withdrawal,42.29,0.00,948841.48
1951,2020-10-11,2020-10-11,,Coffee Shop,10.39,0.00,948831.09
1952,2020-10-12,2020-10-11,,Cash Deposit,0.00,375.24,949206.33
1953,2020-10-10,2020-10-11,,Dividend Received,0.00,425.52,949631.85
1954,2020-10-11,2020-10-11,,Credit Card Payment,320.87,0.00,949310.98
1955,2020-10-11,2020-10-11,,Investment Returns,0.00,425.34,949736.32
1956,2020-10-12,2020-10-12,,Credit Card Payment,304.81,0.00,949431.51
1957,2020-10-12,2020-10-12,,Daily Essentials,48.65,0.00,949382.86
1958,2020-10-12,2020-10-12,,Dining Out,38.27,0.00,949344.59
1959,2020-10-12,2020-10-12,,Utility Payment,278.85,0.00,949065.74
1960,2020-10-14,2020-10-13,,Groceries - Supermarket,142.82,0.00,948922.92
1961,2020-10-13,2020-10-13,,Salary Credit,0.00,3046.58,951969.50
1962,2020-10-14,2020-10-13,,Groceries - Supermarket,160.38,0.00,951809.12
1963,2020-10-14,2020-10-13,,Online Transfer,418.65,0.00,951390.47
1964,2020-10-14,2020-10-13,,Daily Essentials,14.06,0.00,951376.41
1965,2020-10-13,2020-10-13,,Credit Card Payment,815.14,0.00,950561.27
1966,2020-10-13,2020-10-13,,Transfer Received,0.00,2640.50,953201.77
1967,2020-10-12,2020-10-13,,Dividend Received,0.00,414.53,953616.30
1968,2020-10-14,2020-10-14,,Credit Card Payment,505.18,0.00,953111.12
1969,2020-10-14,2020-10-14,,Utility Payment,198.98,0.00,952912.14
1970,2020-10-15,2020-10-14,,Credit Card Payment,367.32,0.00,952544.82
1971,2020-10-14,2020-10-14,,Interest Credited,0.00,14.65,952559.47
1972,2020-10-14,2020-10-14,,Online Transfer,1103.04,0.00,951456.43
1973,2020-10-14,2020-10-14,,Transfer Received,0.00,578.07,952034.50
1974,2020-10-15,2020-10-14,,ATM Withdrawal,140.34,0.00,951894.16
1975,2020-10-15,2020-10-15,,Groceries - Supermarket,91.71,0.00,951802.45
1976,2020-10-15,2020-10-15,,ATM Withdrawal,465.97,0.00,951336.48
1977,2020-10-15,2020-10-15,,Transfer Received,0.00,2660.83,953997.31
1978,2020-10-15,2020-10-15,,Transfer Received,0.00,2644.66,956641.97
1979,2020-10-15,2020-10-15,,Salary Credit,0.00,2070.71,958712.68
1980,2020-10-16,2020-10-15,,Rental Income,0.00,2995.57,961708.25
1981,2020-10-15,2020-10-15,,Transfer Received,0.00,1061.06,962769.31
1982,2020-10-16,2020-10-16,,Dividend Received,0.00,130.46,962899.77
1983,2020-10-16,2020-10-16,,ATM Withdrawal,441.22,0.00,962458.55
1984,2020-10-15,2020-10-16,,Interest Credited,0.00,16.17,962474.72
1985,2020-10-17,2020-10-16,,Groceries - Online Delivery,147.37,0.00,962327.35
1986,2020-10-16,2020-10-16,,ATM Withdrawal,389.44,0.00,961937.91
1987,2020-10-16,2020-10-16,,Transfer Received,0.00,2766.57,964704.48
1988,2020-10-16,2020-10-16,,Salary Credit,0.00,3341.60,968046.08
1989,2020-10-16,2020-10-16,,Transfer Received,0.00,2424.01,970470.09
1990,2020-10-18,2020-10-17,,Rental Income,0.00,1154.48,971624.57
1991,2020-10-17,2020-10-17,,Loan EMI,1891.82,0.00,969732.75
1992,2020-10-17,2020-10-17,,Salary Credit,0.00,3888.53,973621.28
1993,2020-10-17,2020-10-17,,Loan EMI,1312.70,0.00,972308.58
1994,2020-10-16,2020-10-17,,Utility Payment,77.53,0.00,972231.05
1995,2020-10-17,2020-10-17,,Investment - SIP,693.45,0.00,971537.60
1996,2020-10-17,2020-10-17,,ATM Withdrawal,480.27,0.00,971057.33
1997,2020-10-17,2020-10-17,,Groceries - Supermarket,193.74,0.00,970863.59
1998,2020-10-17,2020-10-17,,Dining Out,63.76,0.00,970799.83
1999,2020-10-17,2020-10-17,,Takeout,29.10,0.00,970770.73
2000,2020-10-18,2020-10-18,,Daily Essentials,8.46,0.00,970762.27
2001,2020-10-18,2020-10-18,,Groceries - Online Delivery,94.39,0.00,970667.88
2002,2020-10-19,2020-10-18,,Groceries - Supermarket,186.56,0.00,970481.32
2003,2020-10-19,2020-10-18,,ATM Withdrawal,165.95,0.00,970315.37
2004,2020-10-19,2020-10-18,,Transfer Received,0.00,1346.52,971661.89
2005,2020-10-18,2020-10-18,,Takeout,38.53,0.00,971623.36
2006,2020-10-19,2020-10-19,,Transfer Received,0.00,2734.74,974358.10
2007,2020-10-19,2020-10-19,,Salary Credit,0.00,4825.37,979183.47
2008,2020-10-18,2020-10-19,,Investment - Mutual Funds,1943.83,0.00,977239.64
2009,2020-10-19,2020-10-19,,Salary Credit,0.00,2835.50,980075.14
2010,2020-10-19,2020-10-19,,Loan EMI,1080.75,0.00,978994.39
2011,2020-10-19,2020-10-19,,ATM Withdrawal,434.60,0.00,978559.79
2012,2020-10-18,2020-10-19,,Transfer Received,0.00,2829.34,981389.13
2013,2020-10-19,2020-10-19,,Transfer Received,0.00,1914.89,983304.02
2014,2020-10-20,2020-10-19,,Rental Income,0.00,1742.33,985046.35
2015,2020-10-20,2020-10-20,100044,Cheque Issued,2884.27,0.00,982162.08
2016,2020-10-20,2020-10-20,,Investment Returns,0.00,287.38,982449.46
2017,2020-10-21,2020-10-20,,Utility Payment,161.81,0.00,982287.65
2018,2020-10-21,2020-10-20,,Salary Credit,0.00,4766.74,987054.39
2019,2020-10-21,2020-10-21,,Cash Deposit,0.00,906.45,987960.84
2020,2020-10-22,2020-10-21,,ATM Withdrawal,209.18,0.00,987751.66
2021,2020-10-20,2020-10-21,,Credit Card Payment,560.61,0.00,987191.05
2022,2020-10-21,2020-10-21,,Groceries - Supermarket,22.71,0.00,987168.34
2023,2020-10-21,2020-10-21,,ATM Withdrawal,155.17,0.00,987013.17
2024,2020-10-21,2020-10-21,,Dividend Received,0.00,219.37,987232.54
2025,2020-10-21,2020-10-21,,ATM Withdrawal,444.46,0.00,986788.08
2026,2020-10-21,2020-10-21,100045,Cheque Issued,580.78,0.00,986207.30
2027,2020-10-22,2020-10-22,,Online Transfer,185.90,0.00,986021.40
2028,2020-10-22,2020-10-22,,Interest Credited,0.00,23.68,986045.08
2029,2020-10-22,2020-10-22,,Credit Card Payment,276.98,0.00,985768.10
2030,2020-10-23,2020-10-22,,Dividend Received,0.00,179.22,985947.32
2031,2020-10-21,2020-10-22,,Salary Credit,0.00,4581.68,990529.00
2032,2020-10-22,2020-10-22,,Utility Payment,92.68,0.00,990436.32
2033,2020-10-22,2020-10-22,,ATM Withdrawal,159.63,0.00,990276.69
2034,2020-10-21,2020-10-22,,Online Transfer,1971.88,0.00,988304.81
2035,2020-10-22,2020-10-22,,Investment Returns,0.00,490.75,988795.56
2036,2020-10-22,2020-10-22,,Credit Card Payment,840.18,0.00,987955.38
2037,2020-10-23,2020-10-23,,Investment Returns,0.00,644.48,988599.86
2038,2020-10-23,2020-10-23,,Takeout,19.61,0.00,988580.25
2039,2020-10-22,2020-10-23,,Groceries - Online Delivery,148.57,0.00,988431.68
2040,2020-10-22,2020-10-23,,ATM Withdrawal,417.46,0.00,988014.22
2041,2020-10-23,2020-10-23,,Transfer Received,0.00,2793.71,990807.93
2042,2020-10-24,2020-10-23,,Credit Card Payment,317.51,0.00,990490.42
2043,2020-10-23,2020-10-23,,Rental Income,0.00,2881.38,993371.80
2044,2020-10-23,2020-10-23,,Interest Credited,0.00,14.02,993385.82
2045,2020-10-24,2020-10-24,,Salary Credit,0.00,4983.15,998368.97
2046,2020-10-24,2020-10-24,,Salary Credit,0.00,4881.29,1003250.26
2047,2020-10-24,2020-10-24,,Salary Credit,0.00,4803.53,1008053.79
2048,2020-10-23,2020-10-24,,Transfer Received,0.00,1658.67,1009712.46
2049,2020-10-24,2020-10-24,,Credit Card Payment,744.67,0.00,1008967.79
2050,2020-10-24,2020-10-24,,ATM Withdrawal,393.04,0.00,1008574.75
2051,2020-10-24,2020-10-25,,Loan EMI,1567.97,0.00,1007006.78
2052,2020-10-25,2020-10-25,100046,Cheque Issued,2800.01,0.00,1004206.77
2053,2020-10-25,2020-10-25,,Transfer Received,0.00,1988.95,1006195.72
2054,2020-10-25,2020-10-25,,Groceries - Online Delivery,122.60,0.00,1006073.12
2055,2020-10-25,2020-10-25,,Transfer Received,0.00,1843.22,1007916.34
2056,2020-10-25,2020-10-25,,Transfer Received,0.00,2580.59,1010496.93
2057,2020-10-26,2020-10-26,,Transfer Received,0.00,2381.02,1012877.95
2058,2020-10-25,2020-10-26,,Transfer Received,0.00,2146.75,1015024.70
2059,2020-10-26,2020-10-27,,Salary Credit,0.00,2523.14,1017547.84
2060,2020-10-27,2020-10-27,,Transfer Received,0.00,1510.78,1019058.62
2061,2020-10-27,2020-10-27,,Transfer Received,0.00,2777.23,1021835.85
2062,2020-10-27,2020-10-27,,Transfer Received,0.00,2021.92,1023857.77
2063,2020-10-28,2020-10-28,100047,Cheque Issued,1532.40,0.00,1022325.37
2064,2020-10-27,2020-10-28,,Utility Payment,115.68,0.00,1022209.69
2065,2020-10-29,2020-10-28,,Dividend Received,0.00,245.59,1022455.28
2066,2020-10-28,2020-10-28,,Credit Card Payment,232.32,0.00,1022222.96
2067,2020-10-28,2020-10-28,,Transfer Received,0.00,967.66,1023190.62
2068,2020-10-28,2020-10-28,,Interest Credited,0.00,27.70,1023218.32
2069,2020-10-29,2020-10-29,,Daily Essentials,48.28,0.00,1023170.04
2070,2020-10-29,2020-10-29,,Dining Out,38.47,0.00,1023131.57
2071,2020-10-29,2020-10-29,,Daily Essentials,24.90,0.00,1023106.67
2072,2020-10-30,2020-10-29,,Cash Deposit,0.00,371.74,1023478.41
2073,2020-10-29,2020-10-29,,Investment - Stocks,1543.34,0.00,1021935.07
2074,2020-10-28,2020-10-29,,Transfer Received,0.00,1683.81,1023618.88
2075,2020-10-28,2020-10-29,,Credit Card Payment,809.47,0.00,1022809.41
2076,2020-10-30,2020-10-30,,Salary Credit,0.00,2335.04,1025144.45
2077,2020-10-31,2020-10-30,,Dividend Received,0.00,349.34,1025493.79
2078,2020-10-30,2020-10-30,,Salary Credit,0.00,2555.62,1028049.41
2079,2020-10-29,2020-10-30,,ATM Withdrawal,381.17,0.00,1027668.24
2080,2020-10-29,2020-10-30,,Transfer Received,0.00,1753.70,1029421.94
2081,2020-10-29,2020-10-30,,Groceries - Online Delivery,91.34,0.00,1029330.60
2082,2020-10-31,2020-10-31,,Investment Returns,0.00,70.74,1029401.34
2083,2020-10-31,2020-10-31,,Interest Credited,0.00,45.20,1029446.54
2084,2020-10-31,2020-10-31,,Transfer Received,0.00,1429.27,1030875.81
2085,2020-11-01,2020-10-31,,Daily Essentials,36.39,0.00,1030839.42
2086,2020-10-31,2020-10-31,,Dividend Received,0.00,417.68,1031257.10
2087,2020-10-31,2020-10-31,,Salary Credit,0.00,3605.09,1034862.19
2088,2020-10-31,2020-10-31,,Online Transfer,499.82,0.00,1034362.37
2089,2020-10-31,2020-10-31,,Transfer Received,0.00,1072.01,1035434.38
2090,2020-10-31,2020-10-31,,Dividend Received,0.00,104.84,1035539.22
2091,2020-11-01,2020-11-01,,Transfer Received,0.00,2697.24,1038236.46
2092,2020-11-01,2020-11-01,,ATM Withdrawal,463.57,0.00,1037772.89
2093,2020-11-01,2020-11-01,,Loan EMI,1086.92,0.00,1036685.97
2094,2020-11-01,2020-11-01,,Transfer Received,0.00,2407.21,1039093.18
2095,2020-11-01,2020-11-01,,Dividend Received,0.00,270.54,1039363.72
2096,2020-11-02,2020-11-01,,Groceries - Supermarket,66.52,0.00,1039297.20
2097,2020-11-01,2020-11-01,,Investment - SIP,382.51,0.00,1038914.69
2098,2020-11-01,2020-11-01,,Online Transfer,1471.01,0.00,1037443.68
2099,2020-10-31,2020-11-01,,Utility Payment,158.04,0.00,1037285.64
2100,2020-11-02,2020-11-02,,ATM Withdrawal,476.55,0.00,1036809.09
2101,2020-11-02,2020-11-02,,Takeout,34.53,0.00,1036774.56
2102,2020-11-02,2020-11-02,,Interest Credited,0.00,15.29,1036789.85
2103,2020-11-02,2020-11-02,,Groceries - Supermarket,112.46,0.00,1036677.39
2104,2020-11-02,2020-11-02,,Transfer Received,0.00,2242.83,1038920.22
2105,2020-11-02,2020-11-02,,Interest Credited,0.00,32.96,1038953.18
2106,2020-11-02,2020-11-02,,Groceries - Supermarket,33.92,0.00,1038919.26
2107,2020-11-03,2020-11-03,,Salary Credit,0.00,3610.53,1042529.79
2108,2020-11-04,2020-11-03,,Groceries - Supermarket,64.74,0.00,1042465.05
2109,2020-11-04,2020-11-04,,ATM Withdrawal,171.57,0.00,1042293.48
2110,2020-11-04,2020-11-04,,Online Transfer,394.98,0.00,1041898.50
2111,2020-11-04,2020-11-04,,Groceries - Supermarket,55.77,0.00,1041842.73
2112,2020-11-04,2020-11-04,,Salary Credit,0.00,4589.84,1046432.57
2113,2020-11-05,2020-11-05,,Groceries - Supermarket,149.31,0.00,1046283.26
2114,2020-11-04,2020-11-05,,ATM Withdrawal,496.80,0.00,1045786.46
2115,2020-11-05,2020-11-05,,Salary Credit,0.00,4901.44,1050687.90
2116,2020-11-05,2020-11-05,,ATM Withdrawal,322.75,0.00,1050365.15
2117,2020-11-05,2020-11-05,,Salary Credit,0.00,4545.14,1054910.29
2118,2020-11-06,2020-11-06,,Utility Payment,111.38,0.00,1054798.91
2119,2020-11-07,2020-11-06,,Salary Credit,0.00,4619.18,1059418.09
2120,2020-11-06,2020-11-06,,Salary Credit,0.00,3281.99,1062700.08
2121,2020-11-06,2020-11-06,,Interest Credited,0.00,57.68,1062757.76
2122,2020-11-06,2020-11-06,,Daily Essentials,19.15,0.00,1062738.61
2123,2020-11-07,2020-11-06,,Credit Card Payment,965.21,0.00,1061773.40
2124,2020-11-07,2020-11-06,,Transfer Received,0.00,556.88,1062330.28
2125,2020-11-06,2020-11-06,100048,Cheque Issued,1951.41,0.00,1060378.87
2126,2020-11-07,2020-11-07,,Daily Essentials,37.92,0.00,1060340.95
2127,2020-11-06,2020-11-07,,Utility Payment,53.26,0.00,1060287.69
2128,2020-11-08,2020-11-07,,Transfer Received,0.00,1353.66,1061641.35
2129,2020-11-07,2020-11-07,,Transfer Received,0.00,2835.44,1064476.79
2130,2020-11-08,2020-11-07,,Daily Essentials,18.20,0.00,1064458.59
2131,2020-11-08,2020-11-08,,Groceries - Online Delivery,75.53,0.00,1064383.06
2132,2020-11-07,2020-11-08,,Transfer Received,0.00,538.76,1064921.82
2133,2020-11-08,2020-11-08,,Transfer Received,0.00,2542.31,1067464.13
2134,2020-11-09,2020-11-08,,Investment - Stocks,1193.25,0.00,1066270.88
2135,2020-11-07,2020-11-08,,Dividend Received,0.00,78.75,1066349.63
2136,2020-11-08,2020-11-08,,Interest Credited,0.00,52.68,1066402.31
2137,2020-11-08,2020-11-08,,Groceries - Supermarket,89.72,0.00,1066312.59
2138,2020-11-09,2020-11-09,,Salary Credit,0.00,3299.44,1069612.03
2139,2020-11-09,2020-11-09,,Credit Card Payment,784.05,0.00,1068827.98
2140,2020-11-09,2020-11-09,,Online Transfer,363.32,0.00,1068464.66
2141,2020-11-09,2020-11-09,,Dividend Received,0.00,369.95,1068834.61
2142,2020-11-08,2020-11-09,,Utility Payment,295.46,0.00,1068539.15
2143,2020-11-09,2020-11-09,,Groceries - Supermarket,83.27,0.00,1068455.88
2144,2020-11-10,2020-11-10,,Transfer Received,0.00,2360.99,1070816.87
2145,2020-11-10,2020-11-10,,Salary Credit,0.00,2042.55,1072859.42
2146,2020-11-10,2020-11-10,,Investment - Mutual Funds,710.94,0.00,1072148.48
2147,2020-11-09,2020-11-10,,Credit Card Payment,229.77,0.00,1071918.71
2148,2020-11-11,2020-11-11,,Groceries - Supermarket,199.09,0.00,1071719.62
2149,2020-11-11,2020-11-11,,Transfer Received,0.00,1506.43,1073226.05
2150,2020-11-11,2020-11-11,,Interest Credited,0.00,98.20,1073324.25
2151,2020-11-12,2020-11-11,,Dining Out,32.57,0.00,1073291.68
2152,2020-11-11,2020-11-11,,Investment Returns,0.00,225.64,1073517.32
2153,2020-11-11,2020-11-11,,Salary Credit,0.00,2098.25,1075615.57
2154,2020-11-13,2020-11-12,,Utility Payment,172.42,0.00,1075443.15
2155,2020-11-13,2020-11-12,,Utility Payment,288.24,0.00,1075154.91
2156,2020-11-12,2020-11-12,,Rental Income,0.00,2063.37,1077218.28
2157,2020-11-12,2020-11-12,,Dining Out,15.60,0.00,1077202.68
2158,2020-11-12,2020-11-12,,Interest Credited,0.00,79.31,1077281.99
2159,2020-11-12,2020-11-12,,Utility Payment,114.46,0.00,1077167.53
2160,2020-11-12,2020-11-12,,Salary Credit,0.00,3445.02,1080612.55
2161,2020-11-12,2020-11-12,,Groceries - Supermarket,71.69,0.00,1080540.86
2162,2020-11-12,2020-11-12,,Utility Payment,225.76,0.00,1080315.10
2163,2020-11-12,2020-11-12,,ATM Withdrawal,235.51,0.00,1080079.59
2164,2020-11-13,2020-11-13,,Transfer Received,0.00,865.73,1080945.32
2165,2020-11-12,2020-11-13,,Coffee Shop,11.08,0.00,1080934.24
2166,2020-11-13,2020-11-13,,Utility Payment,253.71,0.00,1080680.53
2167,2020-11-14,2020-11-13,,Groceries - Online Delivery,124.36,0.00,1080556.17
2168,2020-11-14,2020-11-13,,Transfer Received,0.00,2525.86,1083082.03
2169,2020-11-12,2020-11-13,,Loan EMI,1393.90,0.00,1081688.13
2170,2020-11-14,2020-11-14,,Groceries - Supermarket,141.55,0.00,1081546.58
2171,2020-11-14,2020-11-14,,Credit Card Payment,859.78,0.00,1080686.80
2172,2020-11-14,2020-11-14,,Groceries - Supermarket,189.81,0.00,1080496.99
2173,2020-11-15,2020-11-14,,Interest Credited,0.00,72.91,1080569.90
2174,2020-11-14,2020-11-14,,Groceries - Supermarket,64.69,0.00,1080505.21
2175,2020-11-14,2020-11-14,,Utility Payment,82.38,0.00,1080422.83
2176,2020-11-15,2020-11-15,,Dining Out,89.93,0.00,1080332.90
2177,2020-11-16,2020-11-15,,ATM Withdrawal,247.63,0.00,1080085.27
2178,2020-11-16,2020-11-15,,Transfer Received,0.00,664.94,1080750.21
2179,2020-11-16,2020-11-15,,Groceries - Supermarket,133.14,0.00,1080617.07
2180,2020-11-14,2020-11-15,,Groceries - Supermarket,56.43,0.00,1080560.64
2181,2020-11-16,2020-11-15,,Salary Credit,0.00,2494.02,1083054.66
2182,2020-11-15,2020-11-15,,Investment - Mutual Funds,1949.01,0.00,1081105.65
2183,2020-11-14,2020-11-15,,Transfer Received,0.00,1321.99,1082427.64
2184,2020-11-16,2020-11-15,,Transfer Received,0.00,677.42,1083105.06
2185,2020-11-15,2020-11-16,,Salary Credit,0.00,2465.25,1085570.31
2186,2020-11-16,2020-11-16,,Online Transfer,357.78,0.00,1085212.53
2187,2020-11-17,2020-11-16,,Transfer Received,0.00,1917.26,1087129.79
2188,2020-11-16,2020-11-16,,Dining Out,88.24,0.00,1087041.55
2189,2020-11-16,2020-11-16,,ATM Withdrawal,492.97,0.00,1086548.58
2190,2020-11-16,2020-11-16,,Investment - Mutual Funds,1668.81,0.00,1084879.77
2191,2020-11-16,2020-11-16,,Interest Credited,0.00,58.22,1084937.99
2192,2020-11-16,2020-11-16,,Credit Card Payment,290.55,0.00,1084647.44
2193,2020-11-17,2020-11-17,,Salary Credit,0.00,4663.73,1089311.17
2194,2020-11-17,2020-11-17,,Investment - Mutual Funds,1346.54,0.00,1087964.63
2195,2020-11-19,2020-11-18,,ATM Withdrawal,242.19,0.00,1087722.44
2196,2020-11-18,2020-11-18,,ATM Withdrawal,346.82,0.00,1087375.62
2197,2020-11-18,2020-11-18,,ATM Withdrawal,202.03,0.00,1087173.59
2198,2020-11-18,2020-11-18,,ATM Withdrawal,374.57,0.00,1086799.02
2199,2020-11-18,2020-11-18,,Interest Credited,0.00,98.39,1086897.41
2200,2020-11-18,2020-11-18,,Utility Payment,102.21,0.00,1086795.20
2201,2020-11-18,2020-11-18,,Interest Credited,0.00,50.98,1086846.18
2202,2020-11-18,2020-11-18,,Groceries - Online Delivery,105.13,0.00,1086741.05
2203,2020-11-19,2020-11-18,,Salary Credit,0.00,3717.66,1090458.71
2204,2020-11-19,2020-11-19,,Groceries - Supermarket,165.68,0.00,1090293.03
2205,2020-11-19,2020-11-19,,Online Transfer,1703.26,0.00,1088589.77
2206,2020-11-18,2020-11-19,,Online Transfer,250.06,0.00,1088339.71
2207,2020-11-18,2020-11-19,,ATM Withdrawal,86.30,0.00,1088253.41
2208,2020-11-19,2020-11-19,,Investment Returns,0.00,174.93,1088428.34
2209,2020-11-19,2020-11-19,,Groceries - Supermarket,123.33,0.00,1088305.01
2210,2020-11-19,2020-11-19,,Transfer Received,0.00,831.20,1089136.21
2211,2020-11-19,2020-11-19,,ATM Withdrawal,188.00,0.00,1088948.21
2212,2020-11-21,2020-11-20,,Transfer Received,0.00,1104.36,1090052.57
2213,2020-11-20,2020-11-20,,Groceries - Online Delivery,64.71,0.00,1089987.86
2214,2020-11-21,2020-11-20,,ATM Withdrawal,125.44,0.00,1089862.42
2215,2020-11-19,2020-11-20,,Groceries - Supermarket,132.59,0.00,1089729.83
2216,2020-11-20,2020-11-20,,Daily Essentials,14.72,0.00,1089715.11
2217,2020-11-21,2020-11-21,,Groceries - Supermarket,135.85,0.00,1089579.26
2218,2020-11-22,2020-11-21,,Credit Card Payment,458.81,0.00,1089120.45
2219,2020-11-22,2020-11-21,,Salary Credit,0.00,3753.77,1092874.22
2220,2020-11-21,2020-11-21,,Utility Payment,54.72,0.00,1092819.50
2221,2020-11-22,2020-11-21,,Groceries - Online Delivery,124.38,0.00,1092695.12
2222,2020-11-21,2020-11-21,,Groceries - Supermarket,169.33,0.00,1092525.79
2223,2020-11-21,2020-11-21,,ATM Withdrawal,434.64,0.00,1092091.15
2224,2020-11-21,2020-11-21,,Credit Card Payment,672.90,0.00,1091418.25
2225,2020-11-22,2020-11-22,,Interest Credited,0.00,68.22,1091486.47
2226,2020-11-22,2020-11-22,,Salary Credit,0.00,4645.56,1096132.03
2227,2020-11-21,2020-11-22,,Utility Payment,234.36,0.00,1095897.67
2228,2020-11-22,2020-11-22,,ATM Withdrawal,428.98,0.00,1095468.69
2229,2020-11-21,2020-11-22,,Groceries - Supermarket,154.03,0.00,1095314.66
2230,2020-11-21,2020-11-22,,Credit Card Payment,211.08,0.00,1095103.58
2231,2020-11-21,2020-11-22,100049,Cheque Issued,1613.76,0.00,1093489.82
2232,2020-11-22,2020-11-23,,Online Transfer,1795.23,0.00,1091694.59
2233,2020-11-24,2020-11-24,,Salary Credit,0.00,2402.33,1094096.92
2234,2020-11-24,2020-11-24,,Groceries - Supermarket,195.49,0.00,1093901.43
2235,2020-11-23,2020-11-24,,Daily Essentials,44.66,0.00,1093856.77
2236,2020-11-24,2020-11-25,,Salary Credit,0.00,2800.49,1096657.26
2237,2020-11-24,2020-11-25,,Utility Payment,196.42,0.00,1096460.84
2238,2020-11-25,2020-11-25,,Transfer Received,0.00,1047.19,1097508.03
2239,2020-11-25,2020-11-25,,Investment - Mutual Funds,1265.93,0.00,1096242.10
2240,2020-11-26,2020-11-26,,Online Transfer,1243.97,0.00,1094998.13
2241,2020-11-26,2020-11-26,,ATM Withdrawal,304.35,0.00,1094693.78
2242,2020-11-26,2020-11-26,,Interest Credited,0.00,17.31,1094711.09
2243,2020-11-26,2020-11-26,,Coffee Shop,7.06,0.00,1094704.03
2244,2020-11-25,2020-11-26,,Online Transfer,1522.31,0.00,1093181.72
2245,2020-11-26,2020-11-26,,Interest Credited,0.00,98.98,1093280.70
2246,2020-11-26,2020-11-26,100050,Cheque Issued,1550.35,0.00,1091730.35
2247,2020-11-26,2020-11-26,,Salary Credit,0.00,2388.89,1094119.24
2248,2020-11-26,2020-11-26,,Groceries - Supermarket,93.81,0.00,1094025.43
2249,2020-11-27,2020-11-27,,ATM Withdrawal,111.64,0.00,1093913.79
2250,2020-11-27,2020-11-27,,Salary Credit,0.00,3192.93,1097106.72
2251,2020-11-27,2020-11-27,,Groceries - Online Delivery,89.05,0.00,1097017.67
2252,2020-11-27,2020-11-27,,Dining Out,49.90,0.00,1096967.77
2253,2020-11-28,2020-11-27,,Groceries - Supermarket,41.91,0.00,1096925.86
2254,2020-11-27,2020-11-27,,Investment - Mutual Funds,1236.61,0.00,1095689.25
2255,2020-11-27,2020-11-27,,ATM Withdrawal,488.39,0.00,1095200.86
2256,2020-11-28,2020-11-27,,Credit Card Payment,621.06,0.00,1094579.80
2257,2020-11-29,2020-11-28,,Loan EMI,1567.31,0.00,1093012.49
2258,2020-11-28,2020-11-28,,Transfer Received,0.00,591.28,1093603.77
2259,2020-11-27,2020-11-28,,Salary Credit,0.00,4126.04,1097729.81
2260,2020-11-27,2020-11-28,,Groceries - Supermarket,45.30,0.00,1097684.51
2261,2020-11-29,2020-11-29,,Transfer Received,0.00,1879.47,1099563.98
2262,2020-11-29,2020-11-29,,ATM Withdrawal,307.36,0.00,1099256.62
2263,2020-11-29,2020-11-29,,Credit Card Payment,276.80,0.00,1098979.82
2264,2020-11-29,2020-11-29,,Cash Deposit,0.00,326.01,1099305.83
2265,2020-12-01,2020-11-30,,ATM Withdrawal,369.39,0.00,1098936.44
2266,2020-11-30,2020-11-30,100051,Cheque Issued,1807.60,0.00,1097128.84
2267,2020-12-01,2020-11-30,,Online Transfer,1008.77,0.00,1096120.07
2268,2020-11-30,2020-11-30,,Dining Out,31.42,0.00,1096088.65
2269,2020-12-01,2020-11-30,,Coffee Shop,16.05,0.00,1096072.60
2270,2020-11-30,2020-11-30,,Groceries - Online Delivery,98.26,0.00,1095974.34
2271,2020-12-01,2020-12-01,,Transfer Received,0.00,675.97,1096650.31
2272,2020-12-01,2020-12-01,,Groceries - Online Delivery,119.64,0.00,1096530.67
2273,2020-11-30,2020-12-01,100052,Cheque Issued,852.26,0.00,1095678.41
2274,2020-12-02,2020-12-01,,Groceries - Supermarket,143.46,0.00,1095534.95
2275,2020-12-02,2020-12-01,,Dividend Received,0.00,462.53,1095997.48
2276,2020-12-02,2020-12-01,,Online Transfer,1028.92,0.00,1094968.56
2277,2020-12-01,2020-12-01,,Rental Income,0.00,2291.64,1097260.20
2278,2020-12-02,2020-12-02,,Credit Card Payment,926.64,0.00,1096333.56
2279,2020-12-03,2020-12-02,,Utility Payment,145.88,0.00,1096187.68
2280,2020-12-02,2020-12-02,,ATM Withdrawal,257.31,0.00,1095930.37
2281,2020-12-02,2020-12-02,,Groceries - Supermarket,148.63,0.00,1095781.74
2282,2020-12-01,2020-12-02,,Transfer Received,0.00,802.80,1096584.54
2283,2020-12-01,2020-12-02,,Loan EMI,1189.65,0.00,1095394.89
2284,2020-12-03,2020-12-03,,Online Transfer,1585.48,0.00,1093809.41
2285,2020-12-03,2020-12-03,,Groceries - Supermarket,74.23,0.00,1093735.18
2286,2020-12-02,2020-12-03,,Interest Credited,0.00,76.62,1093811.80
2287,2020-12-04,2020-12-03,,Dining Out,29.88,0.00,1093781.92
2288,2020-12-03,2020-12-03,,Salary Credit,0.00,4914.82,1098696.74
2289,2020-12-04,2020-12-03,,Salary Credit,0.00,3721.16,1102417.90
2290,2020-12-05,2020-12-04,,Investment Returns,0.00,329.61,1102747.51
2291,2020-12-03,2020-12-04,,Online Transfer,1420.59,0.00,1101326.92
2292,2020-12-04,2020-12-04,,Takeout,48.61,0.00,1101278.31
2293,2020-12-03,2020-12-04,,Dining Out,23.03,0.00,1101255.28
2294,2020-12-06,2020-12-05,,Transfer Received,0.00,575.27,1101830.55
2295,2020-12-05,2020-12-05,,Loan EMI,822.23,0.00,1101008.32
2296,2020-12-05,2020-12-05,,Online Transfer,1096.17,0.00,1099912.15
2297,2020-12-05,2020-12-05,,Groceries - Supermarket,67.33,0.00,1099844.82
2298,2020-12-06,2020-12-05,,Daily Essentials,42.03,0.00,1099802.79
2299,2020-12-04,2020-12-05,,ATM Withdrawal,250.35,0.00,1099552.44
2300,2020-12-05,2020-12-05,,Rental Income,0.00,1718.03,1101270.47
2301,2020-12-06,2020-12-06,,Online Transfer,1577.72,0.00,1099692.75
2302,2020-12-06,2020-12-06,,Salary Credit,0.00,2105.93,1101798.68
2303,2020-12-06,2020-12-06,,Dividend Received,0.00,298.72,1102097.40
2304,2020-12-06,2020-12-06,,Rental Income,0.00,1668.52,1103765.92
2305,2020-12-06,2020-12-06,,Transfer Received,0.00,732.86,1104498.78
2306,2020-12-06,2020-12-06,,ATM Withdrawal,291.63,0.00,1104207.15
2307,2020-12-06,2020-12-06,,Transfer Received,0.00,1828.31,1106035.46
2308,2020-12-07,2020-12-07,,ATM Withdrawal,246.18,0.00,1105789.28
2309,2020-12-08,2020-12-07,,Dividend Received,0.00,106.25,1105895.53
2310,2020-12-07,2020-12-07,100053,Cheque Issued,1189.30,0.00,1104706.23
2311,2020-12-06,2020-12-07,,Salary Credit,0.00,3248.31,1107954.54
2312,2020-12-06,2020-12-07,,Transfer Received,0.00,1088.52,1109043.06
2313,2020-12-08,2020-12-08,,Transfer Received,0.00,2148.31,1111191.37
2314,2020-12-08,2020-12-08,,Interest Credited,0.00,75.66,1111267.03
2315,2020-12-08,2020-12-08,,Utility Payment,235.14,0.00,1111031.89
2316,2020-12-07,2020-12-08,,Dividend Received,0.00,160.22,1111192.11
2317,2020-12-09,2020-12-08,,Online Transfer,867.13,0.00,1110324.98
2318,2020-12-08,2020-12-08,,Transfer Received,0.00,1402.22,1111727.20
2319,2020-12-09,2020-12-09,,Credit Card Payment,492.40,0.00,1111234.80
2320,2020-12-09,2020-12-09,,Groceries - Supermarket,75.31,0.00,1111159.49
2321,2020-12-09,2020-12-09,,Utility Payment,181.75,0.00,1110977.74
2322,2020-12-09,2020-12-09,,ATM Withdrawal,266.68,0.00,1110711.06
2323,2020-12-09,2020-12-09,,Groceries - Supermarket,191.04,0.00,1110520.02
2324,2020-12-10,2020-12-09,,Transfer Received,0.00,2414.14,1112934.16
2325,2020-12-10,2020-12-09,100054,Cheque Issued,2768.79,0.00,1110165.37
2326,2020-12-08,2020-12-09,,Dining Out,22.77,0.00,1110142.60
2327,2020-12-09,2020-12-09,,Online Transfer,287.33,0.00,1109855.27
2328,2020-12-10,2020-12-09,,Salary Credit,0.00,2041.00,1111896.27
2329,2020-12-09,2020-12-09,,Utility Payment,84.38,0.00,1111811.89
2330,2020-12-08,2020-12-09,,Online Transfer,206.55,0.00,1111605.34
2331,2020-12-10,2020-12-10,,Groceries - Supermarket,97.68,0.00,1111507.66
2332,2020-12-09,2020-12-10,,ATM Withdrawal,121.08,0.00,1111386.58
2333,2020-12-09,2020-12-10,,Groceries - Supermarket,164.12,0.00,1111222.46
2334,2020-12-10,2020-12-10,,Salary Credit,0.00,3100.98,1114323.44
2335,2020-12-09,2020-12-10,,Daily Essentials,34.70,0.00,1114288.74
2336,2020-12-09,2020-12-10,,Investment - Stocks,3236.48,0.00,1111052.26
2337,2020-12-10,2020-12-10,,Online Transfer,866.96,0.00,1110185.30
2338,2020-12-10,2020-12-10,,Groceries - Supermarket,169.14,0.00,1110016.16
2339,2020-12-10,2020-12-10,,Groceries - Supermarket,134.85,0.00,1109881.31
2340,2020-12-10,2020-12-10,,Interest Credited,0.00,29.70,1109911.01
2341,2020-12-10,2020-12-10,,Transfer Received,0.00,623.44,1110534.45
2342,2020-12-10,2020-12-10,,Groceries - Supermarket,118.97,0.00,1110415.48
2343,2020-12-10,2020-12-10,100055,Cheque Issued,1289.80,0.00,1109125.68
2344,2020-12-11,2020-12-11,,Online Transfer,1250.32,0.00,1107875.36
2345,2020-12-11,2020-12-11,,Dividend Received,0.00,465.22,1108340.58
2346,2020-12-11,2020-12-11,,Online Transfer,109.24,0.00,1108231.34
2347,2020-12-11,2020-12-11,,Investment - Stocks,1437.85,0.00,1106793.49
2348,2020-12-11,2020-12-11,100056,Cheque Issued,1566.76,0.00,1105226.73
2349,2020-12-12,2020-12-12,,Transfer Received,0.00,2328.76,1107555.49
2350,2020-12-12,2020-12-12,,Cash Deposit,0.00,805.41,1108360.90
2351,2020-12-12,2020-12-12,,Coffee Shop,12.56,0.00,1108348.34
2352,2020-12-11,2020-12-12,,Transfer Received,0.00,911.95,1109260.29
2353,2020-12-12,2020-12-12,,Groceries - Supermarket,166.45,0.00,1109093.84
2354,2020-12-13,2020-12-12,,Interest Credited,0.00,90.07,1109183.91
2355,2020-12-12,2020-12-12,,Investment - Mutual Funds,909.29,0.00,1108274.62
2356,2020-12-13,2020-12-13,,Transfer Received,0.00,2123.57,1110398.19
2357,2020-12-13,2020-12-13,,Transfer Received,0.00,2522.20,1112920.39
2358,2020-12-13,2020-12-13,100057,Cheque Issued,2393.67,0.00,1110526.72
2359,2020-12-13,2020-12-13,,Salary Credit,0.00,2786.43,1113313.15
2360,2020-12-13,2020-12-13,,Interest Credited,0.00,64.30,1113377.45
2361,2020-12-14,2020-12-13,100058,Cheque Issued,2565.97,0.00,1110811.48
2362,2020-12-12,2020-12-13,,Salary Credit,0.00,3251.51,1114062.99
2363,2020-12-13,2020-12-13,,Groceries - Supermarket,81.66,0.00,1113981.33
2364,2020-12-13,2020-12-13,,Online Transfer,992.68,0.00,1112988.65
2365,2020-12-13,2020-12-13,,Cash Deposit,0.00,383.25,1113371.90
2366,2020-12-14,2020-12-14,,ATM Withdrawal,204.89,0.00,1113167.01
2367,2020-12-13,2020-12-14,,Coffee Shop,11.22,0.00,1113155.79
2368,2020-12-14,2020-12-14,,Online Transfer,777.78,0.00,1112378.01
2369,2020-12-15,2020-12-14,,Groceries - Supermarket,183.71,0.00,1112194.30
2370,2020-12-13,2020-12-14,,Investment - Mutual Funds,2407.72,0.00,1109786.58
2371,2020-12-15,2020-12-14,,Utility Payment,202.40,0.00,1109584.18
2372,2020-12-15,2020-12-14,,Salary Credit,0.00,2216.84,1111801.02
2373,2020-12-14,2020-12-14,,Loan EMI,1298.74,0.00,1110502.28
2374,2020-12-13,2020-12-14,,Credit Card Payment,264.23,0.00,1110238.05
2375,2020-12-14,2020-12-14,,Dining Out,11.34,0.00,1110226.71
2376,2020-12-16,2020-12-15,,ATM Withdrawal,66.87,0.00,1110159.84
2377,2020-12-15,2020-12-15,,Utility Payment,259.38,0.00,1109900.46
2378,2020-12-16,2020-12-15,,Online Transfer,845.47,0.00,1109054.99
2379,2020-12-14,2020-12-15,,Online Transfer,762.46,0.00,1108292.53
2380,2020-12-14,2020-12-15,,Online Transfer,835.10,0.00,1107457.43
2381,2020-12-15,2020-12-15,,Salary Credit,0.00,4691.48,1112148.91
2382,2020-12-16,2020-12-15,,Online Transfer,617.80,0.00,1111531.11
2383,2020-12-14,2020-12-15,,Groceries - Online Delivery,127.13,0.00,1111403.98
2384,2020-12-17,2020-12-16,,Utility Payment,141.92,0.00,1111262.06
2385,2020-12-16,2020-12-16,,Rental Income,0.00,1605.19,1112867.25
2386,2020-12-15,2020-12-16,,Online Transfer,1274.65,0.00,1111592.60
2387,2020-12-17,2020-12-16,,Transfer Received,0.00,2778.99,1114371.59
2388,2020-12-16,2020-12-16,,ATM Withdrawal,315.97,0.00,1114055.62
2389,2020-12-17,2020-12-17,,Transfer Received,0.00,2139.41,1116195.03
2390,2020-12-17,2020-12-17,,Groceries - Online Delivery,107.33,0.00,1116087.70
2391,2020-12-18,2020-12-17,,Investment Returns,0.00,683.94,1116771.64
2392,2020-12-17,2020-12-17,,Dividend Received,0.00,425.75,1117197.39
2393,2020-12-17,2020-12-17,,ATM Withdrawal,32.98,0.00,1117164.41
2394,2020-12-16,2020-12-17,,Investment - Mutual Funds,656.70,0.00,1116507.71
2395,2020-12-17,2020-12-17,,Groceries - Supermarket,68.37,0.00,1116439.34
2396,2020-12-17,2020-12-18,,Transfer Received,0.00,2119.36,1118558.70
2397,2020-12-18,2020-12-18,,Investment - SIP,477.22,0.00,1118081.48
2398,2020-12-18,2020-12-18,,Groceries - Online Delivery,125.16,0.00,1117956.32
2399,2020-12-18,2020-12-18,,Investment - Mutual Funds,937.39,0.00,1117018.93
2400,2020-12-18,2020-12-18,,Dining Out,39.12,0.00,1116979.81
2401,2020-12-18,2020-12-18,,Loan EMI,702.96,0.00,1116276.85
2402,2020-12-19,2020-12-19,,Coffee Shop,8.64,0.00,1116268.21
2403,2020-12-19,2020-12-19,,Groceries - Online Delivery,132.88,0.00,1116135.33
2404,2020-12-19,2020-12-19,,Rental Income,0.00,1097.40,1117232.73
2405,2020-12-19,2020-12-19,,Takeout,11.33,0.00,1117221.40
2406,2020-12-19,2020-12-19,,ATM Withdrawal,287.54,0.00,1116933.86
2407,2020-12-19,2020-12-19,100059,Cheque Issued,1908.54,0.00,1115025.32
2408,2020-12-19,2020-12-19,,ATM Withdrawal,270.00,0.00,1114755.32
2409,2020-12-20,2020-12-19,,Online Transfer,365.52,0.00,1114389.80
2410,2020-12-19,2020-12-19,,ATM Withdrawal,313.73,0.00,1114076.07
2411,2020-12-20,2020-12-19,,Interest Credited,0.00,16.79,1114092.86
2412,2020-12-20,2020-12-20,,ATM Withdrawal,250.65,0.00,1113842.21
2413,2020-12-21,2020-12-20,,Coffee Shop,7.28,0.00,1113834.93
2414,2020-12-21,2020-12-20,,Interest Credited,0.00,68.73,1113903.66
2415,2020-12-19,2020-12-20,,Online Transfer,1347.83,0.00,1112555.83
2416,2020-12-19,2020-12-20,,Online Transfer,1336.85,0.00,1111218.98
2417,2020-12-19,2020-12-20,,Online Transfer,1880.94,0.00,1109338.04
2418,2020-12-20,2020-12-20,,Groceries - Online Delivery,54.44,0.00,1109283.60
2419,2020-12-20,2020-12-20,,Salary Credit,0.00,3062.83,1112346.43
2420,2020-12-21,2020-12-21,,ATM Withdrawal,444.36,0.00,1111902.07
2421,2020-12-21,2020-12-21,,Online Transfer,1032.08,0.00,1110869.99
2422,2020-12-21,2020-12-21,,Cash Deposit,0.00,871.49,1111741.48
2423,2020-12-21,2020-12-21,,Online Transfer,790.99,0.00,1110950.49
2424,2020-12-21,2020-12-21,,Transfer Received,0.00,1355.70,1112306.19
2425,2020-12-20,2020-12-21,,Interest Credited,0.00,39.28,1112345.47
2426,2020-12-22,2020-12-21,,Investment - SIP,603.39,0.00,1111742.08
2427,2020-12-20,2020-12-21,,Transfer Received,0.00,760.48,1112502.56
2428,2020-12-22,2020-12-22,,Transfer Received,0.00,2628.93,1115131.49
2429,2020-12-22,2020-12-22,,ATM Withdrawal,140.13,0.00,1114991.36
2430,2020-12-22,2020-12-22,,Salary Credit,0.00,4267.31,1119258.67
2431,2020-12-22,2020-12-22,,Transfer Received,0.00,1066.32,1120324.99
2432,2020-12-22,2020-12-22,,Groceries - Supermarket,86.14,0.00,1120238.85
2433,2020-12-22,2020-12-22,,Salary Credit,0.00,2423.35,1122662.20
2434,2020-12-23,2020-12-23,,Groceries - Supermarket,63.46,0.00,1122598.74
2435,2020-12-22,2020-12-23,,Interest Credited,0.00,25.15,1122623.89
2436,2020-12-23,2020-12-23,100060,Cheque Issued,2229.93,0.00,1120393.96
2437,2020-12-24,2020-12-23,,Utility Payment,116.36,0.00,1120277.60
2438,2020-12-22,2020-12-23,,Investment - Mutual Funds,1297.60,0.00,1118980.00
2439,2020-12-24,2020-12-24,,Transfer Received,0.00,2943.65,1121923.65
2440,2020-12-23,2020-12-24,,Transfer Received,0.00,2750.07,1124673.72
2441,2020-12-25,2020-12-24,,Groceries - Supermarket,187.14,0.00,1124486.58
2442,2020-12-24,2020-12-24,,Groceries - Supermarket,61.49,0.00,1124425.09
2443,2020-12-24,2020-12-24,,Salary Credit,0.00,2002.35,1126427.44
2444,2020-12-26,2020-12-25,,Salary Credit,0.00,3853.35,1130280.79
2445,2020-12-25,2020-12-25,,Groceries - Supermarket,61.49,0.00,1130219.30
2446,2020-12-25,2020-12-25,,Transfer Received,0.00,1848.52,1132067.82
2447,2020-12-24,2020-12-25,,Salary Credit,0.00,2367.98,1134435.80
2448,2020-12-25,2020-12-25,,Utility Payment,101.70,0.00,1134334.10
2449,2020-12-24,2020-12-25,,Salary Credit,0.00,4143.51,1138477.61
2450,2020-12-26,2020-12-26,,Interest Credited,0.00,93.84,1138571.45
2451,2020-12-26,2020-12-26,,Investment - Mutual Funds,2963.60,0.00,1135607.85
2452,2020-12-26,2020-12-26,,Utility Payment,187.12,0.00,1135420.73
2453,2020-12-26,2020-12-26,,Online Transfer,1045.05,0.00,1134375.68
2454,2020-12-26,2020-12-26,,Salary Credit,0.00,4119.18,1138494.86
2455,2020-12-26,2020-12-26,,Transfer Received,0.00,2851.78,1141346.64
2456,2020-12-27,2020-12-27,,Salary Credit,0.00,4718.62,1146065.26
2457,2020-12-27,2020-12-27,,Utility Payment,118.52,0.00,1145946.74
2458,2020-12-27,2020-12-27,,Salary Credit,0.00,2522.56,1148469.30
2459,2020-12-28,2020-12-27,,Transfer Received,0.00,2339.89,1150809.19
2460,2020-12-28,2020-12-28,,Cash Deposit,0.00,405.01,1151214.20
2461,2020-12-28,2020-12-28,,Salary Credit,0.00,4591.72,1155805.92
2462,2020-12-28,2020-12-28,,Salary Credit,0.00,2423.05,1158228.97
2463,2020-12-29,2020-12-28,,Transfer Received,0.00,2408.13,1160637.10
2464,2020-12-29,2020-12-29,,Groceries - Supermarket,114.56,0.00,1160522.54
2465,2020-12-29,2020-12-29,,Dividend Received,0.00,468.75,1160991.29
2466,2020-12-29,2020-12-29,,Daily Essentials,25.11,0.00,1160966.18
2467,2020-12-29,2020-12-29,,Dining Out,43.37,0.00,1160922.81
2468,2020-12-30,2020-12-30,,Investment - Mutual Funds,2799.91,0.00,1158122.90
2469,2020-12-30,2020-12-30,,Investment Returns,0.00,783.75,1158906.65
2470,2020-12-30,2020-12-30,,Interest Credited,0.00,29.50,1158936.15
2471,2020-12-29,2020-12-30,,Interest Credited,0.00,74.02,1159010.17
2472,2020-12-30,2020-12-30,100061,Cheque Issued,2232.53,0.00,1156777.64
2473,2020-12-30,2020-12-30,,Online Transfer,1406.48,0.00,1155371.16
2474,2020-12-31,2020-12-31,,Cash Deposit,0.00,175.84,1155547.00
2475,2020-12-31,2020-12-31,,Interest Credited,0.00,55.87,1155602.87
2476,2020-12-31,2020-12-31,,Transfer Received,0.00,704.71,1156307.58
2477,2021-01-01,2020-12-31,,Credit Card Payment,445.61,0.00,1155861.97
2478,2021-01-01,2020-12-31,,Credit Card Payment,366.03,0.00,1155495.94
2479,2020-12-30,2020-12-31,,Salary Credit,0.00,2830.72,1158326.66
2480,2021-01-01,2020-12-31,,Transfer Received,0.00,964.45,1159291.11
2481,2020-12-30,2020-12-31,,Credit Card Payment,205.12,0.00,1159085.99
2482,2021-01-01,2021-01-01,,Credit Card Payment,356.98,0.00,1158729.01
2483,2021-01-01,2021-01-01,,Salary Credit,0.00,3786.62,1162515.63
2484,2021-01-01,2021-01-01,,Groceries - Online Delivery,83.99,0.00,1162431.64
2485,2021-01-02,2021-01-01,,Groceries - Supermarket,74.18,0.00,1162357.46
2486,2021-01-01,2021-01-01,,Groceries - Supermarket,148.58,0.00,1162208.88
2487,2021-01-01,2021-01-01,,Interest Credited,0.00,68.51,1162277.39
2488,2021-01-01,2021-01-01,,Online Transfer,1478.11,0.00,1160799.28
2489,2021-01-02,2021-01-02,,Salary Credit,0.00,3195.49,1163994.77
2490,2021-01-02,2021-01-02,,Daily Essentials,40.08,0.00,1163954.69
2491,2021-01-03,2021-01-02,,Daily Essentials,23.44,0.00,1163931.25
2492,2021-01-02,2021-01-02,,ATM Withdrawal,102.19,0.00,1163829.06
2493,2021-01-01,2021-01-02,,Utility Payment,216.14,0.00,1163612.92
2494,2021-01-01,2021-01-02,,Dividend Received,0.00,433.76,1164046.68
2495,2021-01-03,2021-01-03,,Utility Payment,246.06,0.00,1163800.62
2496,2021-01-03,2021-01-03,,ATM Withdrawal,499.58,0.00,1163301.04
2497,2021-01-03,2021-01-03,,Takeout,29.69,0.00,1163271.35
2498,2021-01-02,2021-01-03,,Transfer Received,0.00,2464.22,1165735.57
2499,2021-01-03,2021-01-03,,Transfer Received,0.00,2330.87,1168066.44
2500,2021-01-02,2021-01-03,,Investment - Mutual Funds,1050.56,0.00,1167015.88
2501,2021-01-03,2021-01-03,,Groceries - Supermarket,138.03,0.00,1166877.85
2502,2021-01-03,2021-01-03,,Groceries - Supermarket,170.06,0.00,1166707.79
2503,2021-01-02,2021-01-03,,Transfer Received,0.00,1765.36,1168473.15
2504,2021-01-02,2021-01-03,,Groceries - Supermarket,115.43,0.00,1168357.72
2505,2021-01-03,2021-01-03,,Transfer Received,0.00,525.36,1168883.08
2506,2021-01-04,2021-01-04,,Groceries - Supermarket,196.65,0.00,1168686.43
2507,2021-01-04,2021-01-04,,Online Transfer,228.10,0.00,1168458.33
2508,2021-01-04,2021-01-04,,Groceries - Online Delivery,94.48,0.00,1168363.85
2509,2021-01-04,2021-01-04,,Credit Card Payment,715.49,0.00,1167648.36
2510,2021-01-04,2021-01-04,,Groceries - Supermarket,75.57,0.00,1167572.79
2511,2021-01-03,2021-01-04,,Interest Credited,0.00,19.21,1167592.00
2512,2021-01-05,2021-01-05,,Groceries - Supermarket,193.18,0.00,1167398.82
2513,2021-01-05,2021-01-05,,ATM Withdrawal,71.30,0.00,1167327.52
2514,2021-01-06,2021-01-05,,Salary Credit,0.00,4335.55,1171663.07
2515,2021-01-04,2021-01-05,,Transfer Received,0.00,1938.89,1173601.96
2516,2021-01-06,2021-01-05,,Groceries - Supermarket,79.28,0.00,1173522.68
2517,2021-01-06,2021-01-06,,Salary Credit,0.00,3234.81,1176757.49
2518,2021-01-06,2021-01-06,,Transfer Received,0.00,1208.30,1177965.79
2519,2021-01-07,2021-01-06,,Loan EMI,769.27,0.00,1177196.52
2520,2021-01-06,2021-01-06,,Groceries - Supermarket,80.03,0.00,1177116.49
2521,2021-01-06,2021-01-06,,Groceries - Supermarket,151.79,0.00,1176964.70
2522,2021-01-06,2021-01-06,,Credit Card Payment,837.56,0.00,1176127.14
2523,2021-01-06,2021-01-06,,Utility Payment,238.99,0.00,1175888.15
2524,2021-01-06,2021-01-06,,Transfer Received,0.00,1038.58,1176926.73
2525,2021-01-06,2021-01-06,100062,Cheque Issued,1022.11,0.00,1175904.62
2526,2021-01-07,2021-01-07,,Utility Payment,87.19,0.00,1175817.43
2527,2021-01-06,2021-01-07,,ATM Withdrawal,445.47,0.00,1175371.96
2528,2021-01-07,2021-01-07,,Online Transfer,1418.15,0.00,1173953.81
2529,2021-01-06,2021-01-07,,Salary Credit,0.00,3236.95,1177190.76
2530,2021-01-07,2021-01-07,,Transfer Received,0.00,2910.56,1180101.32
2531,2021-01-08,2021-01-08,,Daily Essentials,34.53,0.00,1180066.79
2532,2021-01-07,2021-01-08,,ATM Withdrawal,317.22,0.00,1179749.57
2533,2021-01-08,2021-01-08,,Transfer Received,0.00,1994.61,1181744.18
2534,2021-01-08,2021-01-08,,Transfer Received,0.00,2903.00,1184647.18
2535,2021-01-08,2021-01-08,,Interest Credited,0.00,61.04,1184708.22
2536,2021-01-09,2021-01-08,,Investment - Mutual Funds,1517.61,0.00,1183190.61
2537,2021-01-09,2021-01-09,,Dining Out,19.10,0.00,1183171.51
2538,2021-01-09,2021-01-09,,Interest Credited,0.00,70.86,1183242.37
2539,2021-01-09,2021-01-09,,Transfer Received,0.00,597.86,1183840.23
2540,2021-01-08,2021-01-09,,Dining Out,71.91,0.00,1183768.32
2541,2021-01-09,2021-01-09,,Daily Essentials,25.34,0.00,1183742.98
2542,2021-01-09,2021-01-10,,Utility Payment,231.63,0.00,1183511.35
2543,2021-01-10,2021-01-10,,Transfer Received,0.00,1440.69,1184952.04
2544,2021-01-10,2021-01-10,,Transfer Received,0.00,843.16,1185795.20
2545,2021-01-10,2021-01-10,,Credit Card Payment,542.07,0.00,1185253.13
2546,2021-01-10,2021-01-10,,Salary Credit,0.00,3480.98,1188734.11
2547,2021-01-10,2021-01-10,,Credit Card Payment,203.04,0.00,1188531.07
2548,2021-01-10,2021-01-10,,Investment - Stocks,3568.47,0.00,1184962.60
2549,2021-01-10,2021-01-10,,Interest Credited,0.00,54.30,1185016.90
2550,2021-01-11,2021-01-11,,Salary Credit,0.00,3945.54,1188962.44
2551,2021-01-11,2021-01-11,,Dining Out,54.14,0.00,1188908.30
2552,2021-01-11,2021-01-11,,Salary Credit,0.00,2115.47,1191023.77
2553,2021-01-10,2021-01-11,,Interest Credited,0.00,61.04,1191084.81
2554,2021-01-11,2021-01-11,,ATM Withdrawal,423.99,0.00,1190660.82
2555,2021-01-11,2021-01-11,,Transfer Received,0.00,1581.39,1192242.21
2556,2021-01-13,2021-01-12,,Transfer Received,0.00,1778.20,1194020.41
2557,2021-01-12,2021-01-12,,Takeout,27.76,0.00,1193992.65
2558,2021-01-12,2021-01-12,,Salary Credit,0.00,2512.32,1196504.97
2559,2021-01-12,2021-01-12,,Transfer Received,0.00,1653.22,1198158.19
2560,2021-01-12,2021-01-12,,Takeout,24.43,0.00,1198133.76
2561,2021-01-12,2021-01-12,,Transfer Received,0.00,808.00,1198941.76
2562,2021-01-12,2021-01-12,,Groceries - Supermarket,133.91,0.00,1198807.85
2563,2021-01-13,2021-01-13,,Interest Credited,0.00,77.51,1198885.36
2564,2021-01-13,2021-01-13,,Transfer Received,0.00,1315.42,1200200.78
2565,2021-01-13,2021-01-13,,Coffee Shop,9.82,0.00,1200190.96
2566,2021-01-14,2021-01-13,,Investment Returns,0.00,167.43,1200358.39
2567,2021-01-14,2021-01-14,,Transfer Received,0.00,2102.04,1202460.43
2568,2021-01-15,2021-01-14,,Loan EMI,1998.79,0.00,1200461.64
2569,2021-01-14,2021-01-14,100063,Cheque Issued,2789.34,0.00,1197672.30
2570,2021-01-14,2021-01-14,,Salary Credit,0.00,2462.11,1200134.41
2571,2021-01-14,2021-01-14,,ATM Withdrawal,317.21,0.00,1199817.20
2572,2021-01-14,2021-01-14,,Utility Payment,160.52,0.00,1199656.68
2573,2021-01-14,2021-01-14,,Cash Deposit,0.00,191.98,1199848.66
2574,2021-01-13,2021-01-14,,Salary Credit,0.00,4577.46,1204426.12
2575,2021-01-13,2021-01-14,,Salary Credit,0.00,4428.20,1208854.32
2576,2021-01-14,2021-01-14,,Investment Returns,0.00,410.83,1209265.15
2577,2021-01-14,2021-01-15,,Investment - Mutual Funds,1250.42,0.00,1208014.73
2578,2021-01-15,2021-01-15,,Online Transfer,189.33,0.00,1207825.40
2579,2021-01-14,2021-01-15,,Investment - Stocks,1308.00,0.00,1206517.40
2580,2021-01-15,2021-01-15,,Investment Returns,0.00,529.65,1207047.05
2581,2021-01-14,2021-01-15,,Transfer Received,0.00,1585.02,1208632.07
2582,2021-01-15,2021-01-16,,Transfer Received,0.00,1313.70,1209945.77
2583,2021-01-16,2021-01-16,,Salary Credit,0.00,3594.46,1213540.23
2584,2021-01-16,2021-01-16,,Online Transfer,391.30,0.00,1213148.93
2585,2021-01-16,2021-01-16,,Transfer Received,0.00,2059.66,1215208.59
2586,2021-01-16,2021-01-16,,Utility Payment,160.44,0.00,1215048.15
2587,2021-01-15,2021-01-16,,Takeout,13.59,0.00,1215034.56
2588,2021-01-17,2021-01-17,,Transfer Received,0.00,1227.73,1216262.29
2589,2021-01-17,2021-01-17,,Transfer Received,0.00,2452.25,1218714.54
2590,2021-01-17,2021-01-17,,Groceries - Supermarket,154.37,0.00,1218560.17
2591,2021-01-17,2021-01-17,,Rental Income,0.00,1610.56,1220170.73
2592,2021-01-17,2021-01-17,,Salary Credit,0.00,3252.11,1223422.84
2593,2021-01-18,2021-01-18,,Utility Payment,128.58,0.00,1223294.26
2594,2021-01-18,2021-01-18,,Credit Card Payment,401.52,0.00,1222892.74
2595,2021-01-17,2021-01-18,,Utility Payment,60.77,0.00,1222831.97
2596,2021-01-18,2021-01-19,,Online Transfer,1906.86,0.00,1220925.11
2597,2021-01-19,2021-01-19,,Online Transfer,1905.53,0.00,1219019.58
2598,2021-01-19,2021-01-19,,Utility Payment,275.59,0.00,1218743.99
2599,2021-01-19,2021-01-19,,Loan EMI,927.54,0.00,1217816.45
2600,2021-01-19,2021-01-19,,Interest Credited,0.00,14.61,1217831.06
2601,2021-01-19,2021-01-19,,Credit Card Payment,420.17,0.00,1217410.89
2602,2021-01-20,2021-01-19,,ATM Withdrawal,28.09,0.00,1217382.80
2603,2021-01-20,2021-01-20,,ATM Withdrawal,424.00,0.00,1216958.80
2604,2021-01-20,2021-01-20,,Groceries - Supermarket,63.29,0.00,1216895.51
2605,2021-01-21,2021-01-20,,ATM Withdrawal,55.81,0.00,1216839.70
2606,2021-01-20,2021-01-20,,Online Transfer,137.61,0.00,1216702.09
2607,2021-01-20,2021-01-20,,Interest Credited,0.00,63.13,1216765.22
2608,2021-01-19,2021-01-20,,Groceries - Supermarket,40.30,0.00,1216724.92
2609,2021-01-20,2021-01-20,,Online Transfer,608.95,0.00,1216115.97
2610,2021-01-20,2021-01-20,,ATM Withdrawal,326.31,0.00,1215789.66
2611,2021-01-20,2021-01-20,,Utility Payment,193.82,0.00,1215595.84
2612,2021-01-20,2021-01-20,,Investment Returns,0.00,489.48,1216085.32
2613,2021-01-20,2021-01-20,,ATM Withdrawal,144.79,0.00,1215940.53
2614,2021-01-21,2021-01-20,,Groceries - Supermarket,141.79,0.00,1215798.74
2615,2021-01-20,2021-01-20,,Loan EMI,544.25,0.00,1215254.49
2616,2021-01-21,2021-01-21,,ATM Withdrawal,45.20,0.00,1215209.29
2617,2021-01-21,2021-01-21,,Online Transfer,1261.86,0.00,1213947.43
2618,2021-01-21,2021-01-21,,Utility Payment,273.93,0.00,1213673.50
2619,2021-01-21,2021-01-21,,ATM Withdrawal,395.30,0.00,1213278.20
2620,2021-01-21,2021-01-21,,ATM Withdrawal,51.75,0.00,1213226.45
2621,2021-01-21,2021-01-21,,Coffee Shop,19.00,0.00,1213207.45
2622,2021-01-22,2021-01-22,,Transfer Received,0.00,1593.36,1214800.81
2623,2021-01-22,2021-01-22,,Transfer Received,0.00,1719.35,1216520.16
2624,2021-01-21,2021-01-22,,Credit Card Payment,363.36,0.00,1216156.80
2625,2021-01-22,2021-01-22,,Investment Returns,0.00,639.81,1216796.61
2626,2021-01-22,2021-01-23,,ATM Withdrawal,299.04,0.00,1216497.57
2627,2021-01-23,2021-01-23,,Salary Credit,0.00,4214.54,1220712.11
2628,2021-01-23,2021-01-23,,Groceries - Supermarket,194.32,0.00,1220517.79
2629,2021-01-23,2021-01-23,,Salary Credit,0.00,3176.78,1223694.57
2630,2021-01-25,2021-01-24,,Online Transfer,1831.20,0.00,1221863.37
2631,2021-01-24,2021-01-24,,Transfer Received,0.00,2239.39,1224102.76
2632,2021-01-24,2021-01-24,,ATM Withdrawal,479.89,0.00,1223622.87
2633,2021-01-24,2021-01-24,,Online Transfer,1775.49,0.00,1221847.38
2634,2021-01-25,2021-01-24,,Groceries - Online Delivery,120.51,0.00,1221726.87
2635,2021-01-24,2021-01-24,,Online Transfer,236.34,0.00,1221490.53
2636,2021-01-24,2021-01-24,,Credit Card Payment,394.79,0.00,1221095.74
2637,2021-01-26,2021-01-25,,Groceries - Supermarket,191.83,0.00,1220903.91
2638,2021-01-25,2021-01-25,100064,Cheque Issued,2379.62,0.00,1218524.29
2639,2021-01-26,2021-01-25,,ATM Withdrawal,269.45,0.00,1218254.84
2640,2021-01-26,2021-01-25,,Rental Income,0.00,1258.16,1219513.00
2641,2021-01-26,2021-01-26,,Utility Payment,254.65,0.00,1219258.35
2642,2021-01-25,2021-01-26,,Transfer Received,0.00,2896.55,1222154.90
2643,2021-01-26,2021-01-26,,Groceries - Online Delivery,145.16,0.00,1222009.74
2644,2021-01-27,2021-01-26,,Investment - Stocks,2870.69,0.00,1219139.05
2645,2021-01-26,2021-01-26,,Credit Card Payment,512.00,0.00,1218627.05
2646,2021-01-26,2021-01-26,,Salary Credit,0.00,3779.89,1222406.94
2647,2021-01-27,2021-01-26,,Salary Credit,0.00,3858.16,1226265.10
2648,2021-01-26,2021-01-26,,Interest Credited,0.00,93.30,1226358.40
2649,2021-01-27,2021-01-27,,ATM Withdrawal,462.37,0.00,1225896.03
2650,2021-01-27,2021-01-27,,Dining Out,39.90,0.00,1225856.13
2651,2021-01-27,2021-01-27,,Online Transfer,828.91,0.00,1225027.22
2652,2021-01-27,2021-01-27,,Transfer Received,0.00,2060.74,1227087.96
2653,2021-01-28,2021-01-28,,Utility Payment,52.30,0.00,1227035.66
2654,2021-01-28,2021-01-28,,Utility Payment,192.77,0.00,1226842.89
2655,2021-01-28,2021-01-28,,Salary Credit,0.00,4174.52,1231017.41
2656,2021-01-27,2021-01-28,,Transfer Received,0.00,1197.35,1232214.76
2657,2021-01-28,2021-01-28,,Groceries - Supermarket,78.57,0.00,1232136.19
2658,2021-01-28,2021-01-28,100065,Cheque Issued,1793.37,0.00,1230342.82
2659,2021-01-28,2021-01-28,,Salary Credit,0.00,4383.86,1234726.68
2660,2021-01-29,2021-01-29,,Investment Returns,0.00,242.01,1234968.69
2661,2021-01-29,2021-01-29,,Transfer Received,0.00,1368.91,1236337.60
2662,2021-01-29,2021-01-29,,Transfer Received,0.00,1880.31,1238217.91
2663,2021-01-29,2021-01-29,,Groceries - Supermarket,142.63,0.00,1238075.28
2664,2021-01-29,2021-01-29,,Salary Credit,0.00,3008.68,1241083.96
2665,2021-01-29,2021-01-29,,ATM Withdrawal,456.55,0.00,1240627.41
2666,2021-01-29,2021-01-29,,Transfer Received,0.00,2585.18,1243212.59
2667,2021-01-30,2021-01-29,,Transfer Received,0.00,1047.99,1244260.58
2668,2021-01-29,2021-01-29,,Salary Credit,0.00,3853.01,1248113.59
2669,2021-01-28,2021-01-29,,Groceries - Online Delivery,94.94,0.00,1248018.65
2670,2021-01-29,2021-01-29,,Transfer Received,0.00,888.45,1248907.10
2671,2021-01-30,2021-01-30,,Transfer Received,0.00,2290.70,1251197.80
2672,2021-01-31,2021-01-30,,Transfer Received,0.00,1365.09,1252562.89
2673,2021-01-30,2021-01-30,,Transfer Received,0.00,947.36,1253510.25
2674,2021-01-30,2021-01-30,,Loan EMI,1758.35,0.00,1251751.90
2675,2021-01-30,2021-01-30,,Groceries - Supermarket,154.18,0.00,1251597.72
2676,2021-01-31,2021-01-31,,ATM Withdrawal,133.86,0.00,1251463.86
2677,2021-01-30,2021-01-31,,Dining Out,29.87,0.00,1251433.99
2678,2021-01-30,2021-01-31,,Investment - SIP,961.56,0.00,1250472.43
2679,2021-01-31,2021-01-31,,Online Transfer,1852.09,0.00,1248620.34
2680,2021-01-31,2021-01-31,,Transfer Received,0.00,2005.87,1250626.21
2681,2021-01-31,2021-01-31,,Daily Essentials,11.79,0.00,1250614.42
2682,2021-02-02,2021-02-01,,Salary Credit,0.00,4737.90,1255352.32
2683,2021-02-01,2021-02-01,,Transfer Received,0.00,1434.99,1256787.31
2684,2021-02-01,2021-02-01,,Investment - Stocks,3981.46,0.00,1252805.85
2685,2021-02-01,2021-02-01,,Groceries - Supermarket,169.63,0.00,1252636.22
2686,2021-01-31,2021-02-01,,Utility Payment,203.59,0.00,1252432.63
2687,2021-02-02,2021-02-02,,Dividend Received,0.00,333.14,1252765.77
2688,2021-02-02,2021-02-02,,Utility Payment,122.00,0.00,1252643.77
2689,2021-02-02,2021-02-02,,Transfer Received,0.00,2388.09,1255031.86
2690,2021-02-02,2021-02-02,,Dining Out,91.36,0.00,1254940.50
2691,2021-02-02,2021-02-02,,Cash Deposit,0.00,617.16,1255557.66
2692,2021-02-01,2021-02-02,,Online Transfer,477.98,0.00,1255079.68
2693,2021-02-03,2021-02-03,,Salary Credit,0.00,3966.17,1259045.85
2694,2021-02-03,2021-02-03,,Dining Out,87.04,0.00,1258958.81
2695,2021-02-03,2021-02-03,,Dining Out,75.83,0.00,1258882.98
2696,2021-02-02,2021-02-03,,Transfer Received,0.00,1798.25,1260681.23
2697,2021-02-03,2021-02-03,,Salary Credit,0.00,3922.42,1264603.65
2698,2021-02-05,2021-02-04,,Dividend Received,0.00,100.94,1264704.59
2699,2021-02-04,2021-02-04,,Interest Credited,0.00,56.70,1264761.29
2700,2021-02-04,2021-02-04,,Transfer Received,0.00,1010.57,1265771.86
2701,2021-02-04,2021-02-04,,Transfer Received,0.00,2735.85,1268507.71
2702,2021-02-04,2021-02-04,,Utility Payment,95.94,0.00,1268411.77
2703,2021-02-04,2021-02-04,,Groceries - Supermarket,186.26,0.00,1268225.51
2704,2021-02-05,2021-02-04,,Interest Credited,0.00,33.33,1268258.84
2705,2021-02-03,2021-02-04,,Online Transfer,1949.63,0.00,1266309.21
2706,2021-02-06,2021-02-05,,ATM Withdrawal,358.50,0.00,1265950.71
2707,2021-02-05,2021-02-05,,Transfer Received,0.00,2511.22,1268461.93
2708,2021-02-04,2021-02-05,,Online Transfer,1256.35,0.00,1267205.58
2709,2021-02-05,2021-02-05,,Utility Payment,143.84,0.00,1267061.74
2710,2021-02-05,2021-02-05,,Online Transfer,1743.44,0.00,1265318.30
2711,2021-02-05,2021-02-05,,Credit Card Payment,650.39,0.00,1264667.91
2712,2021-02-04,2021-02-05,,ATM Withdrawal,227.14,0.00,1264440.77
2713,2021-02-07,2021-02-06,,Transfer Received,0.00,2150.35,1266591.12
2714,2021-02-06,2021-02-06,,Investment - SIP,750.05,0.00,1265841.07
2715,2021-02-06,2021-02-06,,Transfer Received,0.00,1086.33,1266927.40
2716,2021-02-06,2021-02-06,,Investment - Mutual Funds,1546.86,0.00,1265380.54
2717,2021-02-05,2021-02-06,,Online Transfer,1910.44,0.00,1263470.10
2718,2021-02-06,2021-02-06,,ATM Withdrawal,451.96,0.00,1263018.14
2719,2021-02-06,2021-02-06,,Investment - SIP,919.74,0.00,1262098.40
2720,2021-02-07,2021-02-06,,Cash Deposit,0.00,949.48,1263047.88
2721,2021-02-07,2021-02-07,,Groceries - Online Delivery,85.86,0.00,1262962.02
2722,2021-02-08,2021-02-07,,Transfer Received,0.00,1729.49,1264691.51
2723,2021-02-07,2021-02-07,,Salary Credit,0.00,2394.41,1267085.92
2724,2021-02-09,2021-02-08,,Transfer Received,0.00,967.86,1268053.78
2725,2021-02-07,2021-02-08,,Salary Credit,0.00,2571.99,1270625.77
2726,2021-02-08,2021-02-08,,Salary Credit,0.00,3044.78,1273670.55
2727,2021-02-08,2021-02-08,,Dividend Received,0.00,338.02,1274008.57
2728,2021-02-08,2021-02-08,,Dining Out,39.64,0.00,1273968.93
2729,2021-02-08,2021-02-08,,Dividend Received,0.00,490.96,1274459.89
2730,2021-02-07,2021-02-08,,Utility Payment,136.66,0.00,1274323.23
2731,2021-02-08,2021-02-08,,Credit Card Payment,738.13,0.00,1273585.10
2732,2021-02-09,2021-02-08,,Groceries - Supermarket,27.36,0.00,1273557.74
2733,2021-02-10,2021-02-09,,Transfer Received,0.00,1173.24,1274730.98
2734,2021-02-09,2021-02-09,,Dining Out,70.33,0.00,1274660.65
2735,2021-02-09,2021-02-09,,Utility Payment,103.69,0.00,1274556.96
2736,2021-02-09,2021-02-09,,Takeout,27.50,0.00,1274529.46
2737,2021-02-09,2021-02-09,,Interest Credited,0.00,34.03,1274563.49
2738,2021-02-09,2021-02-09,100066,Cheque Issued,2898.77,0.00,1271664.72
2739,2021-02-09,2021-02-09,,Loan EMI,1829.12,0.00,1269835.60
2740,2021-02-10,2021-02-10,,ATM Withdrawal,243.74,0.00,1269591.86
2741,2021-02-10,2021-02-10,,Interest Credited,0.00,35.90,1269627.76
2742,2021-02-10,2021-02-10,,Interest Credited,0.00,63.91,1269691.67
2743,2021-02-10,2021-02-10,,Salary Credit,0.00,3688.14,1273379.81
2744,2021-02-10,2021-02-10,,Groceries - Supermarket,122.75,0.00,1273257.06
2745,2021-02-11,2021-02-11,,Transfer Received,0.00,1674.00,1274931.06
2746,2021-02-11,2021-02-11,,Loan EMI,1896.38,0.00,1273034.68
2747,2021-02-10,2021-02-11,,Cash Deposit,0.00,600.03,1273634.71
2748,2021-02-11,2021-02-11,,Salary Credit,0.00,2404.98,1276039.69
2749,2021-02-10,2021-02-11,100067,Cheque Issued,1162.20,0.00,1274877.49
2750,2021-02-11,2021-02-11,,Investment Returns,0.00,920.74,1275798.23
2751,2021-02-11,2021-02-11,,Interest Credited,0.00,26.80,1275825.03
2752,2021-02-12,2021-02-12,,Salary Credit,0.00,2569.17,1278394.20
2753,2021-02-12,2021-02-12,,Online Transfer,1877.42,0.00,1276516.78
2754,2021-02-12,2021-02-12,,Salary Credit,0.00,2634.08,1279150.86
2755,2021-02-11,2021-02-12,,ATM Withdrawal,196.87,0.00,1278953.99
2756,2021-02-13,2021-02-13,,Salary Credit,0.00,3142.13,1282096.12
2757,2021-02-13,2021-02-13,,Investment - Stocks,3324.87,0.00,1278771.25
2758,2021-02-13,2021-02-13,,Transfer Received,0.00,2619.38,1281390.63
2759,2021-02-14,2021-02-13,,Credit Card Payment,936.74,0.00,1280453.89
2760,2021-02-13,2021-02-13,,Cash Deposit,0.00,560.85,1281014.74
2761,2021-02-13,2021-02-13,,Utility Payment,208.94,0.00,1280805.80
2762,2021-02-14,2021-02-14,,ATM Withdrawal,192.23,0.00,1280613.57
2763,2021-02-14,2021-02-14,,Investment Returns,0.00,202.15,1280815.72
2764,2021-02-14,2021-02-14,,Online Transfer,1699.59,0.00,1279116.13
2765,2021-02-14,2021-02-14,,Loan EMI,909.46,0.00,1278206.67
2766,2021-02-14,2021-02-14,,Groceries - Online Delivery,139.01,0.00,1278067.66
2767,2021-02-15,2021-02-15,,Daily Essentials,24.61,0.00,1278043.05
2768,2021-02-16,2021-02-15,,Interest Credited,0.00,32.90,1278075.95
2769,2021-02-14,2021-02-15,,Transfer Received,0.00,2151.83,1280227.78
2770,2021-02-15,2021-02-15,,Interest Credited,0.00,27.17,1280254.95
2771,2021-02-15,2021-02-15,,Credit Card Payment,260.22,0.00,1279994.73
2772,2021-02-16,2021-02-15,,Utility Payment,211.25,0.00,1279783.48
2773,2021-02-16,2021-02-16,,Online Transfer,530.09,0.00,1279253.39
2774,2021-02-16,2021-02-16,,Salary Credit,0.00,2661.02,1281914.41
2775,2021-02-15,2021-02-16,,Transfer Received,0.00,1117.24,1283031.65
2776,2021-02-16,2021-02-16,100068,Cheque Issued,503.06,0.00,1282528.59
2777,2021-02-16,2021-02-16,,Transfer Received,0.00,863.50,1283392.09
2778,2021-02-15,2021-02-16,,Transfer Received,0.00,1767.26,1285159.35
2779,2021-02-16,2021-02-16,,Loan EMI,1532.31,0.00,1283627.04
2780,2021-02-16,2021-02-16,,Groceries - Supermarket,192.53,0.00,1283434.51
2781,2021-02-16,2021-02-16,,Groceries - Supermarket,180.42,0.00,1283254.09
2782,2021-02-15,2021-02-16,,Online Transfer,1863.04,0.00,1281391.05
2783,2021-02-17,2021-02-16,,Groceries - Supermarket,58.23,0.00,1281332.82
2784,2021-02-17,2021-02-16,,Interest Credited,0.00,44.83,1281377.65
2785,2021-02-16,2021-02-16,,Online Transfer,795.78,0.00,1280581.87
2786,2021-02-17,2021-02-16,,Coffee Shop,14.99,0.00,1280566.88
2787,2021-02-17,2021-02-17,,Investment Returns,0.00,292.73,1280859.61
2788,2021-02-16,2021-02-17,,Online Transfer,538.48,0.00,1280321.13
2789,2021-02-17,2021-02-17,,Salary Credit,0.00,4791.44,1285112.57
2790,2021-02-17,2021-02-17,,Transfer Received,0.00,2334.43,1287447.00
2791,2021-02-17,2021-02-17,,Transfer Received,0.00,790.86,1288237.86
2792,2021-02-16,2021-02-17,,Cash Deposit,0.00,465.92,1288703.78
2793,2021-02-17,2021-02-17,,Investment - SIP,893.02,0.00,1287810.76
2794,2021-02-16,2021-02-17,,Groceries - Supermarket,21.84,0.00,1287788.92
2795,2021-02-17,2021-02-17,,Transfer Received,0.00,2990.80,1290779.72
2796,2021-02-17,2021-02-17,,Online Transfer,1191.70,0.00,1289588.02
2797,2021-02-18,2021-02-18,,Online Transfer,1142.47,0.00,1288445.55
2798,2021-02-18,2021-02-18,,Salary Credit,0.00,3780.45,1292226.00
2799,2021-02-18,2021-02-18,,ATM Withdrawal,429.65,0.00,1291796.35
2800,2021-02-17,2021-02-18,,Utility Payment,110.08,0.00,1291686.27
2801,2021-02-18,2021-02-18,,Utility Payment,282.37,0.00,1291403.90
2802,2021-02-18,2021-02-18,,Loan EMI,1722.43,0.00,1289681.47
2803,2021-02-17,2021-02-18,,Salary Credit,0.00,2351.78,1292033.25
2804,2021-02-18,2021-02-19,,ATM Withdrawal,226.99,0.00,1291806.26
2805,2021-02-19,2021-02-19,,Salary Credit,0.00,2768.34,1294574.60
2806,2021-02-19,2021-02-19,,Online Transfer,1159.98,0.00,1293414.62
2807,2021-02-19,2021-02-19,,Interest Credited,0.00,84.00,1293498.62
2808,2021-02-19,2021-02-19,,Salary Credit,0.00,4009.63,1297508.25
2809,2021-02-21,2021-02-20,,Online Transfer,1690.86,0.00,1295817.39
2810,2021-02-20,2021-02-20,,Coffee Shop,5.68,0.00,1295811.71
2811,2021-02-20,2021-02-20,,Transfer Received,0.00,708.76,1296520.47
2812,2021-02-20,2021-02-20,,Salary Credit,0.00,3329.50,1299849.97
2813,2021-02-20,2021-02-20,,Dividend Received,0.00,295.08,1300145.05
2814,2021-02-20,2021-02-20,,Rental Income,0.00,2481.60,1302626.65
2815,2021-02-20,2021-02-20,,Transfer Received,0.00,2423.95,1305050.60
2816,2021-02-21,2021-02-20,,Daily Essentials,13.01,0.00,1305037.59
2817,2021-02-19,2021-02-20,,ATM Withdrawal,69.18,0.00,1304968.41
2818,2021-02-21,2021-02-21,,Online Transfer,887.24,0.00,1304081.17
2819,2021-02-22,2021-02-21,,Transfer Received,0.00,1183.46,1305264.63
2820,2021-02-21,2021-02-21,,Rental Income,0.00,2187.60,1307452.23
2821,2021-02-20,2021-02-21,,Groceries - Online Delivery,130.00,0.00,1307322.23
2822,2021-02-21,2021-02-21,,Utility Payment,289.18,0.00,1307033.05
2823,2021-02-21,2021-02-21,,Transfer Received,0.00,634.62,1307667.67
2824,2021-02-21,2021-02-21,,Salary Credit,0.00,4537.32,1312204.99
2825,2021-02-20,2021-02-21,,Groceries - Supermarket,85.18,0.00,1312119.81
2826,2021-02-21,2021-02-21,,Transfer Received,0.00,2186.29,1314306.10
2827,2021-02-21,2021-02-21,,Credit Card Payment,224.74,0.00,1314081.36
2828,2021-02-22,2021-02-22,,Investment - Mutual Funds,2012.50,0.00,1312068.86
2829,2021-02-23,2021-02-22,,Salary Credit,0.00,2348.23,1314417.09
2830,2021-02-22,2021-02-22,,ATM Withdrawal,284.03,0.00,1314133.06
2831,2021-02-21,2021-02-22,100069,Cheque Issued,1711.46,0.00,1312421.60
2832,2021-02-22,2021-02-22,,Credit Card Payment,515.62,0.00,1311905.98
2833,2021-02-22,2021-02-22,,ATM Withdrawal,233.77,0.00,1311672.21
2834,2021-02-22,2021-02-22,,Salary Credit,0.00,3739.81,1315412.02
2835,2021-02-22,2021-02-22,,Groceries - Supermarket,93.34,0.00,1315318.68
2836,2021-02-22,2021-02-22,,ATM Withdrawal,342.00,0.00,1314976.68
2837,2021-02-22,2021-02-22,,ATM Withdrawal,403.36,0.00,1314573.32
2838,2021-02-23,2021-02-22,,Transfer Received,0.00,2921.74,1317495.06
2839,2021-02-22,2021-02-22,,Rental Income,0.00,1800.24,1319295.30
2840,2021-02-21,2021-02-22,,Salary Credit,0.00,2962.38,1322257.68
2841,2021-02-23,2021-02-23,,ATM Withdrawal,389.95,0.00,1321867.73
2842,2021-02-24,2021-02-23,,Daily Essentials,17.75,0.00,1321849.98
2843,2021-02-24,2021-02-23,,Credit Card Payment,797.39,0.00,1321052.59
2844,2021-02-23,2021-02-23,,Salary Credit,0.00,4118.04,1325170.63
2845,2021-02-23,2021-02-23,,Interest Credited,0.00,49.04,1325219.67
2846,2021-02-24,2021-02-23,,Salary Credit,0.00,4721.65,1329941.32
2847,2021-02-23,2021-02-23,,Online Transfer,453.76,0.00,1329487.56
2848,2021-02-24,2021-02-24,,Loan EMI,1096.04,0.00,1328391.52
2849,2021-02-24,2021-02-24,,Coffee Shop,12.98,0.00,1328378.54
2850,2021-02-24,2021-02-24,,ATM Withdrawal,268.70,0.00,1328109.84
2851,2021-02-25,2021-02-24,100070,Cheque Issued,1043.67,0.00,1327066.17
2852,2021-02-24,2021-02-24,,Dining Out,50.29,0.00,1327015.88
2853,2021-02-24,2021-02-24,,ATM Withdrawal,286.70,0.00,1326729.18
2854,2021-02-25,2021-02-24,,Investment - Mutual Funds,267.50,0.00,1326461.68
2855,2021-02-24,2021-02-24,,Investment Returns,0.00,240.50,1326702.18
2856,2021-02-24,2021-02-24,,Credit Card Payment,788.55,0.00,1325913.63
2857,2021-02-24,2021-02-24,,Groceries - Supermarket,25.49,0.00,1325888.14
2858,2021-02-25,2021-02-25,,Online Transfer,1107.69,0.00,1324780.45
2859,2021-02-25,2021-02-25,,Credit Card Payment,478.99,0.00,1324301.46
2860,2021-02-25,2021-02-25,,Credit Card Payment,731.40,0.00,1323570.06
2861,2021-02-25,2021-02-25,,Transfer Received,0.00,2555.43,1326125.49
2862,2021-02-26,2021-02-25,,Dining Out,10.50,0.00,1326114.99
2863,2021-02-25,2021-02-25,,Transfer Received,0.00,1100.11,1327215.10
2864,2021-02-25,2021-02-25,,Investment - Stocks,3865.50,0.00,1323349.60
2865,2021-02-24,2021-02-25,,Salary Credit,0.00,4769.29,1328118.89
2866,2021-02-26,2021-02-26,,Credit Card Payment,723.99,0.00,1327394.90
2867,2021-02-26,2021-02-26,100071,Cheque Issued,1095.87,0.00,1326299.03
2868,2021-02-26,2021-02-26,100072,Cheque Issued,1660.06,0.00,1324638.97
2869,2021-02-26,2021-02-26,,Groceries - Supermarket,58.94,0.00,1324580.03
2870,2021-02-27,2021-02-26,,Salary Credit,0.00,4270.95,1328850.98
2871,2021-02-26,2021-02-26,,Groceries - Supermarket,148.18,0.00,1328702.80
2872,2021-02-25,2021-02-26,,Online Transfer,344.01,0.00,1328358.79
2873,2021-02-26,2021-02-26,,Rental Income,0.00,1163.09,1329521.88
2874,2021-02-27,2021-02-27,,Online Transfer,1213.16,0.00,1328308.72
2875,2021-02-27,2021-02-27,,Transfer Received,0.00,1954.96,1330263.68
2876,2021-02-27,2021-02-27,,Coffee Shop,17.37,0.00,1330246.31
2877,2021-02-27,2021-02-27,,ATM Withdrawal,122.67,0.00,1330123.64
2878,2021-02-27,2021-02-27,,Groceries - Supermarket,144.52,0.00,1329979.12
2879,2021-02-27,2021-02-27,,Interest Credited,0.00,57.36,1330036.48
2880,2021-02-28,2021-02-28,,Salary Credit,0.00,2473.41,1332509.89
2881,2021-02-28,2021-02-28,,ATM Withdrawal,446.60,0.00,1332063.29
2882,2021-03-01,2021-02-28,,Loan EMI,760.34,0.00,1331302.95
2883,2021-02-27,2021-02-28,,Dining Out,10.96,0.00,1331291.99
2884,2021-02-27,2021-02-28,,Transfer Received,0.00,1763.94,1333055.93
2885,2021-02-27,2021-02-28,,Credit Card Payment,411.88,0.00,1332644.05
2886,2021-03-02,2021-03-01,,Investment Returns,0.00,963.64,1333607.69
2887,2021-03-02,2021-03-01,,Credit Card Payment,822.70,0.00,1332784.99
2888,2021-03-01,2021-03-01,,Transfer Received,0.00,2640.58,1335425.57
2889,2021-03-01,2021-03-01,,Credit Card Payment,745.04,0.00,1334680.53
2890,2021-03-02,2021-03-02,,ATM Withdrawal,27.29,0.00,1334653.24
2891,2021-03-02,2021-03-02,,Transfer Received,0.00,2959.80,1337613.04
2892,2021-03-01,2021-03-02,,Credit Card Payment,879.05,0.00,1336733.99
2893,2021-03-02,2021-03-02,,Interest Credited,0.00,50.25,1336784.24
2894,2021-03-02,2021-03-02,,Transfer Received,0.00,1012.64,1337796.88
2895,2021-03-03,2021-03-03,,ATM Withdrawal,387.87,0.00,1337409.01
2896,2021-03-04,2021-03-03,,Groceries - Supermarket,114.64,0.00,1337294.37
2897,2021-03-04,2021-03-03,,Utility Payment,245.81,0.00,1337048.56
2898,2021-03-03,2021-03-03,,Credit Card Payment,779.36,0.00,1336269.20
2899,2021-03-03,2021-03-03,,Transfer Received,0.00,1165.98,1337435.18
2900,2021-03-04,2021-03-03,,Transfer Received,0.00,2438.65,1339873.83
2901,2021-03-03,2021-03-03,,ATM Withdrawal,370.63,0.00,1339503.20
2902,2021-03-03,2021-03-03,,Salary Credit,0.00,3259.63,1342762.83
2903,2021-03-03,2021-03-03,,Transfer Received,0.00,2539.93,1345302.76
2904,2021-03-04,2021-03-04,,Transfer Received,0.00,975.85,1346278.61
2905,2021-03-05,2021-03-04,,Online Transfer,573.54,0.00,1345705.07
2906,2021-03-04,2021-03-04,,Groceries - Supermarket,160.65,0.00,1345544.42
2907,2021-03-05,2021-03-05,,Cash Deposit,0.00,587.83,1346132.25
2908,2021-03-05,2021-03-05,,Online Transfer,1216.12,0.00,1344916.13
2909,2021-03-05,2021-03-05,,Investment - SIP,188.48,0.00,1344727.65
2910,2021-03-04,2021-03-05,,Dining Out,73.61,0.00,1344654.04
2911,2021-03-06,2021-03-05,,Credit Card Payment,516.46,0.00,1344137.58
2912,2021-03-04,2021-03-05,,Groceries - Supermarket,62.76,0.00,1344074.82
2913,2021-03-07,2021-03-06,,Salary Credit,0.00,2508.77,1346583.59
2914,2021-03-06,2021-03-06,,Utility Payment,121.29,0.00,1346462.30
2915,2021-03-05,2021-03-06,,ATM Withdrawal,95.20,0.00,1346367.10
2916,2021-03-06,2021-03-06,,Salary Credit,0.00,4186.04,1350553.14
2917,2021-03-07,2021-03-06,,Investment Returns,0.00,684.03,1351237.17
2918,2021-03-06,2021-03-06,,ATM Withdrawal,389.79,0.00,1350847.38
2919,2021-03-06,2021-03-06,,Utility Payment,146.43,0.00,1350700.95
2920,2021-03-06,2021-03-06,,Investment Returns,0.00,363.09,1351064.04
2921,2021-03-06,2021-03-07,,Interest Credited,0.00,44.52,1351108.56
2922,2021-03-07,2021-03-07,,Salary Credit,0.00,4959.34,1356067.90
2923,2021-03-07,2021-03-07,,Cash Deposit,0.00,212.93,1356280.83
2924,2021-03-07,2021-03-08,,Rental Income,0.00,2455.41,1358736.24
2925,2021-03-09,2021-03-08,,Online Transfer,629.84,0.00,1358106.40
2926,2021-03-07,2021-03-08,,Online Transfer,1075.80,0.00,1357030.60
2927,2021-03-08,2021-03-08,,Salary Credit,0.00,3362.73,1360393.33
2928,2021-03-08,2021-03-08,,Groceries - Supermarket,108.40,0.00,1360284.93
2929,2021-03-10,2021-03-09,,ATM Withdrawal,395.97,0.00,1359888.96
2930,2021-03-08,2021-03-09,,Groceries - Supermarket,173.16,0.00,1359715.80
2931,2021-03-09,2021-03-09,,Investment - SIP,598.51,0.00,1359117.29
2932,2021-03-08,2021-03-09,,Transfer Received,0.00,2985.99,1362103.28
2933,2021-03-09,2021-03-09,,Cash Deposit,0.00,955.08,1363058.36
2934,2021-03-09,2021-03-09,,Online Transfer,1734.89,0.00,1361323.47
2935,2021-03-11,2021-03-10,,Investment - Mutual Funds,1077.95,0.00,1360245.52
2936,2021-03-10,2021-03-10,,Online Transfer,1920.09,0.00,1358325.43
2937,2021-03-10,2021-03-10,,Groceries - Supermarket,68.55,0.00,1358256.88
2938,2021-03-09,2021-03-10,,Groceries - Supermarket,193.47,0.00,1358063.41
2939,2021-03-10,2021-03-10,,Transfer Received,0.00,1916.56,1359979.97
2940,2021-03-10,2021-03-10,,Cash Deposit,0.00,199.52,1360179.49
2941,2021-03-09,2021-03-10,,Transfer Received,0.00,1236.35,1361415.84
2942,2021-03-09,2021-03-10,,Groceries - Supermarket,118.14,0.00,1361297.70
2943,2021-03-11,2021-03-11,,Credit Card Payment,397.96,0.00,1360899.74
2944,2021-03-11,2021-03-11,,Groceries - Supermarket,166.14,0.00,1360733.60
2945,2021-03-10,2021-03-11,,Salary Credit,0.00,3579.16,1364312.76
2946,2021-03-11,2021-03-11,,Salary Credit,0.00,4552.67,1368865.43
2947,2021-03-11,2021-03-11,,Groceries - Online Delivery,127.47,0.00,1368737.96
2948,2021-03-11,2021-03-11,,Cash Deposit,0.00,945.31,1369683.27
2949,2021-03-10,2021-03-11,,Groceries - Supermarket,192.62,0.00,1369490.65
2950,2021-03-12,2021-03-12,,Daily Essentials,10.76,0.00,1369479.89
2951,2021-03-12,2021-03-12,,Groceries - Supermarket,52.84,0.00,1369427.05
2952,2021-03-11,2021-03-12,,ATM Withdrawal,427.43,0.00,1368999.62
2953,2021-03-12,2021-03-12,,Salary Credit,0.00,3011.46,1372011.08
2954,2021-03-12,2021-03-12,,ATM Withdrawal,263.39,0.00,1371747.69
2955,2021-03-12,2021-03-12,,Transfer Received,0.00,2187.75,1373935.44
2956,2021-03-11,2021-03-12,,ATM Withdrawal,209.54,0.00,1373725.90
2957,2021-03-13,2021-03-12,,ATM Withdrawal,70.03,0.00,1373655.87
2958,2021-03-12,2021-03-12,,Groceries - Online Delivery,59.35,0.00,1373596.52
2959,2021-03-13,2021-03-12,,ATM Withdrawal,332.29,0.00,1373264.23
2960,2021-03-12,2021-03-12,,Loan EMI,731.27,0.00,1372532.96
2961,2021-03-12,2021-03-12,,Investment - SIP,188.71,0.00,1372344.25
2962,2021-03-11,2021-03-12,,ATM Withdrawal,217.49,0.00,1372126.76
2963,2021-03-13,2021-03-13,,Credit Card Payment,637.73,0.00,1371489.03
2964,2021-03-13,2021-03-13,,Transfer Received,0.00,2315.09,1373804.12
2965,2021-03-13,2021-03-13,,Groceries - Supermarket,191.54,0.00,1373612.58
2966,2021-03-13,2021-03-13,,Investment - SIP,805.73,0.00,1372806.85
2967,2021-03-13,2021-03-13,,Utility Payment,129.02,0.00,1372677.83
2968,2021-03-13,2021-03-13,,Online Transfer,365.02,0.00,1372312.81
2969,2021-03-13,2021-03-13,,Transfer Received,0.00,2780.77,1375093.58
2970,2021-03-12,2021-03-13,,Cash Deposit,0.00,399.68,1375493.26
2971,2021-03-13,2021-03-13,,ATM Withdrawal,214.00,0.00,1375279.26
2972,2021-03-13,2021-03-13,,Investment - Mutual Funds,1681.63,0.00,1373597.63
2973,2021-03-14,2021-03-14,,Groceries - Supermarket,121.21,0.00,1373476.42
2974,2021-03-14,2021-03-14,,Online Transfer,1779.91,0.00,1371696.51
2975,2021-03-14,2021-03-14,,Online Transfer,677.91,0.00,1371018.60
2976,2021-03-14,2021-03-14,,ATM Withdrawal,141.53,0.00,1370877.07
2977,2021-03-15,2021-03-14,,Interest Credited,0.00,76.61,1370953.68
2978,2021-03-15,2021-03-15,,Interest Credited,0.00,55.38,1371009.06
2979,2021-03-15,2021-03-15,,Utility Payment,270.63,0.00,1370738.43
2980,2021-03-15,2021-03-15,,Online Transfer,604.59,0.00,1370133.84
2981,2021-03-16,2021-03-15,,Online Transfer,1751.47,0.00,1368382.37
2982,2021-03-16,2021-03-15,,Investment - SIP,381.10,0.00,1368001.27
2983,2021-03-14,2021-03-15,,Groceries - Supermarket,48.61,0.00,1367952.66
2984,2021-03-15,2021-03-15,,Transfer Received,0.00,1342.81,1369295.47
2985,2021-03-14,2021-03-15,,ATM Withdrawal,65.14,0.00,1369230.33
2986,2021-03-16,2021-03-15,,Groceries - Supermarket,75.43,0.00,1369154.90
2987,2021-03-16,2021-03-15,,Rental Income,0.00,2941.49,1372096.39
2988,2021-03-15,2021-03-16,,Transfer Received,0.00,1094.23,1373190.62
2989,2021-03-15,2021-03-16,,Transfer Received,0.00,748.82,1373939.44
2990,2021-03-16,2021-03-16,,ATM Withdrawal,439.86,0.00,1373499.58
2991,2021-03-16,2021-03-16,,Utility Payment,129.94,0.00,1373369.64
2992,2021-03-16,2021-03-16,,Groceries - Supermarket,79.93,0.00,1373289.71
2993,2021-03-17,2021-03-17,,Salary Credit,0.00,2054.15,1375343.86
2994,2021-03-17,2021-03-17,,Transfer Received,0.00,1376.09,1376719.95
2995,2021-03-17,2021-03-17,100073,Cheque Issued,1342.21,0.00,1375377.74
2996,2021-03-17,2021-03-17,,Transfer Received,0.00,1630.90,1377008.64
2997,2021-03-19,2021-03-18,,ATM Withdrawal,265.75,0.00,1376742.89
2998,2021-03-18,2021-03-18,,Online Transfer,711.77,0.00,1376031.12
2999,2021-03-18,2021-03-18,,ATM Withdrawal,358.52,0.00,1375672.60
3000,2021-03-18,2021-03-18,,Loan EMI,1145.40,0.00,1374527.20
3001,2021-03-18,2021-03-18,,Salary Credit,0.00,4705.73,1379232.93
3002,2021-03-18,2021-03-18,,Investment - Stocks,957.69,0.00,1378275.24
3003,2021-03-18,2021-03-18,,Credit Card Payment,474.99,0.00,1377800.25
3004,2021-03-19,2021-03-18,,Groceries - Online Delivery,119.26,0.00,1377680.99
3005,2021-03-18,2021-03-18,,Credit Card Payment,390.63,0.00,1377290.36
3006,2021-03-18,2021-03-18,,Investment Returns,0.00,933.40,1378223.76
3007,2021-03-18,2021-03-19,,Online Transfer,765.18,0.00,1377458.58
3008,2021-03-18,2021-03-19,,Groceries - Supermarket,132.55,0.00,1377326.03
3009,2021-03-19,2021-03-19,,Salary Credit,0.00,3157.28,1380483.31
3010,2021-03-19,2021-03-19,,Dividend Received,0.00,281.88,1380765.19
3011,2021-03-19,2021-03-19,,Daily Essentials,5.55,0.00,1380759.64
3012,2021-03-19,2021-03-19,,Groceries - Online Delivery,123.55,0.00,1380636.09
3013,2021-03-19,2021-03-19,,Salary Credit,0.00,2731.99,1383368.08
3014,2021-03-20,2021-03-20,,Transfer Received,0.00,527.34,1383895.42
3015,2021-03-20,2021-03-20,,Salary Credit,0.00,4895.45,1388790.87
3016,2021-03-19,2021-03-20,,Transfer Received,0.00,659.13,1389450.00
3017,2021-03-19,2021-03-20,,Online Transfer,461.48,0.00,1388988.52
3018,2021-03-20,2021-03-20,,Utility Payment,253.07,0.00,1388735.45
3019,2021-03-21,2021-03-20,,Online Transfer,1704.84,0.00,1387030.61
3020,2021-03-20,2021-03-20,,Coffee Shop,12.60,0.00,1387018.01
3021,2021-03-20,2021-03-20,,Dining Out,79.40,0.00,1386938.61
3022,2021-03-21,2021-03-21,,Interest Credited,0.00,95.89,1387034.50
3023,2021-03-21,2021-03-21,,Transfer Received,0.00,1298.07,1388332.57
3024,2021-03-20,2021-03-21,,Transfer Received,0.00,2976.84,1391309.41
3025,2021-03-21,2021-03-21,,Groceries - Online Delivery,116.70,0.00,1391192.71
3026,2021-03-22,2021-03-22,,Rental Income,0.00,1509.71,1392702.42
3027,2021-03-23,2021-03-22,,Salary Credit,0.00,3484.54,1396186.96
3028,2021-03-22,2021-03-22,,Utility Payment,251.78,0.00,1395935.18
3029,2021-03-22,2021-03-22,,Coffee Shop,5.18,0.00,1395930.00
3030,2021-03-22,2021-03-22,,Utility Payment,138.57,0.00,1395791.43
3031,2021-03-22,2021-03-22,,Cash Deposit,0.00,852.00,1396643.43
3032,2021-03-22,2021-03-22,,Groceries - Online Delivery,132.80,0.00,1396510.63
3033,2021-03-21,2021-03-22,,Cash Deposit,0.00,630.07,1397140.70
3034,2021-03-21,2021-03-22,,ATM Withdrawal,27.70,0.00,1397113.00
3035,2021-03-22,2021-03-22,,Salary Credit,0.00,4851.04,1401964.04
3036,2021-03-22,2021-03-22,,Interest Credited,0.00,17.16,1401981.20
3037,2021-03-21,2021-03-22,,Groceries - Supermarket,111.75,0.00,1401869.45
3038,2021-03-22,2021-03-22,,Transfer Received,0.00,2493.36,1404362.81
3039,2021-03-23,2021-03-23,,Online Transfer,607.01,0.00,1403755.80
3040,2021-03-22,2021-03-23,,Online Transfer,472.03,0.00,1403283.77
3041,2021-03-24,2021-03-23,,Coffee Shop,12.71,0.00,1403271.06
3042,2021-03-23,2021-03-23,,Salary Credit,0.00,4184.32,1407455.38
3043,2021-03-23,2021-03-23,,Daily Essentials,26.48,0.00,1407428.90
3044,2021-03-23,2021-03-23,,Credit Card Payment,363.94,0.00,1407064.96
3045,2021-03-22,2021-03-23,,Groceries - Online Delivery,63.66,0.00,1407001.30
3046,2021-03-23,2021-03-23,,Credit Card Payment,790.97,0.00,1406210.33
3047,2021-03-24,2021-03-23,,Credit Card Payment,410.36,0.00,1405799.97
3048,2021-03-24,2021-03-24,,Salary Credit,0.00,3459.62,1409259.59
3049,2021-03-24,2021-03-24,,Salary Credit,0.00,4524.35,1413783.94
3050,2021-03-26,2021-03-25,,Groceries - Supermarket,89.61,0.00,1413694.33
3051,2021-03-25,2021-03-25,,Salary Credit,0.00,3328.54,1417022.87
3052,2021-03-25,2021-03-25,,Dividend Received,0.00,73.68,1417096.55
3053,2021-03-25,2021-03-25,,Salary Credit,0.00,3952.97,1421049.52
3054,2021-03-26,2021-03-25,,Utility Payment,102.81,0.00,1420946.71
3055,2021-03-24,2021-03-25,,Dividend Received,0.00,156.22,1421102.93
3056,2021-03-25,2021-03-25,,Salary Credit,0.00,2765.62,1423868.55
3057,2021-03-26,2021-03-25,,Utility Payment,153.93,0.00,1423714.62
3058,2021-03-26,2021-03-25,,Salary Credit,0.00,3133.90,1426848.52
3059,2021-03-26,2021-03-26,,ATM Withdrawal,125.45,0.00,1426723.07
3060,2021-03-26,2021-03-26,,Transfer Received,0.00,1919.06,1428642.13
3061,2021-03-26,2021-03-26,,Transfer Received,0.00,1442.59,1430084.72
3062,2021-03-26,2021-03-26,,Salary Credit,0.00,4845.41,1434930.13
3063,2021-03-26,2021-03-26,,Coffee Shop,5.78,0.00,1434924.35
3064,2021-03-26,2021-03-26,,Online Transfer,633.00,0.00,1434291.35
3065,2021-03-26,2021-03-26,,Loan EMI,1066.27,0.00,1433225.08
3066,2021-03-26,2021-03-26,,Online Transfer,672.35,0.00,1432552.73
3067,2021-03-27,2021-03-27,,Salary Credit,0.00,4016.32,1436569.05
3068,2021-03-26,2021-03-27,,Credit Card Payment,736.88,0.00,1435832.17
3069,2021-03-28,2021-03-28,,Salary Credit,0.00,3076.14,1438908.31
3070,2021-03-27,2021-03-28,,Online Transfer,322.69,0.00,1438585.62
3071,2021-03-27,2021-03-28,,Interest Credited,0.00,69.65,1438655.27
3072,2021-03-27,2021-03-28,,Dining Out,42.78,0.00,1438612.49
3073,2021-03-28,2021-03-28,,Utility Payment,236.84,0.00,1438375.65
3074,2021-03-29,2021-03-28,,Transfer Received,0.00,2293.73,1440669.38
3075,2021-03-28,2021-03-28,,Rental Income,0.00,2510.50,1443179.88
3076,2021-03-29,2021-03-28,,Groceries - Online Delivery,135.11,0.00,1443044.77
3077,2021-03-29,2021-03-29,,Transfer Received,0.00,2946.00,1445990.77
3078,2021-03-29,2021-03-29,,Credit Card Payment,460.99,0.00,1445529.78
3079,2021-03-29,2021-03-29,,Online Transfer,1518.32,0.00,1444011.46
3080,2021-03-29,2021-03-29,,Salary Credit,0.00,4680.01,1448691.47
3081,2021-03-28,2021-03-29,,Groceries - Supermarket,123.39,0.00,1448568.08
3082,2021-03-28,2021-03-29,,Credit Card Payment,629.01,0.00,1447939.07
3083,2021-03-30,2021-03-30,,Dining Out,55.55,0.00,1447883.52
3084,2021-03-30,2021-03-30,,Groceries - Supermarket,125.42,0.00,1447758.10
3085,2021-03-29,2021-03-30,,Transfer Received,0.00,1447.00,1449205.10
3086,2021-03-30,2021-03-30,,Credit Card Payment,761.29,0.00,1448443.81
3087,2021-03-31,2021-03-31,,Transfer Received,0.00,1525.10,1449968.91
3088,2021-03-31,2021-03-31,,Groceries - Supermarket,178.06,0.00,1449790.85
3089,2021-04-01,2021-03-31,,Salary Credit,0.00,4790.14,1454580.99
3090,2021-04-01,2021-04-01,,Daily Essentials,33.89,0.00,1454547.10
3091,2021-04-01,2021-04-01,,Rental Income,0.00,2509.85,1457056.95
3092,2021-04-01,2021-04-01,,Groceries - Supermarket,181.27,0.00,1456875.68
3093,2021-03-31,2021-04-01,,Groceries - Supermarket,135.55,0.00,1456740.13
3094,2021-04-01,2021-04-01,,Credit Card Payment,234.43,0.00,1456505.70
3095,2021-04-01,2021-04-01,,Transfer Received,0.00,1493.63,1457999.33
3096,2021-04-01,2021-04-01,100074,Cheque Issued,905.44,0.00,1457093.89
3097,2021-04-01,2021-04-01,,Transfer Received,0.00,2007.29,1459101.18
3098,2021-03-31,2021-04-01,,Dividend Received,0.00,193.29,1459294.47
3099,2021-04-01,2021-04-02,,Transfer Received,0.00,1728.41,1461022.88
3100,2021-04-02,2021-04-02,,Transfer Received,0.00,2169.53,1463192.41
3101,2021-04-02,2021-04-02,,Credit Card Payment,384.86,0.00,1462807.55
3102,2021-04-02,2021-04-02,,Interest Credited,0.00,71.49,1462879.04
3103,2021-04-02,2021-04-02,,Transfer Received,0.00,2098.57,1464977.61
3104,2021-04-03,2021-04-02,,Cash Deposit,0.00,285.87,1465263.48
3105,2021-04-01,2021-04-02,,Dining Out,70.37,0.00,1465193.11
3106,2021-04-02,2021-04-02,100075,Cheque Issued,1477.13,0.00,1463715.98
3107,2021-04-02,2021-04-02,,ATM Withdrawal,337.91,0.00,1463378.07
3108,2021-04-02,2021-04-02,,Transfer Received,0.00,1005.05,1464383.12
3109,2021-04-04,2021-04-03,,Online Transfer,1917.37,0.00,1462465.75
3110,2021-04-04,2021-04-03,,Groceries - Supermarket,191.85,0.00,1462273.90
3111,2021-04-03,2021-04-03,,Cash Deposit,0.00,207.22,1462481.12
3112,2021-04-03,2021-04-03,,Transfer Received,0.00,585.71,1463066.83
3113,2021-04-05,2021-04-04,,ATM Withdrawal,229.41,0.00,1462837.42
3114,2021-04-03,2021-04-04,,Transfer Received,0.00,2817.99,1465655.41
3115,2021-04-04,2021-04-04,,Groceries - Supermarket,132.94,0.00,1465522.47
3116,2021-04-04,2021-04-04,,Groceries - Supermarket,198.89,0.00,1465323.58
3117,2021-04-04,2021-04-04,,Utility Payment,175.09,0.00,1465148.49
3118,2021-04-04,2021-04-04,,Interest Credited,0.00,31.57,1465180.06
3119,2021-04-04,2021-04-04,,ATM Withdrawal,182.84,0.00,1464997.22
3120,2021-04-03,2021-04-04,,Salary Credit,0.00,3048.91,1468046.13
3121,2021-04-04,2021-04-04,,Groceries - Online Delivery,67.45,0.00,1467978.68
3122,2021-04-04,2021-04-04,,Transfer Received,0.00,2067.05,1470045.73
3123,2021-04-03,2021-04-04,,ATM Withdrawal,392.61,0.00,1469653.12
3124,2021-04-03,2021-04-04,,Online Transfer,271.05,0.00,1469382.07
3125,2021-04-05,2021-04-05,,Salary Credit,0.00,4913.77,1474295.84
3126,2021-04-05,2021-04-05,,Transfer Received,0.00,1278.81,1475574.65
3127,2021-04-05,2021-04-05,,Groceries - Supermarket,149.32,0.00,1475425.33
3128,2021-04-05,2021-04-05,,Credit Card Payment,588.68,0.00,1474836.65
3129,2021-04-05,2021-04-05,,Groceries - Supermarket,106.99,0.00,1474729.66
3130,2021-04-06,2021-04-05,,Groceries - Supermarket,184.16,0.00,1474545.50
3131,2021-04-06,2021-04-05,,Transfer Received,0.00,890.31,1475435.81
3132,2021-04-06,2021-04-06,,Credit Card Payment,664.31,0.00,1474771.50
3133,2021-04-06,2021-04-06,,Dining Out,98.18,0.00,1474673.32
3134,2021-04-06,2021-04-06,,Transfer Received,0.00,2102.62,1476775.94
3135,2021-04-06,2021-04-06,,Groceries - Online Delivery,98.80,0.00,1476677.14
3136,2021-04-06,2021-04-06,,Credit Card Payment,323.98,0.00,1476353.16
3137,2021-04-07,2021-04-06,,Transfer Received,0.00,2275.31,1478628.47
3138,2021-04-07,2021-04-07,,Transfer Received,0.00,2882.13,1481510.60
3139,2021-04-07,2021-04-07,,ATM Withdrawal,241.18,0.00,1481269.42
3140,2021-04-08,2021-04-08,,ATM Withdrawal,114.44,0.00,1481154.98
3141,2021-04-09,2021-04-08,,Rental Income,0.00,2144.17,1483299.15
3142,2021-04-07,2021-04-08,,Online Transfer,1284.91,0.00,1482014.24
3143,2021-04-08,2021-04-08,,Online Transfer,1561.92,0.00,1480452.32
3144,2021-04-09,2021-04-08,,Dining Out,28.74,0.00,1480423.58
3145,2021-04-10,2021-04-09,,Online Transfer,1310.74,0.00,1479112.84
3146,2021-04-08,2021-04-09,,ATM Withdrawal,24.97,0.00,1479087.87
3147,2021-04-09,2021-04-09,,Groceries - Supermarket,112.93,0.00,1478974.94
3148,2021-04-08,2021-04-09,,Credit Card Payment,867.29,0.00,1478107.65
3149,2021-04-09,2021-04-09,,Dining Out,98.80,0.00,1478008.85
3150,2021-04-08,2021-04-09,,ATM Withdrawal,43.97,0.00,1477964.88
3151,2021-04-09,2021-04-09,,Groceries - Online Delivery,110.14,0.00,1477854.74
3152,2021-04-11,2021-04-10,,Interest Credited,0.00,31.29,1477886.03
3153,2021-04-09,2021-04-10,,Online Transfer,1891.14,0.00,1475994.89
3154,2021-04-10,2021-04-10,,ATM Withdrawal,25.97,0.00,1475968.92
3155,2021-04-10,2021-04-10,,Transfer Received,0.00,2124.34,1478093.26
3156,2021-04-11,2021-04-11,,Online Transfer,1169.88,0.00,1476923.38
3157,2021-04-12,2021-04-11,,Daily Essentials,36.39,0.00,1476886.99
3158,2021-04-11,2021-04-11,,ATM Withdrawal,75.69,0.00,1476811.30
3159,2021-04-11,2021-04-11,,Takeout,36.72,0.00,1476774.58
3160,2021-04-11,2021-04-11,,Salary Credit,0.00,4452.43,1481227.01
3161,2021-04-10,2021-04-11,,Salary Credit,0.00,4227.91,1485454.92
3162,2021-04-10,2021-04-11,,Credit Card Payment,750.57,0.00,1484704.35
3163,2021-04-12,2021-04-12,,Daily Essentials,20.48,0.00,1484683.87
3164,2021-04-12,2021-04-12,,ATM Withdrawal,484.81,0.00,1484199.06
3165,2021-04-12,2021-04-12,,ATM Withdrawal,55.03,0.00,1484144.03
3166,2021-04-13,2021-04-12,100076,Cheque Issued,2422.56,0.00,1481721.47
3167,2021-04-12,2021-04-12,,Investment - SIP,333.11,0.00,1481388.36
3168,2021-04-12,2021-04-12,,Transfer Received,0.00,2754.70,1484143.06
3169,2021-04-13,2021-04-12,,Salary Credit,0.00,3545.05,1487688.11
3170,2021-04-13,2021-04-13,,Credit Card Payment,987.97,0.00,1486700.14
3171,2021-04-13,2021-04-13,,Loan EMI,1709.80,0.00,1484990.34
3172,2021-04-13,2021-04-13,,Utility Payment,218.79,0.00,1484771.55
3173,2021-04-13,2021-04-13,,Groceries - Supermarket,106.30,0.00,1484665.25
3174,2021-04-14,2021-04-13,,Interest Credited,0.00,20.38,1484685.63
3175,2021-04-13,2021-04-13,,Online Transfer,642.07,0.00,1484043.56
3176,2021-04-13,2021-04-13,,ATM Withdrawal,222.53,0.00,1483821.03
3177,2021-04-13,2021-04-13,,Groceries - Supermarket,114.48,0.00,1483706.55
3178,2021-04-13,2021-04-13,,Interest Credited,0.00,35.02,1483741.57
3179,2021-04-12,2021-04-13,,Daily Essentials,29.58,0.00,1483711.99
3180,2021-04-14,2021-04-14,,Online Transfer,1154.71,0.00,1482557.28
3181,2021-04-14,2021-04-14,,Salary Credit,0.00,3875.31,1486432.59
3182,2021-04-13,2021-04-14,,Takeout,37.19,0.00,1486395.40
3183,2021-04-14,2021-04-14,,Investment - SIP,713.42,0.00,1485681.98
3184,2021-04-14,2021-04-14,,Transfer Received,0.00,1362.10,1487044.08
3185,2021-04-13,2021-04-14,,ATM Withdrawal,458.97,0.00,1486585.11
3186,2021-04-13,2021-04-14,,Salary Credit,0.00,4297.49,1490882.60
3187,2021-04-15,2021-04-14,,Interest Credited,0.00,59.90,1490942.50
3188,2021-04-14,2021-04-14,,Transfer Received,0.00,1259.63,1492202.13
3189,2021-04-14,2021-04-14,,Cash Deposit,0.00,117.44,1492319.57
3190,2021-04-14,2021-04-14,,Salary Credit,0.00,3245.42,1495564.99
3191,2021-04-14,2021-04-15,,ATM Withdrawal,148.51,0.00,1495416.48
3192,2021-04-16,2021-04-15,,Online Transfer,1131.70,0.00,1494284.78
3193,2021-04-16,2021-04-15,,Salary Credit,0.00,4106.72,1498391.50
3194,2021-04-15,2021-04-15,,Coffee Shop,5.50,0.00,1498386.00
3195,2021-04-16,2021-04-15,,Salary Credit,0.00,4844.43,1503230.43
3196,2021-04-15,2021-04-15,,Rental Income,0.00,1278.47,1504508.90
3197,2021-04-15,2021-04-15,,Cash Deposit,0.00,744.77,1505253.67
3198,2021-04-15,2021-04-15,,Transfer Received,0.00,1796.87,1507050.54
3199,2021-04-15,2021-04-16,,ATM Withdrawal,140.32,0.00,1506910.22
3200,2021-04-16,2021-04-16,100077,Cheque Issued,616.26,0.00,1506293.96
3201,2021-04-17,2021-04-16,,Online Transfer,1611.92,0.00,1504682.04
3202,2021-04-16,2021-04-16,,Salary Credit,0.00,3632.97,1508315.01
3203,2021-04-16,2021-04-16,,Cash Deposit,0.00,593.96,1508908.97
3204,2021-04-15,2021-04-16,,Interest Credited,0.00,27.21,1508936.18
3205,2021-04-16,2021-04-16,,Rental Income,0.00,1095.85,1510032.03
3206,2021-04-16,2021-04-16,,Investment - SIP,442.51,0.00,1509589.52
3207,2021-04-18,2021-04-17,,Online Transfer,1405.37,0.00,1508184.15
3208,2021-04-18,2021-04-17,,Online Transfer,470.82,0.00,1507713.33
3209,2021-04-17,2021-04-17,,Salary Credit,0.00,2152.94,1509866.27
3210,2021-04-17,2021-04-17,,Transfer Received,0.00,969.25,1510835.52
3211,2021-04-16,2021-04-17,,Credit Card Payment,604.48,0.00,1510231.04
3212,2021-04-17,2021-04-17,,ATM Withdrawal,490.99,0.00,1509740.05
3213,2021-04-16,2021-04-17,,Groceries - Online Delivery,134.93,0.00,1509605.12
3214,2021-04-17,2021-04-17,,Interest Credited,0.00,91.53,1509696.65
3215,2021-04-17,2021-04-17,,Coffee Shop,11.37,0.00,1509685.28
3216,2021-04-19,2021-04-18,,Groceries - Online Delivery,138.65,0.00,1509546.63
3217,2021-04-18,2021-04-18,,ATM Withdrawal,214.19,0.00,1509332.44
3218,2021-04-17,2021-04-18,,Transfer Received,0.00,2892.17,1512224.61
3219,2021-04-19,2021-04-18,,Cash Deposit,0.00,277.81,1512502.42
3220,2021-04-19,2021-04-19,,Transfer Received,0.00,622.47,1513124.89
3221,2021-04-20,2021-04-19,,Investment Returns,0.00,564.05,1513688.94
3222,2021-04-19,2021-04-19,,Interest Credited,0.00,26.95,1513715.89
3223,2021-04-19,2021-04-19,,Dividend Received,0.00,410.11,1514126.00
3224,2021-04-19,2021-04-19,,Investment - Stocks,3841.79,0.00,1510284.21
3225,2021-04-20,2021-04-19,,Investment Returns,0.00,383.06,1510667.27
3226,2021-04-18,2021-04-19,,Salary Credit,0.00,4334.23,1515001.50
3227,2021-04-19,2021-04-19,,ATM Withdrawal,62.55,0.00,1514938.95
3228,2021-04-20,2021-04-19,,ATM Withdrawal,338.11,0.00,1514600.84
3229,2021-04-19,2021-04-19,,Groceries - Supermarket,56.45,0.00,1514544.39
3230,2021-04-19,2021-04-19,,Online Transfer,274.40,0.00,1514269.99
3231,2021-04-19,2021-04-20,,Takeout,47.12,0.00,1514222.87
3232,2021-04-20,2021-04-20,,Salary Credit,0.00,4582.76,1518805.63
3233,2021-04-21,2021-04-20,,Transfer Received,0.00,1439.55,1520245.18
3234,2021-04-20,2021-04-20,,Groceries - Supermarket,62.35,0.00,1520182.83
3235,2021-04-20,2021-04-20,,Transfer Received,0.00,527.54,1520710.37
3236,2021-04-20,2021-04-20,,Investment - Mutual Funds,2990.06,0.00,1517720.31
3237,2021-04-20,2021-04-20,,Salary Credit,0.00,4788.36,1522508.67
3238,2021-04-20,2021-04-20,,ATM Withdrawal,458.48,0.00,1522050.19
3239,2021-04-21,2021-04-20,,Groceries - Supermarket,89.88,0.00,1521960.31
3240,2021-04-21,2021-04-21,,Dining Out,61.02,0.00,1521899.29
3241,2021-04-21,2021-04-21,,Loan EMI,1960.10,0.00,1519939.19
3242,2021-04-21,2021-04-21,,Interest Credited,0.00,34.59,1519973.78
3243,2021-04-20,2021-04-21,,ATM Withdrawal,199.89,0.00,1519773.89
3244,2021-04-21,2021-04-21,,Salary Credit,0.00,2669.11,1522443.00
3245,2021-04-21,2021-04-21,,Credit Card Payment,948.15,0.00,1521494.85
3246,2021-04-22,2021-04-21,,Transfer Received,0.00,2622.96,1524117.81
3247,2021-04-23,2021-04-22,,Dining Out,92.36,0.00,1524025.45
3248,2021-04-22,2021-04-22,,Utility Payment,68.83,0.00,1523956.62
3249,2021-04-22,2021-04-22,,ATM Withdrawal,481.77,0.00,1523474.85
3250,2021-04-22,2021-04-22,,Dining Out,76.94,0.00,1523397.91
3251,2021-04-22,2021-04-22,,Transfer Received,0.00,950.80,1524348.71
3252,2021-04-21,2021-04-22,,Interest Credited,0.00,80.35,1524429.06
3253,2021-04-22,2021-04-22,,Online Transfer,1813.23,0.00,1522615.83
3254,2021-04-23,2021-04-23,,Cash Deposit,0.00,931.21,1523547.04
3255,2021-04-23,2021-04-23,,Transfer Received,0.00,1340.92,1524887.96
3256,2021-04-23,2021-04-23,,Credit Card Payment,939.13,0.00,1523948.83
3257,2021-04-22,2021-04-23,,Salary Credit,0.00,2582.28,1526531.11
3258,2021-04-24,2021-04-23,,Salary Credit,0.00,3980.65,1530511.76
3259,2021-04-23,2021-04-23,,Salary Credit,0.00,2437.89,1532949.65
3260,2021-04-24,2021-04-23,,Salary Credit,0.00,4705.52,1537655.17
3261,2021-04-24,2021-04-23,,Transfer Received,0.00,2515.40,1540170.57
3262,2021-04-22,2021-04-23,,ATM Withdrawal,168.70,0.00,1540001.87
3263,2021-04-24,2021-04-23,,Credit Card Payment,785.12,0.00,1539216.75
3264,2021-04-24,2021-04-24,,Loan EMI,641.67,0.00,1538575.08
3265,2021-04-24,2021-04-24,,Transfer Received,0.00,2694.80,1541269.88
3266,2021-04-23,2021-04-24,,Salary Credit,0.00,3891.64,1545161.52
3267,2021-04-23,2021-04-24,,ATM Withdrawal,486.96,0.00,1544674.56
3268,2021-04-24,2021-04-24,,Credit Card Payment,534.22,0.00,1544140.34
3269,2021-04-24,2021-04-24,,Dividend Received,0.00,359.64,1544499.98
3270,2021-04-25,2021-04-24,,Utility Payment,244.42,0.00,1544255.56
3271,2021-04-25,2021-04-25,,Online Transfer,806.17,0.00,1543449.39
3272,2021-04-24,2021-04-25,,ATM Withdrawal,366.09,0.00,1543083.30
3273,2021-04-24,2021-04-25,,Transfer Received,0.00,2367.90,1545451.20
3274,2021-04-25,2021-04-25,,Transfer Received,0.00,2309.23,1547760.43
3275,2021-04-26,2021-04-25,,Rental Income,0.00,2184.87,1549945.30
3276,2021-04-25,2021-04-25,,Investment - Mutual Funds,2524.09,0.00,1547421.21
3277,2021-04-25,2021-04-26,,Transfer Received,0.00,1429.33,1548850.54
3278,2021-04-25,2021-04-26,,Coffee Shop,12.78,0.00,1548837.76
3279,2021-04-26,2021-04-26,,Salary Credit,0.00,2230.44,1551068.20
3280,2021-04-26,2021-04-26,,ATM Withdrawal,43.46,0.00,1551024.74
3281,2021-04-26,2021-04-26,,Online Transfer,193.87,0.00,1550830.87
3282,2021-04-25,2021-04-26,,Salary Credit,0.00,4525.95,1555356.82
3283,2021-04-26,2021-04-27,,Transfer Received,0.00,794.67,1556151.49
3284,2021-04-27,2021-04-27,,Salary Credit,0.00,3058.39,1559209.88
3285,2021-04-27,2021-04-27,,Investment Returns,0.00,364.80,1559574.68
3286,2021-04-26,2021-04-27,,Interest Credited,0.00,29.92,1559604.60
3287,2021-04-27,2021-04-28,,Cash Deposit,0.00,647.18,1560251.78
3288,2021-04-28,2021-04-28,,Takeout,11.09,0.00,1560240.69
3289,2021-04-28,2021-04-28,,Transfer Received,0.00,2999.38,1563240.07
3290,2021-04-28,2021-04-28,,Coffee Shop,11.44,0.00,1563228.63
3291,2021-04-28,2021-04-28,,Online Transfer,159.29,0.00,1563069.34
3292,2021-04-29,2021-04-28,,Dividend Received,0.00,110.67,1563180.01
3293,2021-04-29,2021-04-28,,ATM Withdrawal,174.22,0.00,1563005.79
3294,2021-04-29,2021-04-29,,Groceries - Supermarket,179.27,0.00,1562826.52
3295,2021-04-29,2021-04-29,,Salary Credit,0.00,3713.68,1566540.20
3296,2021-04-29,2021-04-29,,Interest Credited,0.00,33.56,1566573.76
3297,2021-04-30,2021-04-29,,Loan EMI,1970.27,0.00,1564603.49
3298,2021-04-30,2021-04-29,,Online Transfer,1547.81,0.00,1563055.68
3299,2021-04-29,2021-04-29,,Groceries - Supermarket,58.94,0.00,1562996.74
3300,2021-04-29,2021-04-30,,Groceries - Online Delivery,105.07,0.00,1562891.67
3301,2021-05-01,2021-04-30,,ATM Withdrawal,75.58,0.00,1562816.09
3302,2021-04-29,2021-04-30,,Utility Payment,238.69,0.00,1562577.40
3303,2021-04-30,2021-04-30,,Transfer Received,0.00,1600.08,1564177.48
3304,2021-04-30,2021-04-30,,Loan EMI,1887.11,0.00,1562290.37
3305,2021-05-01,2021-04-30,,Salary Credit,0.00,3064.82,1565355.19
3306,2021-04-30,2021-04-30,,Transfer Received,0.00,1511.32,1566866.51
3307,2021-04-29,2021-04-30,,Dining Out,75.56,0.00,1566790.95
3308,2021-04-30,2021-04-30,,Credit Card Payment,599.81,0.00,1566191.14
3309,2021-04-30,2021-04-30,,Transfer Received,0.00,1136.98,1567328.12
3310,2021-05-01,2021-05-01,,Salary Credit,0.00,2484.77,1569812.89
3311,2021-05-02,2021-05-01,,Transfer Received,0.00,508.72,1570321.61
3312,2021-04-30,2021-05-01,,Interest Credited,0.00,11.08,1570332.69
3313,2021-05-01,2021-05-01,,Online Transfer,1052.73,0.00,1569279.96
3314,2021-05-02,2021-05-01,,Groceries - Supermarket,181.31,0.00,1569098.65
3315,2021-05-01,2021-05-01,,Interest Credited,0.00,76.92,1569175.57
3316,2021-04-30,2021-05-01,,Cash Deposit,0.00,305.94,1569481.51
3317,2021-05-01,2021-05-01,,Groceries - Online Delivery,71.73,0.00,1569409.78
3318,2021-05-01,2021-05-01,,Groceries - Supermarket,85.36,0.00,1569324.42
3319,2021-05-01,2021-05-01,,Salary Credit,0.00,3095.33,1572419.75
3320,2021-05-01,2021-05-01,,Investment - Stocks,2339.04,0.00,1570080.71
3321,2021-04-30,2021-05-01,,Salary Credit,0.00,2245.59,1572326.30
3322,2021-05-02,2021-05-01,,Groceries - Supermarket,61.96,0.00,1572264.34
3323,2021-05-02,2021-05-02,,Dining Out,57.18,0.00,1572207.16
3324,2021-05-01,2021-05-02,,Dining Out,93.73,0.00,1572113.43
3325,2021-05-02,2021-05-02,,ATM Withdrawal,120.86,0.00,1571992.57
3326,2021-05-02,2021-05-02,,Transfer Received,0.00,1328.51,1573321.08
3327,2021-05-01,2021-05-02,,Investment - Mutual Funds,577.66,0.00,1572743.42
3328,2021-05-03,2021-05-02,,Cash Deposit,0.00,637.29,1573380.71
3329,2021-05-02,2021-05-02,,Online Transfer,1965.24,0.00,1571415.47
3330,2021-05-03,2021-05-02,,Salary Credit,0.00,4778.53,1576194.00
3331,2021-05-02,2021-05-02,,Utility Payment,208.16,0.00,1575985.84
3332,2021-05-02,2021-05-02,,Salary Credit,0.00,4220.29,1580206.13
3333,2021-05-02,2021-05-02,,Groceries - Online Delivery,140.32,0.00,1580065.81
3334,2021-05-02,2021-05-02,,Interest Credited,0.00,88.43,1580154.24
3335,2021-05-03,2021-05-03,,Groceries - Online Delivery,106.66,0.00,1580047.58
3336,2021-05-02,2021-05-03,,Loan EMI,1998.77,0.00,1578048.81
3337,2021-05-03,2021-05-03,,Investment - Mutual Funds,2781.33,0.00,1575267.48
3338,2021-05-04,2021-05-03,,Credit Card Payment,777.93,0.00,1574489.55
3339,2021-05-03,2021-05-03,,Online Transfer,1740.62,0.00,1572748.93
3340,2021-05-03,2021-05-03,,Takeout,17.58,0.00,1572731.35
3341,2021-05-03,2021-05-03,,Daily Essentials,34.35,0.00,1572697.00
3342,2021-05-03,2021-05-03,,Online Transfer,1694.67,0.00,1571002.33
3343,2021-05-04,2021-05-03,,Groceries - Online Delivery,108.75,0.00,1570893.58
3344,2021-05-04,2021-05-04,,Credit Card Payment,813.89,0.00,1570079.69
3345,2021-05-04,2021-05-04,,Transfer Received,0.00,2506.76,1572586.45
3346,2021-05-04,2021-05-04,,Salary Credit,0.00,2102.08,1574688.53
3347,2021-05-04,2021-05-04,,Cash Deposit,0.00,629.37,1575317.90
3348,2021-05-05,2021-05-04,,Transfer Received,0.00,526.92,1575844.82
3349,2021-05-05,2021-05-05,,Online Transfer,399.77,0.00,1575445.05
3350,2021-05-05,2021-05-05,,Online Transfer,365.53,0.00,1575079.52
3351,2021-05-06,2021-05-05,,Online Transfer,1348.65,0.00,1573730.87
3352,2021-05-05,2021-05-05,,Credit Card Payment,284.36,0.00,1573446.51
3353,2021-05-05,2021-05-05,,Groceries - Supermarket,65.52,0.00,1573380.99
3354,2021-05-05,2021-05-05,,Transfer Received,0.00,507.08,1573888.07
3355,2021-05-05,2021-05-05,,Cash Deposit,0.00,733.01,1574621.08
3356,2021-05-05,2021-05-05,,Takeout,36.08,0.00,1574585.00
3357,2021-05-07,2021-05-06,,Coffee Shop,18.27,0.00,1574566.73
3358,2021-05-05,2021-05-06,,Credit Card Payment,714.32,0.00,1573852.41
3359,2021-05-06,2021-05-06,,Online Transfer,808.19,0.00,1573044.22
3360,2021-05-05,2021-05-06,,Dividend Received,0.00,103.05,1573147.27
3361,2021-05-06,2021-05-06,,Groceries - Supermarket,165.25,0.00,1572982.02
3362,2021-05-05,2021-05-06,,Utility Payment,133.80,0.00,1572848.22
3363,2021-05-05,2021-05-06,,Transfer Received,0.00,2983.12,1575831.34
3364,2021-05-06,2021-05-06,,Salary Credit,0.00,3226.95,1579058.29
3365,2021-05-06,2021-05-06,,Transfer Received,0.00,2221.10,1581279.39
3366,2021-05-07,2021-05-07,,Transfer Received,0.00,893.16,1582172.55
3367,2021-05-07,2021-05-07,,Salary Credit,0.00,4265.43,1586437.98
3368,2021-05-07,2021-05-07,,Groceries - Supermarket,127.26,0.00,1586310.72
3369,2021-05-07,2021-05-07,,Transfer Received,0.00,2966.14,1589276.86
3370,2021-05-08,2021-05-07,,Transfer Received,0.00,1884.10,1591160.96
3371,2021-05-06,2021-05-07,,Groceries - Online Delivery,59.20,0.00,1591101.76
3372,2021-05-07,2021-05-07,,Groceries - Supermarket,83.81,0.00,1591017.95
3373,2021-05-07,2021-05-07,,Online Transfer,329.68,0.00,1590688.27
3374,2021-05-07,2021-05-07,,Transfer Received,0.00,1910.70,1592598.97
3375,2021-05-07,2021-05-07,,Online Transfer,354.03,0.00,1592244.94
3376,2021-05-07,2021-05-07,,Online Transfer,815.77,0.00,1591429.17
3377,2021-05-07,2021-05-07,,Salary Credit,0.00,3824.59,1595253.76
3378,2021-05-07,2021-05-07,,Utility Payment,176.49,0.00,1595077.27
3379,2021-05-07,2021-05-08,,Groceries - Supermarket,92.78,0.00,1594984.49
3380,2021-05-08,2021-05-08,,ATM Withdrawal,422.99,0.00,1594561.50
3381,2021-05-09,2021-05-08,,Interest Credited,0.00,44.84,1594606.34
3382,2021-05-07,2021-05-08,,Rental Income,0.00,2029.75,1596636.09
3383,2021-05-08,2021-05-08,,Credit Card Payment,532.33,0.00,1596103.76
3384,2021-05-08,2021-05-08,,Online Transfer,425.09,0.00,1595678.67
3385,2021-05-08,2021-05-08,,Transfer Received,0.00,2864.39,1598543.06
3386,2021-05-08,2021-05-09,,Groceries - Supermarket,98.75,0.00,1598444.31
3387,2021-05-09,2021-05-09,,Transfer Received,0.00,1965.26,1600409.57
3388,2021-05-09,2021-05-09,,Credit Card Payment,336.69,0.00,1600072.88
3389,2021-05-09,2021-05-09,,Transfer Received,0.00,2959.82,1603032.70
3390,2021-05-09,2021-05-09,100078,Cheque Issued,1577.88,0.00,1601454.82
3391,2021-05-09,2021-05-09,,Transfer Received,0.00,794.23,1602249.05
3392,2021-05-09,2021-05-09,,ATM Withdrawal,206.79,0.00,1602042.26
3393,2021-05-09,2021-05-09,,Transfer Received,0.00,2047.65,1604089.91
3394,2021-05-10,2021-05-10,,Salary Credit,0.00,3877.67,1607967.58
3395,2021-05-10,2021-05-10,,Transfer Received,0.00,1877.13,1609844.71
3396,2021-05-10,2021-05-10,,Transfer Received,0.00,1362.84,1611207.55
3397,2021-05-10,2021-05-10,,Utility Payment,296.25,0.00,1610911.30
3398,2021-05-10,2021-05-10,,Groceries - Supermarket,117.47,0.00,1610793.83
3399,2021-05-11,2021-05-11,,Salary Credit,0.00,3858.22,1614652.05
3400,2021-05-11,2021-05-11,,Transfer Received,0.00,2701.21,1617353.26
3401,2021-05-11,2021-05-11,,ATM Withdrawal,89.25,0.00,1617264.01
3402,2021-05-11,2021-05-11,,Groceries - Online Delivery,83.80,0.00,1617180.21
3403,2021-05-11,2021-05-11,,Cash Deposit,0.00,238.64,1617418.85
3404,2021-05-12,2021-05-12,,ATM Withdrawal,150.40,0.00,1617268.45
3405,2021-05-12,2021-05-12,,Transfer Received,0.00,708.76,1617977.21
3406,2021-05-12,2021-05-12,,Salary Credit,0.00,3912.53,1621889.74
3407,2021-05-12,2021-05-12,,Interest Credited,0.00,72.25,1621961.99
3408,2021-05-12,2021-05-12,,ATM Withdrawal,344.50,0.00,1621617.49
3409,2021-05-12,2021-05-12,,Salary Credit,0.00,3131.37,1624748.86
3410,2021-05-13,2021-05-12,,Online Transfer,964.63,0.00,1623784.23
3411,2021-05-12,2021-05-12,,Investment - SIP,512.62,0.00,1623271.61
3412,2021-05-11,2021-05-12,,Interest Credited,0.00,24.94,1623296.55
3413,2021-05-13,2021-05-13,,Transfer Received,0.00,2165.00,1625461.55
3414,2021-05-13,2021-05-13,,Rental Income,0.00,1903.39,1627364.94
3415,2021-05-13,2021-05-13,,Online Transfer,357.59,0.00,1627007.35
3416,2021-05-13,2021-05-13,,Transfer Received,0.00,2999.78,1630007.13
3417,2021-05-14,2021-05-14,,Transfer Received,0.00,2604.29,1632611.42
3418,2021-05-14,2021-05-14,,Groceries - Supermarket,130.44,0.00,1632480.98
3419,2021-05-14,2021-05-14,,Utility Payment,136.67,0.00,1632344.31
3420,2021-05-15,2021-05-15,,Cash Deposit,0.00,545.72,1632890.03
3421,2021-05-15,2021-05-15,,Salary Credit,0.00,4362.39,1637252.42
3422,2021-05-16,2021-05-15,,Online Transfer,117.21,0.00,1637135.21
3423,2021-05-15,2021-05-15,,Transfer Received,0.00,2152.39,1639287.60
3424,2021-05-14,2021-05-15,100079,Cheque Issued,2288.16,0.00,1636999.44
3425,2021-05-15,2021-05-15,,Online Transfer,1329.05,0.00,1635670.39
3426,2021-05-15,2021-05-15,,Transfer Received,0.00,2239.87,1637910.26
3427,2021-05-15,2021-05-15,,Salary Credit,0.00,4124.59,1642034.85
3428,2021-05-15,2021-05-15,,ATM Withdrawal,96.85,0.00,1641938.00
3429,2021-05-14,2021-05-15,,Credit Card Payment,767.38,0.00,1641170.62
3430,2021-05-15,2021-05-15,,Groceries - Supermarket,107.55,0.00,1641063.07
3431,2021-05-15,2021-05-15,,Salary Credit,0.00,2295.88,1643358.95
3432,2021-05-17,2021-05-16,,Investment - SIP,330.69,0.00,1643028.26
3433,2021-05-15,2021-05-16,,Salary Credit,0.00,2753.29,1645781.55
3434,2021-05-18,2021-05-17,,Groceries - Supermarket,186.32,0.00,1645595.23
3435,2021-05-17,2021-05-17,,Salary Credit,0.00,3405.96,1649001.19
3436,2021-05-16,2021-05-17,,Coffee Shop,9.80,0.00,1648991.39
3437,2021-05-18,2021-05-17,,Cash Deposit,0.00,793.00,1649784.39
3438,2021-05-17,2021-05-17,,Dining Out,53.22,0.00,1649731.17
3439,2021-05-17,2021-05-17,,Salary Credit,0.00,3722.49,1653453.66
3440,2021-05-17,2021-05-17,,Online Transfer,1760.23,0.00,1651693.43
3441,2021-05-18,2021-05-17,,ATM Withdrawal,338.93,0.00,1651354.50
3442,2021-05-18,2021-05-18,,Salary Credit,0.00,4480.00,1655834.50
3443,2021-05-17,2021-05-18,,Credit Card Payment,411.09,0.00,1655423.41
3444,2021-05-18,2021-05-18,,Groceries - Supermarket,139.71,0.00,1655283.70
3445,2021-05-18,2021-05-18,,Rental Income,0.00,2865.69,1658149.39
3446,2021-05-18,2021-05-18,,Credit Card Payment,487.79,0.00,1657661.60
3447,2021-05-17,2021-05-18,,Credit Card Payment,851.51,0.00,1656810.09
3448,2021-05-17,2021-05-18,,Transfer Received,0.00,2383.13,1659193.22
3449,2021-05-18,2021-05-18,,Online Transfer,1209.03,0.00,1657984.19
3450,2021-05-18,2021-05-18,,Credit Card Payment,660.95,0.00,1657323.24
3451,2021-05-18,2021-05-18,,Transfer Received,0.00,2768.56,1660091.80
3452,2021-05-18,2021-05-18,,Loan EMI,1466.93,0.00,1658624.87
3453,2021-05-18,2021-05-18,,Salary Credit,0.00,2458.03,1661082.90
3454,2021-05-19,2021-05-19,,Dining Out,61.24,0.00,1661021.66
3455,2021-05-19,2021-05-19,,Rental Income,0.00,1324.19,1662345.85
3456,2021-05-19,2021-05-19,,Salary Credit,0.00,2148.63,1664494.48
3457,2021-05-19,2021-05-19,,ATM Withdrawal,119.60,0.00,1664374.88
3458,2021-05-20,2021-05-19,,Investment - Stocks,3664.49,0.00,1660710.39
3459,2021-05-19,2021-05-19,,Utility Payment,156.32,0.00,1660554.07
3460,2021-05-19,2021-05-19,,Transfer Received,0.00,2140.38,1662694.45
3461,2021-05-20,2021-05-20,,Salary Credit,0.00,4891.16,1667585.61
3462,2021-05-20,2021-05-20,,Salary Credit,0.00,4969.87,1672555.48
3463,2021-05-20,2021-05-20,,ATM Withdrawal,457.46,0.00,1672098.02
3464,2021-05-20,2021-05-20,,Groceries - Online Delivery,76.84,0.00,1672021.18
3465,2021-05-20,2021-05-20,,ATM Withdrawal,124.48,0.00,1671896.70
3466,2021-05-19,2021-05-20,,Takeout,33.20,0.00,1671863.50
3467,2021-05-19,2021-05-20,,Groceries - Supermarket,174.55,0.00,1671688.95
3468,2021-05-19,2021-05-20,,Online Transfer,718.05,0.00,1670970.90
3469,2021-05-21,2021-05-21,,Online Transfer,470.02,0.00,1670500.88
3470,2021-05-22,2021-05-21,,Credit Card Payment,903.11,0.00,1669597.77
3471,2021-05-21,2021-05-21,,Transfer Received,0.00,2568.48,1672166.25
3472,2021-05-21,2021-05-21,,Groceries - Supermarket,178.64,0.00,1671987.61
3473,2021-05-22,2021-05-22,,Utility Payment,208.26,0.00,1671779.35
3474,2021-05-22,2021-05-22,100080,Cheque Issued,1602.90,0.00,1670176.45
3475,2021-05-22,2021-05-22,,Transfer Received,0.00,1967.42,1672143.87
3476,2021-05-22,2021-05-22,,Credit Card Payment,348.67,0.00,1671795.20
3477,2021-05-23,2021-05-22,,Interest Credited,0.00,78.91,1671874.11
3478,2021-05-24,2021-05-23,,Salary Credit,0.00,3278.27,1675152.38
3479,2021-05-23,2021-05-23,,Transfer Received,0.00,1954.96,1677107.34
3480,2021-05-23,2021-05-23,,Cash Deposit,0.00,572.53,1677679.87
3481,2021-05-22,2021-05-23,100081,Cheque Issued,2252.90,0.00,1675426.97
3482,2021-05-23,2021-05-23,,Investment - Mutual Funds,2216.62,0.00,1673210.35
3483,2021-05-23,2021-05-23,,Groceries - Supermarket,144.91,0.00,1673065.44
3484,2021-05-25,2021-05-24,,Groceries - Online Delivery,79.45,0.00,1672985.99
3485,2021-05-24,2021-05-24,,Transfer Received,0.00,905.99,1673891.98
3486,2021-05-24,2021-05-24,,ATM Withdrawal,81.76,0.00,1673810.22
3487,2021-05-25,2021-05-24,,Online Transfer,1722.59,0.00,1672087.63
3488,2021-05-24,2021-05-24,,ATM Withdrawal,493.90,0.00,1671593.73
3489,2021-05-25,2021-05-24,,Transfer Received,0.00,588.08,1672181.81
3490,2021-05-24,2021-05-24,,Rental Income,0.00,2115.74,1674297.55
3491,2021-05-25,2021-05-25,,Takeout,39.14,0.00,1674258.41
3492,2021-05-25,2021-05-25,,Salary Credit,0.00,2341.08,1676599.49
3493,2021-05-26,2021-05-25,,Groceries - Online Delivery,55.55,0.00,1676543.94
3494,2021-05-26,2021-05-25,,Salary Credit,0.00,4645.68,1681189.62
3495,2021-05-25,2021-05-25,,Transfer Received,0.00,1300.62,1682490.24
3496,2021-05-26,2021-05-26,,Utility Payment,224.26,0.00,1682265.98
3497,2021-05-26,2021-05-26,,ATM Withdrawal,102.93,0.00,1682163.05
3498,2021-05-26,2021-05-26,,Interest Credited,0.00,44.46,1682207.51
3499,2021-05-26,2021-05-26,,ATM Withdrawal,417.48,0.00,1681790.03
3500,2021-05-27,2021-05-26,,Credit Card Payment,750.79,0.00,1681039.24
3501,2021-05-28,2021-05-27,,Online Transfer,1082.61,0.00,1679956.63
3502,2021-05-27,2021-05-27,,ATM Withdrawal,298.81,0.00,1679657.82
3503,2021-05-27,2021-05-27,,Salary Credit,0.00,4037.55,1683695.37
3504,2021-05-26,2021-05-27,,ATM Withdrawal,387.19,0.00,1683308.18
3505,2021-05-28,2021-05-28,,ATM Withdrawal,499.76,0.00,1682808.42
3506,2021-05-28,2021-05-28,,ATM Withdrawal,455.46,0.00,1682352.96
3507,2021-05-28,2021-05-28,,Interest Credited,0.00,50.10,1682403.06
3508,2021-05-28,2021-05-28,,Daily Essentials,25.01,0.00,1682378.05
3509,2021-05-27,2021-05-28,,Online Transfer,1854.54,0.00,1680523.51
3510,2021-05-29,2021-05-29,,Transfer Received,0.00,625.07,1681148.58
3511,2021-05-30,2021-05-29,,ATM Withdrawal,339.59,0.00,1680808.99
3512,2021-05-29,2021-05-29,,Transfer Received,0.00,2388.79,1683197.78
3513,2021-05-29,2021-05-29,,Rental Income,0.00,2477.18,1685674.96
3514,2021-05-30,2021-05-29,,Interest Credited,0.00,11.10,1685686.06
3515,2021-05-29,2021-05-29,,Salary Credit,0.00,4232.06,1689918.12
3516,2021-05-29,2021-05-29,,ATM Withdrawal,485.89,0.00,1689432.23
3517,2021-05-30,2021-05-29,,Utility Payment,89.46,0.00,1689342.77
3518,2021-05-29,2021-05-29,,ATM Withdrawal,292.40,0.00,1689050.37
3519,2021-05-29,2021-05-30,,Transfer Received,0.00,2761.44,1691811.81
3520,2021-05-30,2021-05-30,,Online Transfer,1911.16,0.00,1689900.65
3521,2021-05-30,2021-05-30,,Dining Out,78.43,0.00,1689822.22
3522,2021-05-30,2021-05-30,,Salary Credit,0.00,4014.46,1693836.68
3523,2021-05-30,2021-05-30,,Groceries - Supermarket,105.56,0.00,1693731.12
3524,2021-05-31,2021-05-30,,Transfer Received,0.00,2711.31,1696442.43
3525,2021-05-30,2021-05-30,,ATM Withdrawal,33.39,0.00,1696409.04
3526,2021-05-31,2021-05-30,100082,Cheque Issued,2587.28,0.00,1693821.76
3527,2021-05-30,2021-05-30,,Credit Card Payment,697.75,0.00,1693124.01
3528,2021-05-30,2021-05-30,,Transfer Received,0.00,2481.77,1695605.78
3529,2021-05-30,2021-05-30,,Investment Returns,0.00,283.19,1695888.97
3530,2021-05-30,2021-05-30,,ATM Withdrawal,189.50,0.00,1695699.47
3531,2021-05-30,2021-05-30,,Daily Essentials,5.44,0.00,1695694.03
3532,2021-05-30,2021-05-30,,Dining Out,64.27,0.00,1695629.76
3533,2021-06-01,2021-05-31,,Dining Out,98.55,0.00,1695531.21
3534,2021-05-31,2021-05-31,,Salary Credit,0.00,2422.20,1697953.41
3535,2021-05-31,2021-05-31,,Groceries - Supermarket,44.06,0.00,1697909.35
3536,2021-05-31,2021-05-31,,Transfer Received,0.00,556.60,1698465.95
3537,2021-05-31,2021-05-31,,Credit Card Payment,331.81,0.00,1698134.14
3538,2021-05-31,2021-05-31,,Transfer Received,0.00,574.38,1698708.52
3539,2021-06-01,2021-06-01,,Online Transfer,1205.90,0.00,1697502.62
3540,2021-06-01,2021-06-01,,Online Transfer,1323.72,0.00,1696178.90
3541,2021-06-02,2021-06-01,,Interest Credited,0.00,70.25,1696249.15
3542,2021-06-01,2021-06-01,,ATM Withdrawal,402.29,0.00,1695846.86
3543,2021-06-01,2021-06-01,,Salary Credit,0.00,3672.99,1699519.85
3544,2021-06-02,2021-06-01,,Salary Credit,0.00,2128.85,1701648.70
3545,2021-06-03,2021-06-02,,Cash Deposit,0.00,987.64,1702636.34
3546,2021-06-03,2021-06-02,,Daily Essentials,23.12,0.00,1702613.22
3547,2021-06-02,2021-06-02,,Rental Income,0.00,2366.44,1704979.66
3548,2021-06-02,2021-06-02,,Coffee Shop,9.76,0.00,1704969.90
3549,2021-06-01,2021-06-02,,ATM Withdrawal,113.11,0.00,1704856.79
3550,2021-06-01,2021-06-02,,Coffee Shop,6.71,0.00,1704850.08
3551,2021-06-02,2021-06-02,,Groceries - Supermarket,128.70,0.00,1704721.38
3552,2021-06-02,2021-06-02,,Dining Out,86.71,0.00,1704634.67
3553,2021-06-02,2021-06-03,,Dining Out,29.67,0.00,1704605.00
3554,2021-06-03,2021-06-03,,Online Transfer,653.34,0.00,1703951.66
3555,2021-06-03,2021-06-03,,Rental Income,0.00,1950.67,1705902.33
3556,2021-06-03,2021-06-03,,Online Transfer,498.53,0.00,1705403.80
3557,2021-06-03,2021-06-03,,Utility Payment,256.52,0.00,1705147.28
3558,2021-06-04,2021-06-03,,ATM Withdrawal,58.20,0.00,1705089.08
3559,2021-06-04,2021-06-03,,Credit Card Payment,671.20,0.00,1704417.88
3560,2021-06-03,2021-06-03,,Salary Credit,0.00,2249.04,1706666.92
3561,2021-06-05,2021-06-04,,Transfer Received,0.00,1305.67,1707972.59
3562,2021-06-04,2021-06-04,,Credit Card Payment,642.71,0.00,1707329.88
3563,2021-06-04,2021-06-04,,Salary Credit,0.00,2852.68,1710182.56
3564,2021-06-04,2021-06-04,,Utility Payment,81.90,0.00,1710100.66
3565,2021-06-05,2021-06-04,,ATM Withdrawal,226.45,0.00,1709874.21
3566,2021-06-03,2021-06-04,,Online Transfer,1642.67,0.00,1708231.54
3567,2021-06-03,2021-06-04,,Salary Credit,0.00,4088.65,1712320.19
3568,2021-06-03,2021-06-04,,Groceries - Supermarket,101.63,0.00,1712218.56
3569,2021-06-04,2021-06-04,,Groceries - Supermarket,86.16,0.00,1712132.40
3570,2021-06-05,2021-06-04,,ATM Withdrawal,286.62,0.00,1711845.78
3571,2021-06-05,2021-06-05,,Takeout,12.96,0.00,1711832.82
3572,2021-06-05,2021-06-05,,ATM Withdrawal,235.62,0.00,1711597.20
3573,2021-06-06,2021-06-05,,ATM Withdrawal,429.63,0.00,1711167.57
3574,2021-06-05,2021-06-06,,Online Transfer,1742.38,0.00,1709425.19
3575,2021-06-06,2021-06-06,,Credit Card Payment,993.32,0.00,1708431.87
3576,2021-06-06,2021-06-06,,Transfer Received,0.00,1977.45,1710409.32
3577,2021-06-06,2021-06-06,,Groceries - Supermarket,134.22,0.00,1710275.10
3578,2021-06-05,2021-06-06,100083,Cheque Issued,2889.87,0.00,1707385.23
3579,2021-06-05,2021-06-06,,Online Transfer,114.38,0.00,1707270.85
3580,2021-06-06,2021-06-06,,Credit Card Payment,362.87,0.00,1706907.98
3581,2021-06-08,2021-06-07,,Utility Payment,213.82,0.00,1706694.16
3582,2021-06-06,2021-06-07,,Salary Credit,0.00,2620.15,1709314.31
3583,2021-06-07,2021-06-07,,Groceries - Online Delivery,138.03,0.00,1709176.28
3584,2021-06-08,2021-06-07,,ATM Withdrawal,460.73,0.00,1708715.55
3585,2021-06-07,2021-06-07,,Utility Payment,152.87,0.00,1708562.68
3586,2021-06-08,2021-06-07,,Dining Out,27.49,0.00,1708535.19
3587,2021-06-08,2021-06-08,,Interest Credited,0.00,24.78,1708559.97
3588,2021-06-09,2021-06-08,,Utility Payment,167.90,0.00,1708392.07
3589,2021-06-09,2021-06-08,,Salary Credit,0.00,2630.75,1711022.82
3590,2021-06-08,2021-06-08,,Transfer Received,0.00,1435.12,1712457.94
3591,2021-06-09,2021-06-08,,Investment Returns,0.00,465.06,1712923.00
3592,2021-06-08,2021-06-08,,Investment - SIP,101.77,0.00,1712821.23
3593,2021-06-09,2021-06-08,,Groceries - Supermarket,92.16,0.00,1712729.07
3594,2021-06-08,2021-06-08,,ATM Withdrawal,227.92,0.00,1712501.15
3595,2021-06-08,2021-06-08,,Online Transfer,204.98,0.00,1712296.17
3596,2021-06-09,2021-06-09,,Utility Payment,193.50,0.00,1712102.67
3597,2021-06-10,2021-06-09,,Interest Credited,0.00,64.44,1712167.11
3598,2021-06-09,2021-06-09,,Transfer Received,0.00,1514.82,1713681.93
3599,2021-06-10,2021-06-10,,Salary Credit,0.00,2829.51,1716511.44
3600,2021-06-10,2021-06-10,,Transfer Received,0.00,2413.04,1718924.48
3601,2021-06-11,2021-06-10,,ATM Withdrawal,150.98,0.00,1718773.50
3602,2021-06-11,2021-06-10,,Credit Card Payment,332.67,0.00,1718440.83
3603,2021-06-10,2021-06-10,,Online Transfer,862.65,0.00,1717578.18
3604,2021-06-12,2021-06-11,,Credit Card Payment,992.39,0.00,1716585.79
3605,2021-06-11,2021-06-11,,Transfer Received,0.00,1539.12,1718124.91
3606,2021-06-10,2021-06-11,,Online Transfer,1928.45,0.00,1716196.46
3607,2021-06-12,2021-06-11,,Transfer Received,0.00,1476.24,1717672.70
3608,2021-06-11,2021-06-11,,Salary Credit,0.00,3263.49,1720936.19
3609,2021-06-11,2021-06-11,,Cash Deposit,0.00,291.68,1721227.87
3610,2021-06-11,2021-06-11,,Groceries - Online Delivery,88.24,0.00,1721139.63
3611,2021-06-12,2021-06-12,,Salary Credit,0.00,4147.31,1725286.94
3612,2021-06-12,2021-06-12,,Utility Payment,191.10,0.00,1725095.84
3613,2021-06-12,2021-06-12,,Credit Card Payment,406.98,0.00,1724688.86
3614,2021-06-12,2021-06-12,,Online Transfer,1945.49,0.00,1722743.37
3615,2021-06-13,2021-06-13,,Groceries - Online Delivery,129.68,0.00,1722613.69
3616,2021-06-12,2021-06-13,,Credit Card Payment,844.98,0.00,1721768.71
3617,2021-06-14,2021-06-13,,Groceries - Online Delivery,85.82,0.00,1721682.89
3618,2021-06-14,2021-06-14,,Transfer Received,0.00,1855.73,1723538.62
3619,2021-06-14,2021-06-14,,Transfer Received,0.00,2620.47,1726159.09
3620,2021-06-15,2021-06-14,,Online Transfer,1649.65,0.00,1724509.44
3621,2021-06-15,2021-06-15,,Transfer Received,0.00,737.96,1725247.40
3622,2021-06-14,2021-06-15,,ATM Withdrawal,38.15,0.00,1725209.25
3623,2021-06-15,2021-06-15,100084,Cheque Issued,1000.57,0.00,1724208.68
3624,2021-06-14,2021-06-15,,Dining Out,27.46,0.00,1724181.22
3625,2021-06-14,2021-06-15,,Utility Payment,52.98,0.00,1724128.24
3626,2021-06-15,2021-06-15,,Transfer Received,0.00,975.09,1725103.33
3627,2021-06-16,2021-06-16,,Utility Payment,179.27,0.00,1724924.06
3628,2021-06-15,2021-06-16,,ATM Withdrawal,106.57,0.00,1724817.49
3629,2021-06-17,2021-06-16,,Transfer Received,0.00,2363.37,1727180.86
3630,2021-06-15,2021-06-16,,Salary Credit,0.00,2277.06,1729457.92
3631,2021-06-16,2021-06-16,,ATM Withdrawal,148.82,0.00,1729309.10
3632,2021-06-17,2021-06-17,,ATM Withdrawal,408.11,0.00,1728900.99
3633,2021-06-16,2021-06-17,,ATM Withdrawal,495.57,0.00,1728405.42
3634,2021-06-17,2021-06-17,,Salary Credit,0.00,4442.33,1732847.75
3635,2021-06-19,2021-06-18,,Transfer Received,0.00,2268.24,1735115.99
3636,2021-06-18,2021-06-18,,Investment - Stocks,1783.05,0.00,1733332.94
3637,2021-06-19,2021-06-18,,Groceries - Supermarket,148.61,0.00,1733184.33
3638,2021-06-19,2021-06-18,,Investment Returns,0.00,124.72,1733309.05
3639,2021-06-19,2021-06-18,,Salary Credit,0.00,3314.61,1736623.66
3640,2021-06-18,2021-06-18,,Transfer Received,0.00,1016.96,1737640.62
3641,2021-06-18,2021-06-18,,Utility Payment,141.85,0.00,1737498.77
3642,2021-06-19,2021-06-18,,Groceries - Supermarket,53.29,0.00,1737445.48
3643,2021-06-18,2021-06-18,,Transfer Received,0.00,1338.08,1738783.56
3644,2021-06-18,2021-06-18,,Transfer Received,0.00,1325.27,1740108.83
3645,2021-06-18,2021-06-18,,Transfer Received,0.00,2288.87,1742397.70
3646,2021-06-19,2021-06-19,,Transfer Received,0.00,2142.43,1744540.13
3647,2021-06-19,2021-06-19,,Online Transfer,1714.38,0.00,1742825.75
3648,2021-06-20,2021-06-19,,ATM Withdrawal,76.61,0.00,1742749.14
3649,2021-06-19,2021-06-19,,Dividend Received,0.00,464.54,1743213.68
3650,2021-06-20,2021-06-20,,Salary Credit,0.00,3775.19,1746988.87
3651,2021-06-21,2021-06-20,,Salary Credit,0.00,2536.98,1749525.85
3652,2021-06-21,2021-06-20,,Interest Credited,0.00,49.55,1749575.40
3653,2021-06-20,2021-06-20,,Salary Credit,0.00,2368.10,1751943.50
3654,2021-06-20,2021-06-20,,Takeout,41.38,0.00,1751902.12
3655,2021-06-20,2021-06-20,,Online Transfer,688.20,0.00,1751213.92
3656,2021-06-20,2021-06-20,,Interest Credited,0.00,74.05,1751287.97
3657,2021-06-21,2021-06-21,,Online Transfer,431.88,0.00,1750856.09
3658,2021-06-21,2021-06-21,,Online Transfer,1207.89,0.00,1749648.20
3659,2021-06-20,2021-06-21,,Groceries - Supermarket,164.59,0.00,1749483.61
3660,2021-06-21,2021-06-21,,Utility Payment,153.20,0.00,1749330.41
3661,2021-06-22,2021-06-21,,Online Transfer,531.05,0.00,1748799.36
3662,2021-06-22,2021-06-21,,ATM Withdrawal,289.81,0.00,1748509.55
3663,2021-06-20,2021-06-21,,Groceries - Supermarket,82.78,0.00,1748426.77
3664,2021-06-21,2021-06-21,,Coffee Shop,17.77,0.00,1748409.00
3665,2021-06-21,2021-06-21,,Transfer Received,0.00,924.43,1749333.43
3666,2021-06-21,2021-06-21,,Dining Out,72.10,0.00,1749261.33
3667,2021-06-21,2021-06-21,,Online Transfer,230.26,0.00,1749031.07
3668,2021-06-21,2021-06-21,,Transfer Received,0.00,519.55,1749550.62
3669,2021-06-21,2021-06-21,,Online Transfer,273.72,0.00,1749276.90
3670,2021-06-22,2021-06-21,,Transfer Received,0.00,1713.18,1750990.08
3671,2021-06-21,2021-06-22,,ATM Withdrawal,123.90,0.00,1750866.18
3672,2021-06-22,2021-06-22,,Daily Essentials,45.56,0.00,1750820.62
3673,2021-06-22,2021-06-22,,Utility Payment,166.26,0.00,1750654.36
3674,2021-06-21,2021-06-22,,ATM Withdrawal,259.05,0.00,1750395.31
3675,2021-06-22,2021-06-22,,ATM Withdrawal,106.02,0.00,1750289.29
3676,2021-06-23,2021-06-22,,Online Transfer,1363.76,0.00,1748925.53
3677,2021-06-21,2021-06-22,,Dividend Received,0.00,170.67,1749096.20
3678,2021-06-23,2021-06-22,,Credit Card Payment,949.38,0.00,1748146.82
3679,2021-06-23,2021-06-22,,Dining Out,12.79,0.00,1748134.03
3680,2021-06-22,2021-06-23,,Salary Credit,0.00,2306.41,1750440.44
3681,2021-06-24,2021-06-23,,ATM Withdrawal,388.52,0.00,1750051.92
3682,2021-06-23,2021-06-23,,Rental Income,0.00,2628.32,1752680.24
3683,2021-06-24,2021-06-24,,Transfer Received,0.00,2087.62,1754767.86
3684,2021-06-24,2021-06-24,,Salary Credit,0.00,2178.13,1756945.99
3685,2021-06-25,2021-06-24,,Credit Card Payment,843.40,0.00,1756102.59
3686,2021-06-25,2021-06-24,,Salary Credit,0.00,3821.18,1759923.77
3687,2021-06-24,2021-06-24,,Transfer Received,0.00,2853.36,1762777.13
3688,2021-06-24,2021-06-24,,Loan EMI,1453.15,0.00,1761323.98
3689,2021-06-23,2021-06-24,,Credit Card Payment,880.99,0.00,1760442.99
3690,2021-06-25,2021-06-25,,Cash Deposit,0.00,644.71,1761087.70
3691,2021-06-25,2021-06-25,,ATM Withdrawal,57.62,0.00,1761030.08
3692,2021-06-25,2021-06-25,,Salary Credit,0.00,3400.56,1764430.64
3693,2021-06-25,2021-06-25,,Salary Credit,0.00,2288.35,1766718.99
3694,2021-06-25,2021-06-26,,Rental Income,0.00,1896.88,1768615.87
3695,2021-06-26,2021-06-26,,Groceries - Supermarket,172.60,0.00,1768443.27
3696,2021-06-26,2021-06-26,,Takeout,20.11,0.00,1768423.16
3697,2021-06-27,2021-06-26,,Transfer Received,0.00,1700.23,1770123.39
3698,2021-06-26,2021-06-26,,Salary Credit,0.00,4499.23,1774622.62
3699,2021-06-26,2021-06-26,,Loan EMI,753.45,0.00,1773869.17
3700,2021-06-28,2021-06-27,,Transfer Received,0.00,1690.26,1775559.43
3701,2021-06-26,2021-06-27,,Utility Payment,161.74,0.00,1775397.69
3702,2021-06-27,2021-06-27,,Online Transfer,1124.65,0.00,1774273.04
3703,2021-06-27,2021-06-27,,ATM Withdrawal,163.21,0.00,1774109.83
3704,2021-06-28,2021-06-27,,Groceries - Supermarket,155.80,0.00,1773954.03
3705,2021-06-27,2021-06-27,,Online Transfer,575.52,0.00,1773378.51
3706,2021-06-27,2021-06-27,,Interest Credited,0.00,40.92,1773419.43
3707,2021-06-27,2021-06-28,,Utility Payment,207.79,0.00,1773211.64
3708,2021-06-28,2021-06-28,,Online Transfer,984.72,0.00,1772226.92
3709,2021-06-28,2021-06-28,,Credit Card Payment,266.08,0.00,1771960.84
3710,2021-06-27,2021-06-28,,Investment - Mutual Funds,1977.65,0.00,1769983.19
3711,2021-06-27,2021-06-28,,Utility Payment,184.77,0.00,1769798.42
3712,2021-06-28,2021-06-28,,Dividend Received,0.00,422.75,1770221.17
3713,2021-06-28,2021-06-29,,Interest Credited,0.00,85.09,1770306.26
3714,2021-06-29,2021-06-29,,Utility Payment,152.06,0.00,1770154.20
3715,2021-06-29,2021-06-29,,Salary Credit,0.00,4351.88,1774506.08
3716,2021-06-29,2021-06-29,,Salary Credit,0.00,3773.21,1778279.29
3717,2021-06-30,2021-06-29,,Salary Credit,0.00,4371.94,1782651.23
3718,2021-06-29,2021-06-29,,Salary Credit,0.00,3676.26,1786327.49
3719,2021-06-29,2021-06-30,,Credit Card Payment,728.37,0.00,1785599.12
3720,2021-06-30,2021-06-30,,Transfer Received,0.00,1973.47,1787572.59
3721,2021-06-30,2021-06-30,,ATM Withdrawal,433.67,0.00,1787138.92
3722,2021-06-30,2021-06-30,,Salary Credit,0.00,4070.30,1791209.22
3723,2021-06-30,2021-06-30,,Utility Payment,282.79,0.00,1790926.43
3724,2021-06-30,2021-07-01,,Groceries - Online Delivery,81.45,0.00,1790844.98
3725,2021-06-30,2021-07-01,,Utility Payment,223.15,0.00,1790621.83
3726,2021-07-02,2021-07-01,,Interest Credited,0.00,13.09,1790634.92
3727,2021-07-01,2021-07-01,,Transfer Received,0.00,2567.24,1793202.16
3728,2021-07-01,2021-07-01,,Daily Essentials,47.23,0.00,1793154.93
3729,2021-07-02,2021-07-01,,Transfer Received,0.00,2624.46,1795779.39
3730,2021-07-01,2021-07-01,,ATM Withdrawal,193.80,0.00,1795585.59
3731,2021-07-02,2021-07-02,,Transfer Received,0.00,1450.70,1797036.29
3732,2021-07-02,2021-07-02,,ATM Withdrawal,407.65,0.00,1796628.64
3733,2021-07-02,2021-07-02,,Dividend Received,0.00,197.20,1796825.84
3734,2021-07-02,2021-07-02,,Salary Credit,0.00,4795.46,1801621.30
3735,2021-07-02,2021-07-02,,Salary Credit,0.00,4386.27,1806007.57
3736,2021-07-02,2021-07-02,,Dining Out,75.88,0.00,1805931.69
3737,2021-07-01,2021-07-02,,Investment Returns,0.00,187.77,1806119.46
3738,2021-07-02,2021-07-03,,Transfer Received,0.00,2527.62,1808647.08
3739,2021-07-03,2021-07-03,,Interest Credited,0.00,18.47,1808665.55
3740,2021-07-02,2021-07-03,,Transfer Received,0.00,565.02,1809230.57
3741,2021-07-04,2021-07-04,,ATM Withdrawal,252.87,0.00,1808977.70
3742,2021-07-03,2021-07-04,,Transfer Received,0.00,1054.61,1810032.31
3743,2021-07-03,2021-07-04,,Dining Out,13.22,0.00,1810019.09
3744,2021-07-05,2021-07-04,,Daily Essentials,27.36,0.00,1809991.73
3745,2021-07-04,2021-07-04,,Dining Out,37.15,0.00,1809954.58
3746,2021-07-04,2021-07-04,,ATM Withdrawal,481.21,0.00,1809473.37
3747,2021-07-04,2021-07-04,100085,Cheque Issued,2561.10,0.00,1806912.27
3748,2021-07-05,2021-07-04,,Transfer Received,0.00,1733.09,1808645.36
3749,2021-07-04,2021-07-04,,Transfer Received,0.00,1716.90,1810362.26
3750,2021-07-04,2021-07-04,,Groceries - Supermarket,119.54,0.00,1810242.72
3751,2021-07-05,2021-07-05,,Transfer Received,0.00,1989.18,1812231.90
3752,2021-07-06,2021-07-05,100086,Cheque Issued,2125.39,0.00,1810106.51
3753,2021-07-05,2021-07-05,,ATM Withdrawal,372.20,0.00,1809734.31
3754,2021-07-05,2021-07-05,,Online Transfer,448.87,0.00,1809285.44
3755,2021-07-06,2021-07-05,,Online Transfer,1783.44,0.00,1807502.00
3756,2021-07-05,2021-07-05,,Groceries - Supermarket,30.68,0.00,1807471.32
3757,2021-07-05,2021-07-05,,Groceries - Supermarket,126.81,0.00,1807344.51
3758,2021-07-07,2021-07-06,,Groceries - Online Delivery,101.81,0.00,1807242.70
3759,2021-07-06,2021-07-06,,Salary Credit,0.00,3321.97,1810564.67
3760,2021-07-05,2021-07-06,,Groceries - Supermarket,194.78,0.00,1810369.89
3761,2021-07-06,2021-07-06,,Salary Credit,0.00,3476.62,1813846.51
3762,2021-07-07,2021-07-06,,Transfer Received,0.00,572.58,1814419.09
3763,2021-07-06,2021-07-06,100087,Cheque Issued,2999.04,0.00,1811420.05
3764,2021-07-06,2021-07-06,,Online Transfer,1421.74,0.00,1809998.31
3765,2021-07-06,2021-07-06,,Transfer Received,0.00,2008.44,1812006.75
3766,2021-07-07,2021-07-07,,Utility Payment,189.75,0.00,1811817.00
3767,2021-07-07,2021-07-07,,Transfer Received,0.00,1894.02,1813711.02
3768,2021-07-07,2021-07-07,,Salary Credit,0.00,4043.96,1817754.98
3769,2021-07-07,2021-07-07,100088,Cheque Issued,2132.93,0.00,1815622.05
3770,2021-07-07,2021-07-07,,Credit Card Payment,334.31,0.00,1815287.74
3771,2021-07-07,2021-07-07,,Rental Income,0.00,1554.72,1816842.46
3772,2021-07-07,2021-07-07,,Transfer Received,0.00,1315.59,1818158.05
3773,2021-07-09,2021-07-08,,Utility Payment,121.81,0.00,1818036.24
3774,2021-07-08,2021-07-08,,Daily Essentials,6.97,0.00,1818029.27
3775,2021-07-07,2021-07-08,,Utility Payment,185.60,0.00,1817843.67
3776,2021-07-09,2021-07-09,,Online Transfer,1003.92,0.00,1816839.75
3777,2021-07-09,2021-07-09,100089,Cheque Issued,1418.90,0.00,1815420.85
3778,2021-07-08,2021-07-09,,Groceries - Supermarket,106.66,0.00,1815314.19
3779,2021-07-08,2021-07-09,,Groceries - Supermarket,192.74,0.00,1815121.45
3780,2021-07-09,2021-07-09,,Salary Credit,0.00,3466.46,1818587.91
3781,2021-07-09,2021-07-09,,Investment - Mutual Funds,257.65,0.00,1818330.26
3782,2021-07-09,2021-07-09,,Transfer Received,0.00,1185.65,1819515.91
3783,2021-07-08,2021-07-09,,Groceries - Supermarket,197.75,0.00,1819318.16
3784,2021-07-11,2021-07-10,,Transfer Received,0.00,2816.79,1822134.95
3785,2021-07-11,2021-07-10,,Loan EMI,1769.83,0.00,1820365.12
3786,2021-07-10,2021-07-10,,Transfer Received,0.00,2327.04,1822692.16
3787,2021-07-12,2021-07-11,,Transfer Received,0.00,665.28,1823357.44
3788,2021-07-11,2021-07-11,,Utility Payment,97.01,0.00,1823260.43
3789,2021-07-11,2021-07-11,,Salary Credit,0.00,2732.04,1825992.47
3790,2021-07-12,2021-07-11,,Investment - SIP,707.90,0.00,1825284.57
3791,2021-07-12,2021-07-11,,Credit Card Payment,546.91,0.00,1824737.66
3792,2021-07-11,2021-07-11,,Interest Credited,0.00,59.75,1824797.41
3793,2021-07-11,2021-07-11,,Salary Credit,0.00,4830.35,1829627.76
3794,2021-07-11,2021-07-11,,Salary Credit,0.00,4945.13,1834572.89
3795,2021-07-11,2021-07-11,,Online Transfer,1795.50,0.00,1832777.39
3796,2021-07-13,2021-07-12,,Groceries - Online Delivery,131.35,0.00,1832646.04
3797,2021-07-13,2021-07-12,,ATM Withdrawal,222.66,0.00,1832423.38
3798,2021-07-12,2021-07-12,,ATM Withdrawal,300.37,0.00,1832123.01
3799,2021-07-12,2021-07-12,,Online Transfer,1256.23,0.00,1830866.78
3800,2021-07-12,2021-07-12,,Interest Credited,0.00,10.61,1830877.39
3801,2021-07-11,2021-07-12,,Groceries - Supermarket,148.87,0.00,1830728.52
3802,2021-07-12,2021-07-12,,Online Transfer,1066.12,0.00,1829662.40
3803,2021-07-11,2021-07-12,,Investment Returns,0.00,918.03,1830580.43
3804,2021-07-11,2021-07-12,,Online Transfer,1076.35,0.00,1829504.08
3805,2021-07-12,2021-07-12,,Interest Credited,0.00,25.91,1829529.99
3806,2021-07-14,2021-07-13,,Salary Credit,0.00,3687.79,1833217.78
3807,2021-07-12,2021-07-13,,Groceries - Online Delivery,132.23,0.00,1833085.55
3808,2021-07-13,2021-07-13,,Cash Deposit,0.00,468.12,1833553.67
3809,2021-07-12,2021-07-13,,Transfer Received,0.00,1616.54,1835170.21
3810,2021-07-13,2021-07-13,,Credit Card Payment,616.09,0.00,1834554.12
3811,2021-07-14,2021-07-13,,Loan EMI,1678.40,0.00,1832875.72
3812,2021-07-13,2021-07-14,,Salary Credit,0.00,3994.79,1836870.51
3813,2021-07-15,2021-07-14,,Utility Payment,247.51,0.00,1836623.00
3814,2021-07-15,2021-07-14,,Transfer Received,0.00,1621.13,1838244.13
3815,2021-07-14,2021-07-14,,Utility Payment,225.79,0.00,1838018.34
3816,2021-07-14,2021-07-14,,Rental Income,0.00,2026.68,1840045.02
3817,2021-07-14,2021-07-14,,Transfer Received,0.00,1532.85,1841577.87
3818,2021-07-15,2021-07-15,,Rental Income,0.00,2465.29,1844043.16
3819,2021-07-15,2021-07-15,,ATM Withdrawal,259.15,0.00,1843784.01
3820,2021-07-16,2021-07-16,,Coffee Shop,19.85,0.00,1843764.16
3821,2021-07-16,2021-07-16,,Transfer Received,0.00,1718.78,1845482.94
3822,2021-07-15,2021-07-16,,ATM Withdrawal,459.13,0.00,1845023.81
3823,2021-07-16,2021-07-16,,Transfer Received,0.00,1041.53,1846065.34
3824,2021-07-17,2021-07-16,,Transfer Received,0.00,1349.87,1847415.21
3825,2021-07-16,2021-07-16,,Transfer Received,0.00,1521.64,1848936.85
3826,2021-07-17,2021-07-16,,ATM Withdrawal,53.19,0.00,1848883.66
3827,2021-07-16,2021-07-16,,Interest Credited,0.00,15.32,1848898.98
3828,2021-07-16,2021-07-16,,Groceries - Online Delivery,64.58,0.00,1848834.40
3829,2021-07-17,2021-07-17,,ATM Withdrawal,77.40,0.00,1848757.00
3830,2021-07-16,2021-07-17,,ATM Withdrawal,409.20,0.00,1848347.80
3831,2021-07-17,2021-07-17,,ATM Withdrawal,319.66,0.00,1848028.14
3832,2021-07-17,2021-07-17,,Groceries - Online Delivery,99.29,0.00,1847928.85
3833,2021-07-17,2021-07-17,,Utility Payment,113.10,0.00,1847815.75
3834,2021-07-17,2021-07-17,,Groceries - Supermarket,189.90,0.00,1847625.85
3835,2021-07-16,2021-07-17,,ATM Withdrawal,452.84,0.00,1847173.01
3836,2021-07-16,2021-07-17,,Investment - Mutual Funds,2951.02,0.00,1844221.99
3837,2021-07-18,2021-07-18,,Dividend Received,0.00,437.11,1844659.10
3838,2021-07-18,2021-07-18,100090,Cheque Issued,863.13,0.00,1843795.97
3839,2021-07-18,2021-07-18,,Salary Credit,0.00,3741.63,1847537.60
3840,2021-07-18,2021-07-18,,Investment - SIP,889.36,0.00,1846648.24
3841,2021-07-17,2021-07-18,,Investment - SIP,510.05,0.00,1846138.19
3842,2021-07-17,2021-07-18,,Loan EMI,1204.01,0.00,1844934.18
3843,2021-07-18,2021-07-18,,Online Transfer,846.40,0.00,1844087.78
3844,2021-07-17,2021-07-18,,Credit Card Payment,301.02,0.00,1843786.76
3845,2021-07-20,2021-07-19,,Salary Credit,0.00,4166.75,1847953.51
3846,2021-07-19,2021-07-19,,Dining Out,48.87,0.00,1847904.64
3847,2021-07-20,2021-07-19,,Interest Credited,0.00,68.61,1847973.25
3848,2021-07-19,2021-07-20,,Salary Credit,0.00,3231.18,1851204.43
3849,2021-07-20,2021-07-20,,Groceries - Supermarket,158.28,0.00,1851046.15
3850,2021-07-20,2021-07-20,,Salary Credit,0.00,2934.24,1853980.39
3851,2021-07-20,2021-07-20,,Loan EMI,590.69,0.00,1853389.70
3852,2021-07-20,2021-07-20,,Credit Card Payment,557.16,0.00,1852832.54
3853,2021-07-20,2021-07-21,,Groceries - Supermarket,181.77,0.00,1852650.77
3854,2021-07-21,2021-07-21,,Transfer Received,0.00,1225.80,1853876.57
3855,2021-07-21,2021-07-21,,Salary Credit,0.00,4481.05,1858357.62
3856,2021-07-21,2021-07-21,,Online Transfer,896.61,0.00,1857461.01
3857,2021-07-21,2021-07-21,,ATM Withdrawal,409.51,0.00,1857051.50
3858,2021-07-21,2021-07-21,,Transfer Received,0.00,1865.80,1858917.30
3859,2021-07-20,2021-07-21,,Investment Returns,0.00,830.25,1859747.55
3860,2021-07-22,2021-07-21,,Salary Credit,0.00,2386.77,1862134.32
3861,2021-07-22,2021-07-22,,Online Transfer,841.92,0.00,1861292.40
3862,2021-07-22,2021-07-22,,Online Transfer,200.91,0.00,1861091.49
3863,2021-07-22,2021-07-22,,Groceries - Supermarket,165.54,0.00,1860925.95
3864,2021-07-22,2021-07-22,,Investment - Mutual Funds,2422.63,0.00,1858503.32
3865,2021-07-23,2021-07-23,,Investment - SIP,151.02,0.00,1858352.30
3866,2021-07-22,2021-07-23,,Credit Card Payment,297.24,0.00,1858055.06
3867,2021-07-23,2021-07-23,,Salary Credit,0.00,4125.06,1862180.12
3868,2021-07-24,2021-07-23,,Transfer Received,0.00,1875.54,1864055.66
3869,2021-07-23,2021-07-23,,ATM Withdrawal,390.05,0.00,1863665.61
3870,2021-07-23,2021-07-23,,Salary Credit,0.00,4527.08,1868192.69
3871,2021-07-23,2021-07-23,,Investment - Mutual Funds,1154.91,0.00,1867037.78
3872,2021-07-23,2021-07-23,,Transfer Received,0.00,2352.12,1869389.90
3873,2021-07-24,2021-07-24,,Dividend Received,0.00,350.16,1869740.06
3874,2021-07-24,2021-07-24,,Loan EMI,651.27,0.00,1869088.79
3875,2021-07-24,2021-07-24,,Credit Card Payment,862.90,0.00,1868225.89
3876,2021-07-25,2021-07-24,,Groceries - Online Delivery,102.05,0.00,1868123.84
3877,2021-07-24,2021-07-24,,Utility Payment,293.27,0.00,1867830.57
3878,2021-07-25,2021-07-25,,Dining Out,27.91,0.00,1867802.66
3879,2021-07-26,2021-07-25,,ATM Withdrawal,72.40,0.00,1867730.26
3880,2021-07-25,2021-07-25,,Credit Card Payment,846.57,0.00,1866883.69
3881,2021-07-26,2021-07-25,,Rental Income,0.00,2483.09,1869366.78
3882,2021-07-25,2021-07-25,,Takeout,24.26,0.00,1869342.52
3883,2021-07-25,2021-07-25,,Online Transfer,106.03,0.00,1869236.49
3884,2021-07-25,2021-07-25,,Dining Out,59.12,0.00,1869177.37
3885,2021-07-24,2021-07-25,,Dividend Received,0.00,349.58,1869526.95
3886,2021-07-26,2021-07-25,,Investment - Mutual Funds,1911.37,0.00,1867615.58
3887,2021-07-25,2021-07-25,,Dining Out,47.89,0.00,1867567.69
3888,2021-07-26,2021-07-26,,ATM Withdrawal,316.74,0.00,1867250.95
3889,2021-07-26,2021-07-26,,Utility Payment,50.62,0.00,1867200.33
3890,2021-07-25,2021-07-26,,Investment - Stocks,3071.28,0.00,1864129.05
3891,2021-07-25,2021-07-26,,Rental Income,0.00,2802.55,1866931.60
3892,2021-07-26,2021-07-26,,Groceries - Online Delivery,100.19,0.00,1866831.41
3893,2021-07-26,2021-07-26,,Online Transfer,1238.20,0.00,1865593.21
3894,2021-07-26,2021-07-26,,Coffee Shop,15.97,0.00,1865577.24
3895,2021-07-27,2021-07-26,,Investment - Stocks,3477.89,0.00,1862099.35
3896,2021-07-28,2021-07-27,,Coffee Shop,18.33,0.00,1862081.02
3897,2021-07-27,2021-07-27,,Groceries - Online Delivery,58.03,0.00,1862022.99
3898,2021-07-28,2021-07-27,,Online Transfer,1397.78,0.00,1860625.21
3899,2021-07-27,2021-07-27,,ATM Withdrawal,414.99,0.00,1860210.22
3900,2021-07-27,2021-07-27,,Transfer Received,0.00,1678.05,1861888.27
3901,2021-07-28,2021-07-28,,ATM Withdrawal,367.55,0.00,1861520.72
3902,2021-07-28,2021-07-28,,Cash Deposit,0.00,203.50,1861724.22
3903,2021-07-29,2021-07-28,,Groceries - Supermarket,168.00,0.00,1861556.22
3904,2021-07-28,2021-07-28,,Interest Credited,0.00,69.06,1861625.28
3905,2021-07-29,2021-07-28,,Groceries - Online Delivery,140.76,0.00,1861484.52
3906,2021-07-28,2021-07-28,,Loan EMI,583.46,0.00,1860901.06
3907,2021-07-29,2021-07-29,,Online Transfer,1574.47,0.00,1859326.59
3908,2021-07-30,2021-07-29,,ATM Withdrawal,152.55,0.00,1859174.04
3909,2021-07-30,2021-07-29,,Online Transfer,1279.54,0.00,1857894.50
3910,2021-07-29,2021-07-29,,Cash Deposit,0.00,709.83,1858604.33
3911,2021-07-28,2021-07-29,,ATM Withdrawal,248.38,0.00,1858355.95
3912,2021-07-29,2021-07-29,,Salary Credit,0.00,3382.61,1861738.56
3913,2021-07-28,2021-07-29,,Investment Returns,0.00,136.01,1861874.57
3914,2021-07-30,2021-07-30,,Salary Credit,0.00,3869.70,1865744.27
3915,2021-07-30,2021-07-30,,ATM Withdrawal,71.40,0.00,1865672.87
3916,2021-07-30,2021-07-30,,Dining Out,46.23,0.00,1865626.64
3917,2021-07-30,2021-07-30,,Transfer Received,0.00,1890.02,1867516.66
3918,2021-07-30,2021-07-30,,ATM Withdrawal,96.90,0.00,1867419.76
3919,2021-07-30,2021-07-30,,Groceries - Supermarket,120.38,0.00,1867299.38
3920,2021-07-30,2021-07-30,,Groceries - Supermarket,139.27,0.00,1867160.11
3921,2021-07-30,2021-07-30,,Investment Returns,0.00,156.55,1867316.66
3922,2021-07-31,2021-07-30,,Interest Credited,0.00,81.30,1867397.96
3923,2021-08-01,2021-07-31,,Transfer Received,0.00,2203.06,1869601.02
3924,2021-08-01,2021-07-31,,Online Transfer,1047.70,0.00,1868553.32
3925,2021-07-31,2021-07-31,,Online Transfer,1560.43,0.00,1866992.89
3926,2021-07-31,2021-07-31,,Online Transfer,1784.70,0.00,1865208.19
3927,2021-07-31,2021-07-31,,ATM Withdrawal,359.24,0.00,1864848.95
3928,2021-08-01,2021-07-31,,Dining Out,85.40,0.00,1864763.55
3929,2021-08-01,2021-08-01,,ATM Withdrawal,68.63,0.00,1864694.92
3930,2021-08-01,2021-08-01,,Interest Credited,0.00,18.05,1864712.97
3931,2021-08-02,2021-08-01,,Dining Out,86.23,0.00,1864626.74
3932,2021-08-01,2021-08-01,,ATM Withdrawal,328.44,0.00,1864298.30
3933,2021-08-01,2021-08-01,,Credit Card Payment,993.92,0.00,1863304.38
3934,2021-08-01,2021-08-01,,Transfer Received,0.00,1861.19,1865165.57
3935,2021-08-01,2021-08-01,,Credit Card Payment,764.79,0.00,1864400.78
3936,2021-08-01,2021-08-01,,Transfer Received,0.00,529.69,1864930.47
3937,2021-08-02,2021-08-02,,ATM Withdrawal,388.24,0.00,1864542.23
3938,2021-08-01,2021-08-02,,Dividend Received,0.00,59.57,1864601.80
3939,2021-08-02,2021-08-02,,Online Transfer,1482.25,0.00,1863119.55
3940,2021-08-02,2021-08-02,,Utility Payment,124.54,0.00,1862995.01
3941,2021-08-04,2021-08-03,,Online Transfer,1919.87,0.00,1861075.14
3942,2021-08-03,2021-08-03,,Cash Deposit,0.00,217.64,1861292.78
3943,2021-08-03,2021-08-03,,Salary Credit,0.00,4190.51,1865483.29
3944,2021-08-03,2021-08-03,,Credit Card Payment,730.58,0.00,1864752.71
3945,2021-08-03,2021-08-03,,Utility Payment,114.53,0.00,1864638.18
3946,2021-08-03,2021-08-03,,ATM Withdrawal,220.21,0.00,1864417.97
3947,2021-08-02,2021-08-03,,Groceries - Supermarket,154.85,0.00,1864263.12
3948,2021-08-03,2021-08-03,,Transfer Received,0.00,1866.84,1866129.96
3949,2021-08-03,2021-08-03,,Transfer Received,0.00,2283.78,1868413.74
3950,2021-08-03,2021-08-03,,ATM Withdrawal,482.77,0.00,1867930.97
3951,2021-08-04,2021-08-04,,Interest Credited,0.00,58.71,1867989.68
3952,2021-08-04,2021-08-04,,Groceries - Supermarket,110.59,0.00,1867879.09
3953,2021-08-03,2021-08-04,,Interest Credited,0.00,32.31,1867911.40
3954,2021-08-04,2021-08-04,,Salary Credit,0.00,2725.54,1870636.94
3955,2021-08-04,2021-08-04,100091,Cheque Issued,1494.34,0.00,1869142.60
3956,2021-08-05,2021-08-05,,Online Transfer,1491.80,0.00,1867650.80
3957,2021-08-04,2021-08-05,,Daily Essentials,21.30,0.00,1867629.50
3958,2021-08-04,2021-08-05,,Rental Income,0.00,1313.56,1868943.06
3959,2021-08-05,2021-08-05,,Groceries - Online Delivery,119.78,0.00,1868823.28
3960,2021-08-05,2021-08-05,,Groceries - Supermarket,141.11,0.00,1868682.17
3961,2021-08-06,2021-08-06,,ATM Withdrawal,291.49,0.00,1868390.68
3962,2021-08-06,2021-08-06,,Transfer Received,0.00,1532.53,1869923.21
3963,2021-08-05,2021-08-06,,Credit Card Payment,376.26,0.00,1869546.95
3964,2021-08-06,2021-08-06,,Transfer Received,0.00,1945.90,1871492.85
3965,2021-08-07,2021-08-06,,Salary Credit,0.00,4279.40,1875772.25
3966,2021-08-06,2021-08-06,,ATM Withdrawal,478.11,0.00,1875294.14
3967,2021-08-07,2021-08-07,,Online Transfer,1760.85,0.00,1873533.29
3968,2021-08-07,2021-08-07,,Utility Payment,68.58,0.00,1873464.71
3969,2021-08-06,2021-08-07,,Cash Deposit,0.00,766.63,1874231.34
3970,2021-08-07,2021-08-07,,Rental Income,0.00,2112.20,1876343.54
3971,2021-08-08,2021-08-07,,Dining Out,93.20,0.00,1876250.34
3972,2021-08-08,2021-08-08,,Transfer Received,0.00,2348.66,1878599.00
3973,2021-08-09,2021-08-08,,Salary Credit,0.00,3912.70,1882511.70
3974,2021-08-07,2021-08-08,,Transfer Received,0.00,2331.87,1884843.57
3975,2021-08-08,2021-08-08,,Salary Credit,0.00,3029.57,1887873.14
3976,2021-08-09,2021-08-09,,Utility Payment,184.52,0.00,1887688.62
3977,2021-08-08,2021-08-09,,Transfer Received,0.00,2867.40,1890556.02
3978,2021-08-09,2021-08-09,,Groceries - Supermarket,168.40,0.00,1890387.62
3979,2021-08-09,2021-08-09,,Online Transfer,1537.36,0.00,1888850.26
3980,2021-08-10,2021-08-09,,Dividend Received,0.00,378.96,1889229.22
3981,2021-08-09,2021-08-09,,Utility Payment,275.14,0.00,1888954.08
3982,2021-08-09,2021-08-09,,Investment - SIP,817.60,0.00,1888136.48
3983,2021-08-09,2021-08-09,,Utility Payment,295.12,0.00,1887841.36
3984,2021-08-09,2021-08-09,,ATM Withdrawal,348.75,0.00,1887492.61
3985,2021-08-08,2021-08-09,,Loan EMI,578.04,0.00,1886914.57
3986,2021-08-09,2021-08-09,,Groceries - Online Delivery,103.84,0.00,1886810.73
3987,2021-08-09,2021-08-09,,Salary Credit,0.00,3259.28,1890070.01
3988,2021-08-10,2021-08-10,,Online Transfer,813.52,0.00,1889256.49
3989,2021-08-10,2021-08-10,,Salary Credit,0.00,3698.07,1892954.56
3990,2021-08-10,2021-08-10,,Interest Credited,0.00,83.60,1893038.16
3991,2021-08-10,2021-08-10,,Investment Returns,0.00,755.13,1893793.29
3992,2021-08-10,2021-08-10,,Investment - Mutual Funds,2597.23,0.00,1891196.06
3993,2021-08-10,2021-08-10,,Salary Credit,0.00,2407.82,1893603.88
3994,2021-08-10,2021-08-10,,Salary Credit,0.00,4885.36,1898489.24
3995,2021-08-11,2021-08-10,,ATM Withdrawal,292.16,0.00,1898197.08
3996,2021-08-10,2021-08-10,,ATM Withdrawal,49.00,0.00,1898148.08
3997,2021-08-10,2021-08-10,,Loan EMI,1621.52,0.00,1896526.56
3998,2021-08-09,2021-08-10,,Transfer Received,0.00,2166.75,1898693.31
3999,2021-08-10,2021-08-10,,Loan EMI,1909.70,0.00,1896783.61
4000,2021-08-10,2021-08-11,,Investment - Mutual Funds,355.42,0.00,1896428.19
4001,2021-08-11,2021-08-11,,Groceries - Online Delivery,147.31,0.00,1896280.88
4002,2021-08-11,2021-08-11,,ATM Withdrawal,429.18,0.00,1895851.70
4003,2021-08-11,2021-08-11,,Groceries - Supermarket,198.28,0.00,1895653.42
4004,2021-08-11,2021-08-11,,ATM Withdrawal,63.89,0.00,1895589.53
4005,2021-08-11,2021-08-11,,Investment - Mutual Funds,1175.81,0.00,1894413.72
4006,2021-08-12,2021-08-12,,Cash Deposit,0.00,232.92,1894646.64
4007,2021-08-12,2021-08-12,,Utility Payment,248.77,0.00,1894397.87
4008,2021-08-12,2021-08-12,,Online Transfer,1019.93,0.00,1893377.94
4009,2021-08-12,2021-08-12,,ATM Withdrawal,295.13,0.00,1893082.81
4010,2021-08-12,2021-08-12,,Salary Credit,0.00,3999.55,1897082.36
4011,2021-08-12,2021-08-12,,Coffee Shop,12.44,0.00,1897069.92
4012,2021-08-12,2021-08-12,,Dividend Received,0.00,218.34,1897288.26
4013,2021-08-12,2021-08-12,,ATM Withdrawal,241.71,0.00,1897046.55
4014,2021-08-12,2021-08-12,,Groceries - Supermarket,108.59,0.00,1896937.96
4015,2021-08-13,2021-08-13,100092,Cheque Issued,714.33,0.00,1896223.63
4016,2021-08-12,2021-08-13,,Interest Credited,0.00,19.43,1896243.06
4017,2021-08-14,2021-08-13,,Utility Payment,112.88,0.00,1896130.18
4018,2021-08-14,2021-08-13,,Daily Essentials,29.34,0.00,1896100.84
4019,2021-08-13,2021-08-13,,Coffee Shop,9.20,0.00,1896091.64
4020,2021-08-13,2021-08-13,,ATM Withdrawal,378.50,0.00,1895713.14
4021,2021-08-13,2021-08-13,,Salary Credit,0.00,2258.98,1897972.12
4022,2021-08-13,2021-08-13,,Groceries - Online Delivery,100.13,0.00,1897871.99
4023,2021-08-12,2021-08-13,,Transfer Received,0.00,1384.07,1899256.06
4024,2021-08-13,2021-08-13,,Groceries - Supermarket,113.11,0.00,1899142.95
4025,2021-08-13,2021-08-13,,Credit Card Payment,431.01,0.00,1898711.94
4026,2021-08-14,2021-08-14,,Online Transfer,889.87,0.00,1897822.07
4027,2021-08-14,2021-08-14,,Credit Card Payment,777.80,0.00,1897044.27
4028,2021-08-14,2021-08-14,,Dividend Received,0.00,352.40,1897396.67
4029,2021-08-14,2021-08-14,,Utility Payment,179.23,0.00,1897217.44
4030,2021-08-14,2021-08-14,,ATM Withdrawal,183.26,0.00,1897034.18
4031,2021-08-14,2021-08-14,,Transfer Received,0.00,2322.17,1899356.35
4032,2021-08-13,2021-08-14,,Utility Payment,241.74,0.00,1899114.61
4033,2021-08-14,2021-08-14,,Rental Income,0.00,2888.30,1902002.91
4034,2021-08-16,2021-08-15,,Online Transfer,1038.92,0.00,1900963.99
4035,2021-08-15,2021-08-15,,Investment - Stocks,3728.45,0.00,1897235.54
4036,2021-08-15,2021-08-15,,Transfer Received,0.00,1334.32,1898569.86
4037,2021-08-14,2021-08-15,,Loan EMI,1368.42,0.00,1897201.44
4038,2021-08-15,2021-08-15,,Salary Credit,0.00,2244.00,1899445.44
4039,2021-08-15,2021-08-15,,ATM Withdrawal,247.90,0.00,1899197.54
4040,2021-08-14,2021-08-15,,Utility Payment,153.53,0.00,1899044.01
4041,2021-08-16,2021-08-16,,Utility Payment,172.42,0.00,1898871.59
4042,2021-08-16,2021-08-16,,Investment - Mutual Funds,1655.67,0.00,1897215.92
4043,2021-08-16,2021-08-16,,Transfer Received,0.00,1385.16,1898601.08
4044,2021-08-16,2021-08-16,,Cash Deposit,0.00,393.84,1898994.92
4045,2021-08-16,2021-08-16,,Coffee Shop,5.36,0.00,1898989.56
4046,2021-08-17,2021-08-16,,Transfer Received,0.00,2769.93,1901759.49
4047,2021-08-17,2021-08-16,,Daily Essentials,18.31,0.00,1901741.18
4048,2021-08-15,2021-08-16,,Utility Payment,280.01,0.00,1901461.17
4049,2021-08-17,2021-08-16,,Salary Credit,0.00,2007.83,1903469.00
4050,2021-08-17,2021-08-16,,Salary Credit,0.00,3082.61,1906551.61
4051,2021-08-16,2021-08-16,,Transfer Received,0.00,1191.15,1907742.76
4052,2021-08-15,2021-08-16,,Takeout,11.78,0.00,1907730.98
4053,2021-08-16,2021-08-16,,Salary Credit,0.00,2665.55,1910396.53
4054,2021-08-17,2021-08-17,,Groceries - Supermarket,114.52,0.00,1910282.01
4055,2021-08-17,2021-08-17,,Salary Credit,0.00,3295.43,1913577.44
4056,2021-08-17,2021-08-17,,Groceries - Supermarket,146.34,0.00,1913431.10
4057,2021-08-18,2021-08-17,,Rental Income,0.00,1996.31,1915427.41
4058,2021-08-17,2021-08-17,,Salary Credit,0.00,4201.65,1919629.06
4059,2021-08-17,2021-08-17,,Salary Credit,0.00,3838.36,1923467.42
4060,2021-08-18,2021-08-18,,Groceries - Online Delivery,120.28,0.00,1923347.14
4061,2021-08-18,2021-08-18,,Coffee Shop,18.26,0.00,1923328.88
4062,2021-08-18,2021-08-18,100093,Cheque Issued,2660.68,0.00,1920668.20
4063,2021-08-19,2021-08-18,,Transfer Received,0.00,829.39,1921497.59
4064,2021-08-18,2021-08-18,,Online Transfer,1748.58,0.00,1919749.01
4065,2021-08-18,2021-08-18,,Groceries - Supermarket,163.51,0.00,1919585.50
4066,2021-08-18,2021-08-18,,ATM Withdrawal,84.95,0.00,1919500.55
4067,2021-08-17,2021-08-18,,Transfer Received,0.00,2694.44,1922194.99
4068,2021-08-19,2021-08-19,,Salary Credit,0.00,4067.31,1926262.30
4069,2021-08-18,2021-08-19,,Online Transfer,365.83,0.00,1925896.47
4070,2021-08-19,2021-08-19,,Utility Payment,205.82,0.00,1925690.65
4071,2021-08-20,2021-08-19,,Utility Payment,269.21,0.00,1925421.44
4072,2021-08-19,2021-08-19,,Investment - Mutual Funds,2046.60,0.00,1923374.84
4073,2021-08-18,2021-08-19,,Loan EMI,1336.43,0.00,1922038.41
4074,2021-08-21,2021-08-20,,Investment - Stocks,3904.09,0.00,1918134.32
4075,2021-08-20,2021-08-20,,ATM Withdrawal,190.00,0.00,1917944.32
4076,2021-08-20,2021-08-20,,Transfer Received,0.00,1156.17,1919100.49
4077,2021-08-20,2021-08-20,,ATM Withdrawal,319.10,0.00,1918781.39
4078,2021-08-21,2021-08-20,,Online Transfer,296.86,0.00,1918484.53
4079,2021-08-20,2021-08-20,,ATM Withdrawal,98.13,0.00,1918386.40
4080,2021-08-20,2021-08-20,,Transfer Received,0.00,988.14,1919374.54
4081,2021-08-19,2021-08-20,,ATM Withdrawal,220.05,0.00,1919154.49
4082,2021-08-21,2021-08-20,,Groceries - Supermarket,94.42,0.00,1919060.07
4083,2021-08-20,2021-08-20,,Salary Credit,0.00,3389.13,1922449.20
4084,2021-08-20,2021-08-20,,ATM Withdrawal,438.06,0.00,1922011.14
4085,2021-08-21,2021-08-20,,Transfer Received,0.00,2862.64,1924873.78
4086,2021-08-20,2021-08-21,,Salary Credit,0.00,3964.16,1928837.94
4087,2021-08-21,2021-08-21,,ATM Withdrawal,160.28,0.00,1928677.66
4088,2021-08-21,2021-08-21,,Groceries - Supermarket,37.54,0.00,1928640.12
4089,2021-08-22,2021-08-21,,Groceries - Online Delivery,92.88,0.00,1928547.24
4090,2021-08-21,2021-08-21,,Groceries - Supermarket,194.28,0.00,1928352.96
4091,2021-08-21,2021-08-21,,Groceries - Online Delivery,95.12,0.00,1928257.84
4092,2021-08-21,2021-08-21,,Salary Credit,0.00,4845.73,1933103.57
4093,2021-08-22,2021-08-21,,Online Transfer,1529.30,0.00,1931574.27
4094,2021-08-20,2021-08-21,,Interest Credited,0.00,36.58,1931610.85
4095,2021-08-22,2021-08-22,,Investment - SIP,745.56,0.00,1930865.29
4096,2021-08-22,2021-08-22,,Transfer Received,0.00,1697.46,1932562.75
4097,2021-08-22,2021-08-22,,Transfer Received,0.00,760.52,1933323.27
4098,2021-08-23,2021-08-22,,Transfer Received,0.00,1531.78,1934855.05
4099,2021-08-22,2021-08-22,,Takeout,23.31,0.00,1934831.74
4100,2021-08-21,2021-08-22,,Loan EMI,1214.06,0.00,1933617.68
4101,2021-08-21,2021-08-22,,Cash Deposit,0.00,281.78,1933899.46
4102,2021-08-22,2021-08-22,,ATM Withdrawal,163.08,0.00,1933736.38
4103,2021-08-22,2021-08-23,,Groceries - Supermarket,103.92,0.00,1933632.46
4104,2021-08-22,2021-08-23,,Salary Credit,0.00,3578.44,1937210.90
4105,2021-08-23,2021-08-23,,Salary Credit,0.00,3638.47,1940849.37
4106,2021-08-23,2021-08-23,,Interest Credited,0.00,61.46,1940910.83
4107,2021-08-23,2021-08-23,,ATM Withdrawal,439.22,0.00,1940471.61
4108,2021-08-24,2021-08-23,,ATM Withdrawal,68.58,0.00,1940403.03
4109,2021-08-24,2021-08-23,,Salary Credit,0.00,3134.66,1943537.69
4110,2021-08-23,2021-08-23,,Groceries - Supermarket,51.10,0.00,1943486.59
4111,2021-08-24,2021-08-23,,Transfer Received,0.00,2962.83,1946449.42
4112,2021-08-24,2021-08-24,,Credit Card Payment,961.39,0.00,1945488.03
4113,2021-08-24,2021-08-24,,Groceries - Supermarket,43.60,0.00,1945444.43
4114,2021-08-24,2021-08-24,,Transfer Received,0.00,2086.84,1947531.27
4115,2021-08-24,2021-08-24,,Loan EMI,734.29,0.00,1946796.98
4116,2021-08-23,2021-08-24,,ATM Withdrawal,132.47,0.00,1946664.51
4117,2021-08-24,2021-08-24,,Groceries - Online Delivery,67.49,0.00,1946597.02
4118,2021-08-25,2021-08-25,,Transfer Received,0.00,2227.94,1948824.96
4119,2021-08-25,2021-08-25,,Interest Credited,0.00,77.94,1948902.90
4120,2021-08-26,2021-08-25,,Groceries - Supermarket,100.44,0.00,1948802.46
4121,2021-08-25,2021-08-25,,Investment Returns,0.00,485.12,1949287.58
4122,2021-08-25,2021-08-25,,Salary Credit,0.00,2309.68,1951597.26
4123,2021-08-27,2021-08-26,,Groceries - Supermarket,100.48,0.00,1951496.78
4124,2021-08-26,2021-08-26,,Online Transfer,1368.50,0.00,1950128.28
4125,2021-08-25,2021-08-26,,Groceries - Supermarket,189.05,0.00,1949939.23
4126,2021-08-26,2021-08-26,,Dividend Received,0.00,456.87,1950396.10
4127,2021-08-27,2021-08-26,,ATM Withdrawal,314.68,0.00,1950081.42
4128,2021-08-26,2021-08-26,,ATM Withdrawal,120.01,0.00,1949961.41
4129,2021-08-27,2021-08-27,,Groceries - Supermarket,120.38,0.00,1949841.03
4130,2021-08-28,2021-08-27,,Credit Card Payment,777.58,0.00,1949063.45
4131,2021-08-27,2021-08-27,,Transfer Received,0.00,2320.24,1951383.69
4132,2021-08-28,2021-08-27,,Groceries - Online Delivery,82.84,0.00,1951300.85
4133,2021-08-27,2021-08-27,,Utility Payment,293.39,0.00,1951007.46
4134,2021-08-27,2021-08-28,,Transfer Received,0.00,598.53,1951605.99
4135,2021-08-28,2021-08-28,,ATM Withdrawal,336.71,0.00,1951269.28
4136,2021-08-28,2021-08-28,,Online Transfer,1334.78,0.00,1949934.50
4137,2021-08-28,2021-08-28,,Interest Credited,0.00,10.54,1949945.04
4138,2021-08-28,2021-08-28,,Interest Credited,0.00,47.03,1949992.07
4139,2021-08-28,2021-08-28,,Credit Card Payment,398.42,0.00,1949593.65
4140,2021-08-27,2021-08-28,,Utility Payment,277.44,0.00,1949316.21
4141,2021-08-28,2021-08-28,,ATM Withdrawal,253.57,0.00,1949062.64
4142,2021-08-29,2021-08-28,,Online Transfer,143.69,0.00,1948918.95
4143,2021-08-28,2021-08-28,,Salary Credit,0.00,4169.23,1953088.18
4144,2021-08-27,2021-08-28,,Online Transfer,1328.90,0.00,1951759.28
4145,2021-08-29,2021-08-29,,Transfer Received,0.00,768.33,1952527.61
4146,2021-08-28,2021-08-29,,Utility Payment,172.62,0.00,1952354.99
4147,2021-08-29,2021-08-29,,Online Transfer,1185.26,0.00,1951169.73
4148,2021-08-30,2021-08-29,,Transfer Received,0.00,2534.66,1953704.39
4149,2021-08-29,2021-08-29,,Investment - Mutual Funds,1359.41,0.00,1952344.98
4150,2021-08-30,2021-08-29,,Investment - Mutual Funds,301.92,0.00,1952043.06
4151,2021-08-31,2021-08-30,,ATM Withdrawal,187.72,0.00,1951855.34
4152,2021-08-30,2021-08-30,,Online Transfer,739.66,0.00,1951115.68
4153,2021-08-30,2021-08-30,,Salary Credit,0.00,4181.60,1955297.28
4154,2021-08-30,2021-08-30,,Credit Card Payment,454.05,0.00,1954843.23
4155,2021-08-31,2021-08-30,,Utility Payment,272.16,0.00,1954571.07
4156,2021-08-30,2021-08-30,,Utility Payment,146.96,0.00,1954424.11
4157,2021-08-30,2021-08-30,,Dining Out,85.56,0.00,1954338.55
4158,2021-08-30,2021-08-30,,Transfer Received,0.00,2027.47,1956366.02
4159,2021-08-30,2021-08-30,,Salary Credit,0.00,4327.10,1960693.12
4160,2021-08-31,2021-08-31,,Online Transfer,1245.07,0.00,1959448.05
4161,2021-08-31,2021-08-31,,Groceries - Online Delivery,125.90,0.00,1959322.15
4162,2021-08-31,2021-08-31,,Investment Returns,0.00,125.76,1959447.91
4163,2021-09-01,2021-08-31,,Transfer Received,0.00,2371.46,1961819.37
4164,2021-08-30,2021-08-31,,Rental Income,0.00,2146.39,1963965.76
4165,2021-08-31,2021-09-01,,Groceries - Supermarket,83.03,0.00,1963882.73
4166,2021-09-01,2021-09-01,,Utility Payment,169.20,0.00,1963713.53
4167,2021-09-01,2021-09-01,,ATM Withdrawal,376.10,0.00,1963337.43
4168,2021-08-31,2021-09-01,,Investment - Stocks,4530.35,0.00,1958807.08
4169,2021-09-01,2021-09-01,,Salary Credit,0.00,4216.49,1963023.57
4170,2021-09-01,2021-09-01,,Daily Essentials,9.82,0.00,1963013.75
4171,2021-08-31,2021-09-01,,Online Transfer,1983.84,0.00,1961029.91
4172,2021-09-01,2021-09-01,,Investment Returns,0.00,179.59,1961209.50
4173,2021-09-01,2021-09-01,,Transfer Received,0.00,1518.35,1962727.85
4174,2021-09-01,2021-09-01,,ATM Withdrawal,445.56,0.00,1962282.29
4175,2021-09-02,2021-09-02,,Groceries - Online Delivery,71.14,0.00,1962211.15
4176,2021-09-03,2021-09-02,,Online Transfer,976.00,0.00,1961235.15
4177,2021-09-03,2021-09-02,,Transfer Received,0.00,2140.56,1963375.71
4178,2021-09-03,2021-09-02,,Transfer Received,0.00,1368.89,1964744.60
4179,2021-09-01,2021-09-02,,Dividend Received,0.00,291.10,1965035.70
4180,2021-09-03,2021-09-03,,Transfer Received,0.00,2079.58,1967115.28
4181,2021-09-03,2021-09-03,,Online Transfer,335.83,0.00,1966779.45
4182,2021-09-03,2021-09-03,,Interest Credited,0.00,14.34,1966793.79
4183,2021-09-02,2021-09-03,,Takeout,38.40,0.00,1966755.39
4184,2021-09-05,2021-09-04,,Groceries - Online Delivery,124.39,0.00,1966631.00
4185,2021-09-04,2021-09-04,100094,Cheque Issued,1546.50,0.00,1965084.50
4186,2021-09-04,2021-09-04,,Salary Credit,0.00,2633.28,1967717.78
4187,2021-09-03,2021-09-04,,Takeout,23.47,0.00,1967694.31
4188,2021-09-03,2021-09-04,,Groceries - Online Delivery,79.42,0.00,1967614.89
4189,2021-09-03,2021-09-04,,Groceries - Supermarket,123.04,0.00,1967491.85
4190,2021-09-04,2021-09-04,,Transfer Received,0.00,2688.63,1970180.48
4191,2021-09-05,2021-09-05,,Salary Credit,0.00,4498.70,1974679.18
4192,2021-09-05,2021-09-05,,Dining Out,46.78,0.00,1974632.40
4193,2021-09-05,2021-09-05,,Takeout,35.73,0.00,1974596.67
4194,2021-09-05,2021-09-05,,Transfer Received,0.00,2949.42,1977546.09
4195,2021-09-06,2021-09-06,,Utility Payment,107.50,0.00,1977438.59
4196,2021-09-06,2021-09-06,,ATM Withdrawal,246.52,0.00,1977192.07
4197,2021-09-06,2021-09-06,,Online Transfer,1051.72,0.00,1976140.35
4198,2021-09-06,2021-09-06,,Transfer Received,0.00,703.93,1976844.28
4199,2021-09-06,2021-09-06,,Loan EMI,1796.03,0.00,1975048.25
4200,2021-09-06,2021-09-06,,Credit Card Payment,887.24,0.00,1974161.01
4201,2021-09-06,2021-09-06,,Online Transfer,1247.77,0.00,1972913.24
4202,2021-09-06,2021-09-06,,Transfer Received,0.00,2225.40,1975138.64
4203,2021-09-06,2021-09-06,,Groceries - Online Delivery,66.73,0.00,1975071.91
4204,2021-09-07,2021-09-07,,Transfer Received,0.00,1645.93,1976717.84
4205,2021-09-06,2021-09-07,,Investment - SIP,114.47,0.00,1976603.37
4206,2021-09-07,2021-09-07,,Online Transfer,1550.81,0.00,1975052.56
4207,2021-09-08,2021-09-08,,Online Transfer,1838.86,0.00,1973213.70
4208,2021-09-09,2021-09-08,,Salary Credit,0.00,4957.64,1978171.34
4209,2021-09-08,2021-09-08,,Investment - Mutual Funds,2029.89,0.00,1976141.45
4210,2021-09-09,2021-09-08,,Salary Credit,0.00,2498.41,1978639.86
4211,2021-09-08,2021-09-08,,Investment - SIP,877.68,0.00,1977762.18
4212,2021-09-09,2021-09-09,,Salary Credit,0.00,4106.21,1981868.39
4213,2021-09-08,2021-09-09,,Salary Credit,0.00,4904.70,1986773.09
4214,2021-09-09,2021-09-09,,Interest Credited,0.00,70.11,1986843.20
4215,2021-09-08,2021-09-09,,Investment - SIP,527.69,0.00,1986315.51
4216,2021-09-09,2021-09-09,,Transfer Received,0.00,2281.39,1988596.90
4217,2021-09-09,2021-09-09,,Credit Card Payment,938.03,0.00,1987658.87
4218,2021-09-09,2021-09-09,100095,Cheque Issued,1873.84,0.00,1985785.03
4219,2021-09-10,2021-09-10,,ATM Withdrawal,396.87,0.00,1985388.16
4220,2021-09-09,2021-09-10,,Credit Card Payment,602.87,0.00,1984785.29
4221,2021-09-10,2021-09-10,,Transfer Received,0.00,1437.41,1986222.70
4222,2021-09-11,2021-09-11,,Groceries - Supermarket,117.92,0.00,1986104.78
4223,2021-09-11,2021-09-11,,Credit Card Payment,848.80,0.00,1985255.98
4224,2021-09-11,2021-09-11,,Groceries - Supermarket,32.28,0.00,1985223.70
4225,2021-09-13,2021-09-12,,Groceries - Online Delivery,125.58,0.00,1985098.12
4226,2021-09-12,2021-09-12,,Groceries - Supermarket,55.90,0.00,1985042.22
4227,2021-09-12,2021-09-12,,Groceries - Supermarket,47.37,0.00,1984994.85
4228,2021-09-13,2021-09-12,,Rental Income,0.00,2307.69,1987302.54
4229,2021-09-12,2021-09-12,,Online Transfer,748.40,0.00,1986554.14
4230,2021-09-13,2021-09-12,,Online Transfer,1782.61,0.00,1984771.53
4231,2021-09-12,2021-09-12,,Transfer Received,0.00,2716.13,1987487.66
4232,2021-09-13,2021-09-13,,Interest Credited,0.00,42.65,1987530.31
4233,2021-09-13,2021-09-13,,Loan EMI,623.58,0.00,1986906.73
4234,2021-09-14,2021-09-13,,Salary Credit,0.00,2849.85,1989756.58
4235,2021-09-14,2021-09-13,,Transfer Received,0.00,1763.00,1991519.58
4236,2021-09-13,2021-09-13,,Transfer Received,0.00,893.08,1992412.66
4237,2021-09-13,2021-09-13,,ATM Withdrawal,423.28,0.00,1991989.38
4238,2021-09-12,2021-09-13,,Groceries - Supermarket,133.16,0.00,1991856.22
4239,2021-09-15,2021-09-14,,Transfer Received,0.00,1558.55,1993414.77
4240,2021-09-14,2021-09-14,,Salary Credit,0.00,2334.18,1995748.95
4241,2021-09-14,2021-09-14,,Groceries - Online Delivery,108.78,0.00,1995640.17
4242,2021-09-14,2021-09-14,,Loan EMI,1894.33,0.00,1993745.84
4243,2021-09-14,2021-09-14,,Dividend Received,0.00,195.69,1993941.53
4244,2021-09-13,2021-09-14,,Transfer Received,0.00,847.17,1994788.70
4245,2021-09-13,2021-09-14,,Transfer Received,0.00,1360.68,1996149.38
4246,2021-09-15,2021-09-14,,Takeout,19.52,0.00,1996129.86
4247,2021-09-15,2021-09-14,,Rental Income,0.00,1377.49,1997507.35
4248,2021-09-14,2021-09-14,,Investment - Stocks,4235.52,0.00,1993271.83
4249,2021-09-15,2021-09-15,,Online Transfer,1974.58,0.00,1991297.25
4250,2021-09-15,2021-09-15,,Salary Credit,0.00,2982.98,1994280.23
4251,2021-09-15,2021-09-15,,Groceries - Online Delivery,102.18,0.00,1994178.05
4252,2021-09-15,2021-09-15,,Transfer Received,0.00,801.10,1994979.15
4253,2021-09-15,2021-09-15,,Salary Credit,0.00,3340.35,1998319.50
4254,2021-09-15,2021-09-15,,Salary Credit,0.00,4145.71,2002465.21
4255,2021-09-15,2021-09-15,,Transfer Received,0.00,1321.61,2003786.82
4256,2021-09-16,2021-09-15,,Interest Credited,0.00,95.98,2003882.80
4257,2021-09-15,2021-09-15,,Salary Credit,0.00,3870.48,2007753.28
4258,2021-09-17,2021-09-16,,Online Transfer,1219.03,0.00,2006534.25
4259,2021-09-17,2021-09-16,,Utility Payment,71.24,0.00,2006463.01
4260,2021-09-16,2021-09-16,,Daily Essentials,44.08,0.00,2006418.93
4261,2021-09-16,2021-09-16,,Salary Credit,0.00,2447.03,2008865.96
4262,2021-09-16,2021-09-16,,Investment Returns,0.00,177.90,2009043.86
4263,2021-09-17,2021-09-17,,Online Transfer,232.44,0.00,2008811.42
4264,2021-09-18,2021-09-17,,Transfer Received,0.00,2933.24,2011744.66
4265,2021-09-17,2021-09-17,,Salary Credit,0.00,4892.24,2016636.90
4266,2021-09-17,2021-09-17,,Groceries - Supermarket,145.21,0.00,2016491.69
4267,2021-09-17,2021-09-17,,ATM Withdrawal,429.11,0.00,2016062.58
4268,2021-09-19,2021-09-18,,Online Transfer,1892.66,0.00,2014169.92
4269,2021-09-17,2021-09-18,,Utility Payment,172.37,0.00,2013997.55
4270,2021-09-18,2021-09-18,,Interest Credited,0.00,82.13,2014079.68
4271,2021-09-18,2021-09-18,,Dividend Received,0.00,399.96,2014479.64
4272,2021-09-18,2021-09-18,,Credit Card Payment,685.46,0.00,2013794.18
4273,2021-09-18,2021-09-18,,Transfer Received,0.00,830.40,2014624.58
4274,2021-09-17,2021-09-18,,Dining Out,78.34,0.00,2014546.24
4275,2021-09-20,2021-09-19,,Salary Credit,0.00,2808.92,2017355.16
4276,2021-09-19,2021-09-19,,Takeout,19.45,0.00,2017335.71
4277,2021-09-20,2021-09-20,,Daily Essentials,44.50,0.00,2017291.21
4278,2021-09-20,2021-09-20,,Utility Payment,279.35,0.00,2017011.86
4279,2021-09-20,2021-09-20,,Groceries - Supermarket,162.04,0.00,2016849.82
4280,2021-09-20,2021-09-20,,Credit Card Payment,361.84,0.00,2016487.98
4281,2021-09-22,2021-09-21,,Investment - Mutual Funds,2078.64,0.00,2014409.34
4282,2021-09-21,2021-09-21,,ATM Withdrawal,405.73,0.00,2014003.61
4283,2021-09-21,2021-09-21,,Salary Credit,0.00,4594.76,2018598.37
4284,2021-09-21,2021-09-21,,Online Transfer,474.72,0.00,2018123.65
4285,2021-09-21,2021-09-21,,Groceries - Supermarket,63.76,0.00,2018059.89
4286,2021-09-21,2021-09-21,,Coffee Shop,9.63,0.00,2018050.26
4287,2021-09-21,2021-09-21,,Takeout,26.86,0.00,2018023.40
4288,2021-09-21,2021-09-21,,Transfer Received,0.00,2858.45,2020881.85
4289,2021-09-21,2021-09-21,,Salary Credit,0.00,4182.01,2025063.86
4290,2021-09-21,2021-09-21,,ATM Withdrawal,40.87,0.00,2025022.99
4291,2021-09-20,2021-09-21,,Credit Card Payment,562.05,0.00,2024460.94
4292,2021-09-21,2021-09-21,,Investment - SIP,126.96,0.00,2024333.98
4293,2021-09-22,2021-09-22,,Rental Income,0.00,2523.54,2026857.52
4294,2021-09-21,2021-09-22,,Transfer Received,0.00,2433.16,2029290.68
4295,2021-09-22,2021-09-22,,Credit Card Payment,658.81,0.00,2028631.87
4296,2021-09-22,2021-09-22,,Transfer Received,0.00,1924.07,2030555.94
4297,2021-09-22,2021-09-22,,ATM Withdrawal,450.33,0.00,2030105.61
4298,2021-09-22,2021-09-22,,Investment - SIP,570.94,0.00,2029534.67
4299,2021-09-22,2021-09-22,,Online Transfer,127.68,0.00,2029406.99
4300,2021-09-23,2021-09-23,,Salary Credit,0.00,3699.54,2033106.53
4301,2021-09-23,2021-09-23,,ATM Withdrawal,73.71,0.00,2033032.82
4302,2021-09-22,2021-09-23,,Investment - Mutual Funds,2549.89,0.00,2030482.93
4303,2021-09-23,2021-09-23,,Utility Payment,270.64,0.00,2030212.29
4304,2021-09-23,2021-09-23,,Investment - Stocks,3675.13,0.00,2026537.16
4305,2021-09-23,2021-09-23,,Groceries - Supermarket,62.85,0.00,2026474.31
4306,2021-09-23,2021-09-23,,Salary Credit,0.00,3543.43,2030017.74
4307,2021-09-23,2021-09-23,100096,Cheque Issued,2556.03,0.00,2027461.71
4308,2021-09-23,2021-09-23,,Salary Credit,0.00,3485.22,2030946.93
4309,2021-09-25,2021-09-24,,ATM Withdrawal,480.53,0.00,2030466.40
4310,2021-09-23,2021-09-24,,Credit Card Payment,392.95,0.00,2030073.45
4311,2021-09-24,2021-09-24,,Utility Payment,240.59,0.00,2029832.86
4312,2021-09-24,2021-09-24,,Investment - Stocks,2018.35,0.00,2027814.51
4313,2021-09-24,2021-09-25,,Transfer Received,0.00,1601.59,2029416.10
4314,2021-09-24,2021-09-25,,Online Transfer,1652.45,0.00,2027763.65
4315,2021-09-25,2021-09-25,,Transfer Received,0.00,2675.44,2030439.09
4316,2021-09-25,2021-09-25,,Groceries - Supermarket,187.98,0.00,2030251.11
4317,2021-09-26,2021-09-26,,Credit Card Payment,611.30,0.00,2029639.81
4318,2021-09-26,2021-09-26,,Investment - Stocks,4804.88,0.00,2024834.93
4319,2021-09-27,2021-09-26,,ATM Withdrawal,407.22,0.00,2024427.71
4320,2021-09-26,2021-09-26,,Groceries - Supermarket,70.03,0.00,2024357.68
4321,2021-09-26,2021-09-26,,Dividend Received,0.00,61.49,2024419.17
4322,2021-09-26,2021-09-26,,Salary Credit,0.00,3311.39,2027730.56
4323,2021-09-25,2021-09-26,,Loan EMI,1114.46,0.00,2026616.10
4324,2021-09-26,2021-09-26,,Online Transfer,1106.94,0.00,2025509.16
4325,2021-09-25,2021-09-26,,ATM Withdrawal,62.78,0.00,2025446.38
4326,2021-09-28,2021-09-27,,Rental Income,0.00,1052.84,2026499.22
4327,2021-09-27,2021-09-27,,Salary Credit,0.00,4181.45,2030680.67
4328,2021-09-27,2021-09-27,,Loan EMI,655.90,0.00,2030024.77
4329,2021-09-27,2021-09-27,,Transfer Received,0.00,556.35,2030581.12
4330,2021-09-27,2021-09-27,,Credit Card Payment,418.13,0.00,2030162.99
4331,2021-09-28,2021-09-27,,Investment - Mutual Funds,2105.55,0.00,2028057.44
4332,2021-09-26,2021-09-27,,Salary Credit,0.00,2637.02,2030694.46
4333,2021-09-28,2021-09-28,,Transfer Received,0.00,2473.95,2033168.41
4334,2021-09-29,2021-09-28,100097,Cheque Issued,535.41,0.00,2032633.00
4335,2021-09-28,2021-09-28,,Dining Out,90.88,0.00,2032542.12
4336,2021-09-28,2021-09-28,,Groceries - Online Delivery,53.05,0.00,2032489.07
4337,2021-09-28,2021-09-28,,Salary Credit,0.00,2464.24,2034953.31
4338,2021-09-29,2021-09-28,,Online Transfer,161.75,0.00,2034791.56
4339,2021-09-28,2021-09-28,,ATM Withdrawal,202.54,0.00,2034589.02
4340,2021-09-29,2021-09-29,,Salary Credit,0.00,3252.80,2037841.82
4341,2021-09-29,2021-09-29,,Salary Credit,0.00,2590.48,2040432.30
4342,2021-09-29,2021-09-29,,Groceries - Supermarket,146.04,0.00,2040286.26
4343,2021-09-29,2021-09-29,,Interest Credited,0.00,26.17,2040312.43
4344,2021-09-29,2021-09-29,,Transfer Received,0.00,1892.76,2042205.19
4345,2021-09-28,2021-09-29,,Transfer Received,0.00,1574.25,2043779.44
4346,2021-09-29,2021-09-30,100098,Cheque Issued,515.36,0.00,2043264.08
4347,2021-09-30,2021-09-30,100099,Cheque Issued,2358.99,0.00,2040905.09
4348,2021-09-29,2021-09-30,,Credit Card Payment,387.48,0.00,2040517.61
4349,2021-10-01,2021-09-30,,Dining Out,70.00,0.00,2040447.61
4350,2021-09-30,2021-09-30,,Transfer Received,0.00,846.18,2041293.79
4351,2021-09-30,2021-09-30,,Salary Credit,0.00,4485.36,2045779.15
4352,2021-09-30,2021-09-30,,Salary Credit,0.00,3879.18,2049658.33
4353,2021-10-01,2021-09-30,,Daily Essentials,32.85,0.00,2049625.48
4354,2021-10-02,2021-10-01,,ATM Withdrawal,140.07,0.00,2049485.41
4355,2021-10-01,2021-10-01,,ATM Withdrawal,269.40,0.00,2049216.01
4356,2021-10-01,2021-10-01,,Dining Out,97.67,0.00,2049118.34
4357,2021-10-01,2021-10-01,,Groceries - Supermarket,180.41,0.00,2048937.93
4358,2021-10-01,2021-10-01,,Groceries - Online Delivery,76.42,0.00,2048861.51
4359,2021-09-30,2021-10-01,,Groceries - Supermarket,96.31,0.00,2048765.20
4360,2021-10-01,2021-10-01,,ATM Withdrawal,145.98,0.00,2048619.22
4361,2021-10-01,2021-10-01,,Salary Credit,0.00,3861.83,2052481.05
4362,2021-10-01,2021-10-01,,Salary Credit,0.00,4943.70,2057424.75
4363,2021-10-01,2021-10-01,,Utility Payment,267.60,0.00,2057157.15
4364,2021-10-02,2021-10-01,,Online Transfer,375.00,0.00,2056782.15
4365,2021-10-01,2021-10-01,,Salary Credit,0.00,3797.17,2060579.32
4366,2021-10-02,2021-10-01,,Transfer Received,0.00,1303.14,2061882.46
4367,2021-10-03,2021-10-02,,Rental Income,0.00,2802.26,2064684.72
4368,2021-10-03,2021-10-02,,Interest Credited,0.00,24.04,2064708.76
4369,2021-10-02,2021-10-03,,Transfer Received,0.00,1940.80,2066649.56
4370,2021-10-04,2021-10-03,,Investment - Mutual Funds,775.09,0.00,2065874.47
4371,2021-10-03,2021-10-03,,Investment - SIP,954.79,0.00,2064919.68
4372,2021-10-02,2021-10-03,,Transfer Received,0.00,2101.86,2067021.54
4373,2021-10-04,2021-10-03,,Interest Credited,0.00,44.42,2067065.96
4374,2021-10-03,2021-10-03,,Credit Card Payment,254.14,0.00,2066811.82
4375,2021-10-03,2021-10-03,,Interest Credited,0.00,87.82,2066899.64
4376,2021-10-03,2021-10-03,,Utility Payment,151.44,0.00,2066748.20
4377,2021-10-03,2021-10-03,,Dining Out,38.71,0.00,2066709.49
4378,2021-10-04,2021-10-04,,Groceries - Supermarket,31.29,0.00,2066678.20
4379,2021-10-04,2021-10-04,,Interest Credited,0.00,76.25,2066754.45
4380,2021-10-04,2021-10-04,,Interest Credited,0.00,22.93,2066777.38
4381,2021-10-04,2021-10-04,,Investment - Stocks,4330.06,0.00,2062447.32
4382,2021-10-04,2021-10-04,,Dining Out,95.06,0.00,2062352.26
4383,2021-10-04,2021-10-04,,Transfer Received,0.00,2459.69,2064811.95
4384,2021-10-04,2021-10-04,,Rental Income,0.00,1379.16,2066191.11
4385,2021-10-04,2021-10-04,,Groceries - Supermarket,32.33,0.00,2066158.78
4386,2021-10-03,2021-10-04,,Online Transfer,247.69,0.00,2065911.09
4387,2021-10-04,2021-10-04,,Online Transfer,204.32,0.00,2065706.77
4388,2021-10-04,2021-10-05,,Loan EMI,693.69,0.00,2065013.08
4389,2021-10-06,2021-10-05,,Salary Credit,0.00,4507.87,2069520.95
4390,2021-10-06,2021-10-05,,Salary Credit,0.00,2462.25,2071983.20
4391,2021-10-06,2021-10-05,,Credit Card Payment,310.87,0.00,2071672.33
4392,2021-10-05,2021-10-05,,ATM Withdrawal,395.82,0.00,2071276.51
4393,2021-10-05,2021-10-05,,Groceries - Supermarket,33.66,0.00,2071242.85
4394,2021-10-05,2021-10-05,,ATM Withdrawal,198.16,0.00,2071044.69
4395,2021-10-06,2021-10-06,,Investment Returns,0.00,577.55,2071622.24
4396,2021-10-05,2021-10-06,,Groceries - Supermarket,123.09,0.00,2071499.15
4397,2021-10-05,2021-10-06,,Transfer Received,0.00,1129.24,2072628.39
4398,2021-10-05,2021-10-06,,Transfer Received,0.00,1005.48,2073633.87
4399,2021-10-06,2021-10-06,,ATM Withdrawal,199.90,0.00,2073433.97
4400,2021-10-06,2021-10-06,,Salary Credit,0.00,2964.92,2076398.89
4401,2021-10-06,2021-10-06,100100,Cheque Issued,1186.96,0.00,2075211.93
4402,2021-10-07,2021-10-07,,ATM Withdrawal,197.39,0.00,2075014.54
4403,2021-10-07,2021-10-07,,Investment - Mutual Funds,1092.71,0.00,2073921.83
4404,2021-10-07,2021-10-07,,Transfer Received,0.00,1208.80,2075130.63
4405,2021-10-07,2021-10-07,,Credit Card Payment,740.02,0.00,2074390.61
4406,2021-10-07,2021-10-07,,Rental Income,0.00,2144.32,2076534.93
4407,2021-10-08,2021-10-08,,Investment - Mutual Funds,2230.26,0.00,2074304.67
4408,2021-10-08,2021-10-08,,Credit Card Payment,267.70,0.00,2074036.97
4409,2021-10-08,2021-10-08,,Cash Deposit,0.00,908.13,2074945.10
4410,2021-10-08,2021-10-08,,Investment - Stocks,4811.16,0.00,2070133.94
4411,2021-10-08,2021-10-08,,Online Transfer,1024.38,0.00,2069109.56
4412,2021-10-07,2021-10-08,,Credit Card Payment,467.96,0.00,2068641.60
4413,2021-10-08,2021-10-08,,ATM Withdrawal,58.88,0.00,2068582.72
4414,2021-10-08,2021-10-08,,Transfer Received,0.00,2505.97,2071088.69
4415,2021-10-09,2021-10-09,,Daily Essentials,21.65,0.00,2071067.04
4416,2021-10-09,2021-10-09,,Interest Credited,0.00,99.15,2071166.19
4417,2021-10-09,2021-10-09,,Online Transfer,1801.30,0.00,2069364.89
4418,2021-10-09,2021-10-09,,Salary Credit,0.00,3873.06,2073237.95
4419,2021-10-10,2021-10-09,,Interest Credited,0.00,11.85,2073249.80
4420,2021-10-09,2021-10-10,,Groceries - Supermarket,41.34,0.00,2073208.46
4421,2021-10-09,2021-10-10,,Utility Payment,113.02,0.00,2073095.44
4422,2021-10-09,2021-10-10,,Credit Card Payment,732.77,0.00,2072362.67
4423,2021-10-09,2021-10-10,,Loan EMI,1089.46,0.00,2071273.21
4424,2021-10-09,2021-10-10,,Transfer Received,0.00,2398.28,2073671.49
4425,2021-10-10,2021-10-10,,Online Transfer,1254.96,0.00,2072416.53
4426,2021-10-10,2021-10-10,,Utility Payment,127.70,0.00,2072288.83
4427,2021-10-10,2021-10-10,,Salary Credit,0.00,3858.78,2076147.61
4428,2021-10-09,2021-10-10,,ATM Withdrawal,149.91,0.00,2075997.70
4429,2021-10-12,2021-10-11,,ATM Withdrawal,201.90,0.00,2075795.80
4430,2021-10-11,2021-10-11,,ATM Withdrawal,156.57,0.00,2075639.23
4431,2021-10-10,2021-10-11,,Salary Credit,0.00,4792.76,2080431.99
4432,2021-10-11,2021-10-11,,Loan EMI,1611.45,0.00,2078820.54
4433,2021-10-11,2021-10-11,,Dining Out,75.93,0.00,2078744.61
4434,2021-10-11,2021-10-11,,Credit Card Payment,869.43,0.00,2077875.18
4435,2021-10-11,2021-10-11,,ATM Withdrawal,444.26,0.00,2077430.92
4436,2021-10-11,2021-10-12,,Takeout,25.49,0.00,2077405.43
4437,2021-10-12,2021-10-12,,Credit Card Payment,809.57,0.00,2076595.86
4438,2021-10-13,2021-10-12,,Utility Payment,170.28,0.00,2076425.58
4439,2021-10-13,2021-10-12,,Transfer Received,0.00,1225.73,2077651.31
4440,2021-10-12,2021-10-12,,ATM Withdrawal,426.15,0.00,2077225.16
4441,2021-10-12,2021-10-12,,Utility Payment,281.65,0.00,2076943.51
4442,2021-10-12,2021-10-12,,Online Transfer,190.82,0.00,2076752.69
4443,2021-10-12,2021-10-12,,Dividend Received,0.00,387.04,2077139.73
4444,2021-10-13,2021-10-13,,Transfer Received,0.00,733.01,2077872.74
4445,2021-10-13,2021-10-13,,Utility Payment,289.75,0.00,2077582.99
4446,2021-10-14,2021-10-13,,ATM Withdrawal,439.93,0.00,2077143.06
4447,2021-10-13,2021-10-13,,Salary Credit,0.00,3955.73,2081098.79
4448,2021-10-13,2021-10-13,,Transfer Received,0.00,1918.10,2083016.89
4449,2021-10-13,2021-10-13,,Cash Deposit,0.00,273.09,2083289.98
4450,2021-10-13,2021-10-13,,Online Transfer,796.42,0.00,2082493.56
4451,2021-10-13,2021-10-13,,ATM Withdrawal,487.59,0.00,2082005.97
4452,2021-10-13,2021-10-13,,ATM Withdrawal,192.53,0.00,2081813.44
4453,2021-10-13,2021-10-13,,Utility Payment,223.40,0.00,2081590.04
4454,2021-10-13,2021-10-13,,Credit Card Payment,880.60,0.00,2080709.44
4455,2021-10-14,2021-10-14,,Transfer Received,0.00,1316.29,2082025.73
4456,2021-10-13,2021-10-14,,Credit Card Payment,326.13,0.00,2081699.60
4457,2021-10-13,2021-10-14,,Salary Credit,0.00,2996.09,2084695.69
4458,2021-10-14,2021-10-14,,Transfer Received,0.00,1795.65,2086491.34
4459,2021-10-14,2021-10-14,,Salary Credit,0.00,4799.32,2091290.66
4460,2021-10-16,2021-10-15,,Rental Income,0.00,1799.39,2093090.05
4461,2021-10-15,2021-10-15,,Loan EMI,866.21,0.00,2092223.84
4462,2021-10-15,2021-10-15,,Online Transfer,1139.39,0.00,2091084.45
4463,2021-10-16,2021-10-15,100101,Cheque Issued,2110.00,0.00,2088974.45
4464,2021-10-15,2021-10-15,,Credit Card Payment,570.09,0.00,2088404.36
4465,2021-10-16,2021-10-15,,Salary Credit,0.00,4721.24,2093125.60
4466,2021-10-16,2021-10-15,,Utility Payment,183.62,0.00,2092941.98
4467,2021-10-15,2021-10-15,,Transfer Received,0.00,2615.18,2095557.16
4468,2021-10-16,2021-10-16,,Loan EMI,1181.77,0.00,2094375.39
4469,2021-10-15,2021-10-16,,Groceries - Online Delivery,89.01,0.00,2094286.38
4470,2021-10-16,2021-10-16,,Takeout,12.19,0.00,2094274.19
4471,2021-10-17,2021-10-16,,Salary Credit,0.00,4841.89,2099116.08
4472,2021-10-16,2021-10-16,,Salary Credit,0.00,4070.09,2103186.17
4473,2021-10-16,2021-10-16,,Online Transfer,545.72,0.00,2102640.45
4474,2021-10-15,2021-10-16,,Cash Deposit,0.00,527.90,2103168.35
4475,2021-10-17,2021-10-17,,ATM Withdrawal,266.09,0.00,2102902.26
4476,2021-10-17,2021-10-17,,ATM Withdrawal,52.57,0.00,2102849.69
4477,2021-10-17,2021-10-17,,Daily Essentials,29.96,0.00,2102819.73
4478,2021-10-17,2021-10-17,,Credit Card Payment,661.76,0.00,2102157.97
4479,2021-10-17,2021-10-17,,Credit Card Payment,433.85,0.00,2101724.12
4480,2021-10-17,2021-10-17,,Groceries - Supermarket,116.84,0.00,2101607.28
4481,2021-10-16,2021-10-17,,Investment Returns,0.00,780.88,2102388.16
4482,2021-10-17,2021-10-18,,Salary Credit,0.00,3843.01,2106231.17
4483,2021-10-18,2021-10-18,,Investment - SIP,601.93,0.00,2105629.24
4484,2021-10-18,2021-10-18,,Salary Credit,0.00,3724.23,2109353.47
4485,2021-10-19,2021-10-18,,Takeout,24.24,0.00,2109329.23
4486,2021-10-18,2021-10-18,,Salary Credit,0.00,3518.66,2112847.89
4487,2021-10-20,2021-10-19,,Transfer Received,0.00,2690.82,2115538.71
4488,2021-10-19,2021-10-19,,ATM Withdrawal,285.03,0.00,2115253.68
4489,2021-10-20,2021-10-19,,Dividend Received,0.00,349.31,2115602.99
4490,2021-10-20,2021-10-19,,Investment Returns,0.00,719.22,2116322.21
4491,2021-10-19,2021-10-19,,Loan EMI,1873.22,0.00,2114448.99
4492,2021-10-19,2021-10-19,,Online Transfer,1032.34,0.00,2113416.65
4493,2021-10-19,2021-10-19,,Credit Card Payment,862.92,0.00,2112553.73
4494,2021-10-20,2021-10-19,,Transfer Received,0.00,1093.25,2113646.98
4495,2021-10-19,2021-10-20,,Takeout,26.64,0.00,2113620.34
4496,2021-10-20,2021-10-20,,Credit Card Payment,463.09,0.00,2113157.25
4497,2021-10-20,2021-10-20,,ATM Withdrawal,160.75,0.00,2112996.50
4498,2021-10-20,2021-10-20,,Groceries - Supermarket,24.79,0.00,2112971.71
4499,2021-10-20,2021-10-20,,ATM Withdrawal,297.63,0.00,2112674.08
4500,2021-10-20,2021-10-20,,Loan EMI,765.36,0.00,2111908.72
4501,2021-10-20,2021-10-20,,Groceries - Supermarket,175.21,0.00,2111733.51
4502,2021-10-21,2021-10-21,,Groceries - Supermarket,149.10,0.00,2111584.41
4503,2021-10-21,2021-10-21,,Rental Income,0.00,2980.86,2114565.27
4504,2021-10-21,2021-10-21,,Utility Payment,82.10,0.00,2114483.17
4505,2021-10-21,2021-10-21,,Utility Payment,228.00,0.00,2114255.17
4506,2021-10-21,2021-10-21,,Investment - Stocks,3709.78,0.00,2110545.39
4507,2021-10-21,2021-10-21,,ATM Withdrawal,395.15,0.00,2110150.24
4508,2021-10-20,2021-10-21,,Dining Out,57.36,0.00,2110092.88
4509,2021-10-20,2021-10-21,,Investment Returns,0.00,288.56,2110381.44
4510,2021-10-22,2021-10-21,,Interest Credited,0.00,46.20,2110427.64
4511,2021-10-21,2021-10-21,,Groceries - Supermarket,178.00,0.00,2110249.64
4512,2021-10-21,2021-10-21,,Dividend Received,0.00,116.18,2110365.82
4513,2021-10-21,2021-10-21,,Loan EMI,1241.90,0.00,2109123.92
4514,2021-10-22,2021-10-22,,ATM Withdrawal,238.91,0.00,2108885.01
4515,2021-10-22,2021-10-22,,Dividend Received,0.00,197.37,2109082.38
4516,2021-10-22,2021-10-22,,Investment - SIP,249.01,0.00,2108833.37
4517,2021-10-22,2021-10-22,,Groceries - Supermarket,183.67,0.00,2108649.70
4518,2021-10-22,2021-10-22,,Daily Essentials,31.29,0.00,2108618.41
4519,2021-10-21,2021-10-22,,Coffee Shop,14.50,0.00,2108603.91
4520,2021-10-22,2021-10-22,,Groceries - Supermarket,36.66,0.00,2108567.25
4521,2021-10-23,2021-10-23,,Groceries - Supermarket,181.23,0.00,2108386.02
4522,2021-10-23,2021-10-23,,Groceries - Supermarket,61.44,0.00,2108324.58
4523,2021-10-24,2021-10-23,100102,Cheque Issued,1506.40,0.00,2106818.18
4524,2021-10-23,2021-10-23,,ATM Withdrawal,307.84,0.00,2106510.34
4525,2021-10-24,2021-10-24,,ATM Withdrawal,337.55,0.00,2106172.79
4526,2021-10-24,2021-10-24,,ATM Withdrawal,487.59,0.00,2105685.20
4527,2021-10-24,2021-10-24,,Investment - Mutual Funds,453.70,0.00,2105231.50
4528,2021-10-24,2021-10-24,,Online Transfer,1799.17,0.00,2103432.33
4529,2021-10-23,2021-10-24,,Utility Payment,268.50,0.00,2103163.83
4530,2021-10-24,2021-10-24,,Groceries - Supermarket,133.46,0.00,2103030.37
4531,2021-10-25,2021-10-25,,Coffee Shop,14.95,0.00,2103015.42
4532,2021-10-25,2021-10-25,,Investment - SIP,897.00,0.00,2102118.42
4533,2021-10-26,2021-10-25,,Transfer Received,0.00,2401.68,2104520.10
4534,2021-10-25,2021-10-25,,Investment Returns,0.00,706.77,2105226.87
4535,2021-10-25,2021-10-25,,Salary Credit,0.00,4345.70,2109572.57
4536,2021-10-25,2021-10-25,,Salary Credit,0.00,2664.93,2112237.50
4537,2021-10-25,2021-10-25,,Investment - Mutual Funds,447.15,0.00,2111790.35
4538,2021-10-25,2021-10-26,,ATM Withdrawal,462.60,0.00,2111327.75
4539,2021-10-26,2021-10-26,,Online Transfer,615.16,0.00,2110712.59
4540,2021-10-26,2021-10-26,,ATM Withdrawal,454.78,0.00,2110257.81
4541,2021-10-25,2021-10-26,,Groceries - Supermarket,183.08,0.00,2110074.73
4542,2021-10-26,2021-10-26,,ATM Withdrawal,202.32,0.00,2109872.41
4543,2021-10-26,2021-10-26,,Rental Income,0.00,1857.88,2111730.29
4544,2021-10-25,2021-10-26,,ATM Withdrawal,218.62,0.00,2111511.67
4545,2021-10-25,2021-10-26,100103,Cheque Issued,1628.02,0.00,2109883.65
4546,2021-10-27,2021-10-27,,Groceries - Supermarket,110.90,0.00,2109772.75
4547,2021-10-27,2021-10-27,,Credit Card Payment,846.07,0.00,2108926.68
4548,2021-10-27,2021-10-27,,ATM Withdrawal,246.64,0.00,2108680.04
4549,2021-10-27,2021-10-27,,ATM Withdrawal,484.60,0.00,2108195.44
4550,2021-10-28,2021-10-27,100104,Cheque Issued,2803.58,0.00,2105391.86
4551,2021-10-27,2021-10-27,,ATM Withdrawal,331.47,0.00,2105060.39
4552,2021-10-29,2021-10-28,,Transfer Received,0.00,1136.90,2106197.29
4553,2021-10-28,2021-10-28,,Online Transfer,141.73,0.00,2106055.56
4554,2021-10-28,2021-10-28,,Groceries - Supermarket,38.18,0.00,2106017.38
4555,2021-10-28,2021-10-28,,Transfer Received,0.00,2471.42,2108488.80
4556,2021-10-29,2021-10-29,,Credit Card Payment,537.52,0.00,2107951.28
4557,2021-10-29,2021-10-29,,Takeout,28.94,0.00,2107922.34
4558,2021-10-29,2021-10-29,,Salary Credit,0.00,4491.54,2112413.88
4559,2021-10-29,2021-10-29,100105,Cheque Issued,1408.48,0.00,2111005.40
4560,2021-10-28,2021-10-29,,Coffee Shop,9.49,0.00,2110995.91
4561,2021-10-29,2021-10-29,,Transfer Received,0.00,2801.38,2113797.29
4562,2021-10-29,2021-10-29,,Groceries - Online Delivery,106.17,0.00,2113691.12
4563,2021-10-30,2021-10-29,,Coffee Shop,19.66,0.00,2113671.46
4564,2021-10-28,2021-10-29,,Investment - Stocks,2414.84,0.00,2111256.62
4565,2021-10-28,2021-10-29,,Groceries - Supermarket,82.45,0.00,2111174.17
4566,2021-10-28,2021-10-29,,Loan EMI,1940.68,0.00,2109233.49
4567,2021-10-30,2021-10-30,,Groceries - Supermarket,59.82,0.00,2109173.67
4568,2021-10-31,2021-10-30,,Utility Payment,244.01,0.00,2108929.66
4569,2021-10-30,2021-10-30,,Salary Credit,0.00,3986.16,2112915.82
4570,2021-10-29,2021-10-30,,Interest Credited,0.00,28.33,2112944.15
4571,2021-10-30,2021-10-30,,Investment Returns,0.00,635.42,2113579.57
4572,2021-10-30,2021-10-30,,Credit Card Payment,744.18,0.00,2112835.39
4573,2021-10-31,2021-10-31,,Transfer Received,0.00,2464.30,2115299.69
4574,2021-10-31,2021-10-31,,ATM Withdrawal,247.49,0.00,2115052.20
4575,2021-10-31,2021-10-31,,Credit Card Payment,271.06,0.00,2114781.14
4576,2021-10-31,2021-10-31,,Coffee Shop,18.31,0.00,2114762.83
4577,2021-10-30,2021-10-31,,Investment Returns,0.00,211.10,2114973.93
4578,2021-11-01,2021-11-01,,Transfer Received,0.00,1008.12,2115982.05
4579,2021-11-01,2021-11-01,,Transfer Received,0.00,2501.80,2118483.85
4580,2021-11-01,2021-11-01,,Utility Payment,50.90,0.00,2118432.95
4581,2021-11-01,2021-11-01,,Transfer Received,0.00,762.52,2119195.47
4582,2021-10-31,2021-11-01,,Investment Returns,0.00,576.14,2119771.61
4583,2021-11-02,2021-11-01,,ATM Withdrawal,229.65,0.00,2119541.96
4584,2021-11-02,2021-11-02,,Groceries - Supermarket,40.83,0.00,2119501.13
4585,2021-11-02,2021-11-02,100106,Cheque Issued,2245.12,0.00,2117256.01
4586,2021-11-02,2021-11-02,,Transfer Received,0.00,2470.98,2119726.99
4587,2021-11-03,2021-11-02,,Cash Deposit,0.00,182.92,2119909.91
4588,2021-11-03,2021-11-03,,Transfer Received,0.00,915.34,2120825.25
4589,2021-11-03,2021-11-03,,Groceries - Supermarket,25.65,0.00,2120799.60
4590,2021-11-04,2021-11-03,,Salary Credit,0.00,3121.16,2123920.76
4591,2021-11-03,2021-11-03,,Takeout,43.28,0.00,2123877.48
4592,2021-11-04,2021-11-03,,Investment - SIP,655.61,0.00,2123221.87
4593,2021-11-03,2021-11-03,,ATM Withdrawal,155.67,0.00,2123066.20
4594,2021-11-05,2021-11-04,,Interest Credited,0.00,41.13,2123107.33
4595,2021-11-03,2021-11-04,,Groceries - Supermarket,115.46,0.00,2122991.87
4596,2021-11-04,2021-11-04,,Groceries - Supermarket,95.68,0.00,2122896.19
4597,2021-11-04,2021-11-04,,Credit Card Payment,279.80,0.00,2122616.39
4598,2021-11-04,2021-11-04,,Online Transfer,1058.83,0.00,2121557.56
4599,2021-11-05,2021-11-05,,Utility Payment,96.50,0.00,2121461.06
4600,2021-11-05,2021-11-05,,Transfer Received,0.00,1175.64,2122636.70
4601,2021-11-06,2021-11-05,,Groceries - Online Delivery,91.52,0.00,2122545.18
4602,2021-11-05,2021-11-05,,Groceries - Supermarket,70.13,0.00,2122475.05
4603,2021-11-05,2021-11-05,,Transfer Received,0.00,659.05,2123134.10
4604,2021-11-04,2021-11-05,,Transfer Received,0.00,2860.50,2125994.60
4605,2021-11-05,2021-11-05,,Transfer Received,0.00,2758.14,2128752.74
4606,2021-11-05,2021-11-05,,Salary Credit,0.00,4802.85,2133555.59
4607,2021-11-07,2021-11-06,,Salary Credit,0.00,3274.44,2136830.03
4608,2021-11-06,2021-11-06,,ATM Withdrawal,96.43,0.00,2136733.60
4609,2021-11-06,2021-11-06,,Groceries - Supermarket,157.47,0.00,2136576.13
4610,2021-11-07,2021-11-06,,Groceries - Supermarket,41.21,0.00,2136534.92
4611,2021-11-06,2021-11-06,,Credit Card Payment,355.76,0.00,2136179.16
4612,2021-11-05,2021-11-06,,Online Transfer,924.04,0.00,2135255.12
4613,2021-11-06,2021-11-06,,Utility Payment,229.30,0.00,2135025.82
4614,2021-11-07,2021-11-07,,Transfer Received,0.00,2512.18,2137538.00
4615,2021-11-07,2021-11-07,,ATM Withdrawal,419.15,0.00,2137118.85
4616,2021-11-07,2021-11-07,,Coffee Shop,9.94,0.00,2137108.91
4617,2021-11-08,2021-11-08,,Utility Payment,271.09,0.00,2136837.82
4618,2021-11-08,2021-11-08,,Transfer Received,0.00,1268.17,2138105.99
4619,2021-11-09,2021-11-08,,Groceries - Supermarket,95.12,0.00,2138010.87
4620,2021-11-09,2021-11-09,,Transfer Received,0.00,1900.93,2139911.80
4621,2021-11-09,2021-11-09,,Online Transfer,360.50,0.00,2139551.30
4622,2021-11-09,2021-11-09,,Salary Credit,0.00,2661.99,2142213.29
4623,2021-11-09,2021-11-09,,Rental Income,0.00,2432.61,2144645.90
4624,2021-11-08,2021-11-09,,Salary Credit,0.00,4161.94,2148807.84
4625,2021-11-09,2021-11-09,,Salary Credit,0.00,4694.78,2153502.62
4626,2021-11-10,2021-11-10,,Interest Credited,0.00,76.73,2153579.35
4627,2021-11-10,2021-11-10,,Transfer Received,0.00,2699.37,2156278.72
4628,2021-11-11,2021-11-10,,Groceries - Supermarket,168.11,0.00,2156110.61
4629,2021-11-11,2021-11-10,,Transfer Received,0.00,615.40,2156726.01
4630,2021-11-10,2021-11-10,,Transfer Received,0.00,1898.87,2158624.88
4631,2021-11-11,2021-11-10,,Salary Credit,0.00,4024.14,2162649.02
4632,2021-11-11,2021-11-11,100107,Cheque Issued,1480.00,0.00,2161169.02
4633,2021-11-11,2021-11-11,,Investment - Stocks,3605.37,0.00,2157563.65
4634,2021-11-10,2021-11-11,,Groceries - Online Delivery,50.85,0.00,2157512.80
4635,2021-11-11,2021-11-11,,Salary Credit,0.00,4777.68,2162290.48
4636,2021-11-12,2021-11-12,,ATM Withdrawal,310.17,0.00,2161980.31
4637,2021-11-12,2021-11-12,,Utility Payment,220.93,0.00,2161759.38
4638,2021-11-11,2021-11-12,,Cash Deposit,0.00,421.52,2162180.90
4639,2021-11-12,2021-11-12,,Investment - Stocks,3494.19,0.00,2158686.71
4640,2021-11-12,2021-11-12,,Salary Credit,0.00,3028.25,2161714.96
4641,2021-11-13,2021-11-12,,Credit Card Payment,740.87,0.00,2160974.09
4642,2021-11-12,2021-11-12,,Salary Credit,0.00,4523.87,2165497.96
4643,2021-11-13,2021-11-13,,Utility Payment,267.81,0.00,2165230.15
4644,2021-11-13,2021-11-13,,Credit Card Payment,355.20,0.00,2164874.95
4645,2021-11-12,2021-11-13,,Transfer Received,0.00,2756.42,2167631.37
4646,2021-11-13,2021-11-13,,Loan EMI,1471.97,0.00,2166159.40
4647,2021-11-13,2021-11-13,,Salary Credit,0.00,2580.24,2168739.64
4648,2021-11-14,2021-11-14,,Cash Deposit,0.00,358.47,2169098.11
4649,2021-11-14,2021-11-14,,Salary Credit,0.00,2586.28,2171684.39
4650,2021-11-14,2021-11-14,,Interest Credited,0.00,99.84,2171784.23
4651,2021-11-14,2021-11-14,,Transfer Received,0.00,1297.70,2173081.93
4652,2021-11-15,2021-11-14,,Salary Credit,0.00,2859.79,2175941.72
4653,2021-11-13,2021-11-14,,Takeout,27.49,0.00,2175914.23
4654,2021-11-13,2021-11-14,,Transfer Received,0.00,1449.19,2177363.42
4655,2021-11-14,2021-11-14,,Credit Card Payment,365.71,0.00,2176997.71
4656,2021-11-14,2021-11-14,,Utility Payment,255.26,0.00,2176742.45
4657,2021-11-13,2021-11-14,,Groceries - Supermarket,174.53,0.00,2176567.92
4658,2021-11-14,2021-11-14,,Daily Essentials,10.69,0.00,2176557.23
4659,2021-11-15,2021-11-15,,Transfer Received,0.00,2362.81,2178920.04
4660,2021-11-15,2021-11-15,,Loan EMI,654.89,0.00,2178265.15
4661,2021-11-16,2021-11-15,,Online Transfer,1044.08,0.00,2177221.07
4662,2021-11-14,2021-11-15,,Utility Payment,197.90,0.00,2177023.17
4663,2021-11-15,2021-11-15,,Interest Credited,0.00,66.10,2177089.27
4664,2021-11-15,2021-11-15,,Dining Out,51.31,0.00,2177037.96
4665,2021-11-15,2021-11-15,,Credit Card Payment,426.53,0.00,2176611.43
4666,2021-11-17,2021-11-16,,Loan EMI,1333.82,0.00,2175277.61
4667,2021-11-16,2021-11-16,,ATM Withdrawal,404.16,0.00,2174873.45
4668,2021-11-16,2021-11-16,,Online Transfer,441.26,0.00,2174432.19
4669,2021-11-16,2021-11-16,,Utility Payment,112.01,0.00,2174320.18
4670,2021-11-17,2021-11-16,,Investment - Mutual Funds,1326.71,0.00,2172993.47
4671,2021-11-16,2021-11-16,,Utility Payment,98.88,0.00,2172894.59
4672,2021-11-15,2021-11-16,100108,Cheque Issued,761.35,0.00,2172133.24
4673,2021-11-17,2021-11-16,,Transfer Received,0.00,528.33,2172661.57
4674,2021-11-16,2021-11-16,,Investment - SIP,670.82,0.00,2171990.75
4675,2021-11-16,2021-11-16,,Interest Credited,0.00,90.44,2172081.19
4676,2021-11-17,2021-11-16,,Groceries - Supermarket,180.49,0.00,2171900.70
4677,2021-11-17,2021-11-17,,Investment - Stocks,1868.75,0.00,2170031.95
4678,2021-11-18,2021-11-17,100109,Cheque Issued,2012.53,0.00,2168019.42
4679,2021-11-16,2021-11-17,,Dining Out,49.96,0.00,2167969.46
4680,2021-11-17,2021-11-17,,Groceries - Supermarket,48.71,0.00,2167920.75
4681,2021-11-17,2021-11-17,,Credit Card Payment,393.20,0.00,2167527.55
4682,2021-11-17,2021-11-17,,Cash Deposit,0.00,240.10,2167767.65
4683,2021-11-17,2021-11-17,,Salary Credit,0.00,4896.63,2172664.28
4684,2021-11-17,2021-11-18,,Rental Income,0.00,2425.64,2175089.92
4685,2021-11-18,2021-11-18,,Investment - Stocks,4433.55,0.00,2170656.37
4686,2021-11-18,2021-11-18,,Daily Essentials,5.46,0.00,2170650.91
4687,2021-11-18,2021-11-18,,Transfer Received,0.00,1768.97,2172419.88
4688,2021-11-19,2021-11-18,,Interest Credited,0.00,19.36,2172439.24
4689,2021-11-19,2021-11-19,,Online Transfer,204.51,0.00,2172234.73
4690,2021-11-19,2021-11-19,,Utility Payment,143.53,0.00,2172091.20
4691,2021-11-20,2021-11-19,,Cash Deposit,0.00,879.84,2172971.04
4692,2021-11-19,2021-11-19,,Dining Out,14.43,0.00,2172956.61
4693,2021-11-19,2021-11-19,,Loan EMI,915.35,0.00,2172041.26
4694,2021-11-19,2021-11-19,,Groceries - Supermarket,33.68,0.00,2172007.58
4695,2021-11-20,2021-11-20,,Groceries - Supermarket,134.13,0.00,2171873.45
4696,2021-11-20,2021-11-20,,Transfer Received,0.00,1777.07,2173650.52
4697,2021-11-20,2021-11-20,,Interest Credited,0.00,16.43,2173666.95
4698,2021-11-20,2021-11-20,,Transfer Received,0.00,1737.21,2175404.16
4699,2021-11-21,2021-11-20,,Interest Credited,0.00,66.34,2175470.50
4700,2021-11-20,2021-11-20,,Transfer Received,0.00,2793.77,2178264.27
4701,2021-11-20,2021-11-20,,Transfer Received,0.00,606.24,2178870.51
4702,2021-11-21,2021-11-21,,ATM Withdrawal,340.87,0.00,2178529.64
4703,2021-11-21,2021-11-21,,Online Transfer,1344.63,0.00,2177185.01
4704,2021-11-21,2021-11-21,,ATM Withdrawal,417.60,0.00,2176767.41
4705,2021-11-21,2021-11-21,,Investment - Mutual Funds,1462.87,0.00,2175304.54
4706,2021-11-22,2021-11-21,,Groceries - Online Delivery,146.61,0.00,2175157.93
4707,2021-11-21,2021-11-21,,Loan EMI,1698.59,0.00,2173459.34
4708,2021-11-20,2021-11-21,,Interest Credited,0.00,31.53,2173490.87
4709,2021-11-21,2021-11-21,,Transfer Received,0.00,2378.77,2175869.64
4710,2021-11-22,2021-11-22,,Groceries - Online Delivery,102.31,0.00,2175767.33
4711,2021-11-22,2021-11-22,,Dining Out,65.07,0.00,2175702.26
4712,2021-11-22,2021-11-22,,Daily Essentials,20.38,0.00,2175681.88
4713,2021-11-22,2021-11-22,,Credit Card Payment,295.93,0.00,2175385.95
4714,2021-11-22,2021-11-22,,Investment - Mutual Funds,2724.73,0.00,2172661.22
4715,2021-11-22,2021-11-22,,Dining Out,71.59,0.00,2172589.63
4716,2021-11-23,2021-11-23,,Online Transfer,1246.52,0.00,2171343.11
4717,2021-11-23,2021-11-23,,Salary Credit,0.00,4297.25,2175640.36
4718,2021-11-23,2021-11-23,,Interest Credited,0.00,51.59,2175691.95
4719,2021-11-24,2021-11-24,,Salary Credit,0.00,4038.84,2179730.79
4720,2021-11-24,2021-11-24,,ATM Withdrawal,82.61,0.00,2179648.18
4721,2021-11-24,2021-11-24,,Investment - SIP,384.25,0.00,2179263.93
4722,2021-11-24,2021-11-24,,Groceries - Online Delivery,74.93,0.00,2179189.00
4723,2021-11-24,2021-11-24,,Online Transfer,556.76,0.00,2178632.24
4724,2021-11-24,2021-11-24,,Transfer Received,0.00,1862.16,2180494.40
4725,2021-11-24,2021-11-24,,Transfer Received,0.00,2612.82,2183107.22
4726,2021-11-24,2021-11-24,,Takeout,24.70,0.00,2183082.52
4727,2021-11-24,2021-11-24,,ATM Withdrawal,79.25,0.00,2183003.27
4728,2021-11-23,2021-11-24,,Utility Payment,246.97,0.00,2182756.30
4729,2021-11-23,2021-11-24,,Groceries - Supermarket,38.31,0.00,2182717.99
4730,2021-11-24,2021-11-24,,Daily Essentials,48.63,0.00,2182669.36
4731,2021-11-25,2021-11-24,,Salary Credit,0.00,2270.87,2184940.23
4732,2021-11-23,2021-11-24,,Utility Payment,239.15,0.00,2184701.08
4733,2021-11-25,2021-11-25,,Transfer Received,0.00,2598.07,2187299.15
4734,2021-11-24,2021-11-25,,Online Transfer,1534.41,0.00,2185764.74
4735,2021-11-25,2021-11-25,,Daily Essentials,21.15,0.00,2185743.59
4736,2021-11-26,2021-11-25,,Credit Card Payment,845.10,0.00,2184898.49
4737,2021-11-25,2021-11-25,,ATM Withdrawal,259.16,0.00,2184639.33
4738,2021-11-25,2021-11-25,,Transfer Received,0.00,2333.90,2186973.23
4739,2021-11-24,2021-11-25,,Coffee Shop,17.28,0.00,2186955.95
4740,2021-11-26,2021-11-25,,Online Transfer,1117.22,0.00,2185838.73
4741,2021-11-26,2021-11-26,,Groceries - Supermarket,56.24,0.00,2185782.49
4742,2021-11-27,2021-11-27,,Investment - Mutual Funds,1354.89,0.00,2184427.60
4743,2021-11-27,2021-11-27,,Groceries - Supermarket,83.52,0.00,2184344.08
4744,2021-11-26,2021-11-27,,Online Transfer,1031.53,0.00,2183312.55
4745,2021-11-26,2021-11-27,,Interest Credited,0.00,68.25,2183380.80
4746,2021-11-26,2021-11-27,,Online Transfer,1328.79,0.00,2182052.01
4747,2021-11-29,2021-11-28,,Transfer Received,0.00,1716.46,2183768.47
4748,2021-11-29,2021-11-28,,Dining Out,40.43,0.00,2183728.04
4749,2021-11-28,2021-11-28,,Takeout,44.09,0.00,2183683.95
4750,2021-11-30,2021-11-29,,Daily Essentials,44.54,0.00,2183639.41
4751,2021-11-29,2021-11-29,,Transfer Received,0.00,1195.76,2184835.17
4752,2021-11-29,2021-11-29,,Salary Credit,0.00,4275.15,2189110.32
4753,2021-11-29,2021-11-29,,Salary Credit,0.00,4737.59,2193847.91
4754,2021-11-30,2021-11-30,,Transfer Received,0.00,740.17,2194588.08
4755,2021-11-30,2021-11-30,,Credit Card Payment,473.14,0.00,2194114.94
4756,2021-11-29,2021-11-30,,Utility Payment,151.51,0.00,2193963.43
4757,2021-11-30,2021-11-30,,Groceries - Supermarket,145.61,0.00,2193817.82
4758,2021-11-30,2021-11-30,,Interest Credited,0.00,67.74,2193885.56
4759,2021-12-01,2021-12-01,,Salary Credit,0.00,3896.84,2197782.40
4760,2021-12-02,2021-12-01,,Transfer Received,0.00,1870.32,2199652.72
4761,2021-12-02,2021-12-01,,Dining Out,13.84,0.00,2199638.88
4762,2021-12-01,2021-12-01,,Credit Card Payment,571.83,0.00,2199067.05
4763,2021-12-01,2021-12-01,,Transfer Received,0.00,2106.50,2201173.55
4764,2021-12-01,2021-12-01,,Online Transfer,224.25,0.00,2200949.30
4765,2021-12-01,2021-12-01,,Takeout,16.64,0.00,2200932.66
4766,2021-12-01,2021-12-01,,Dining Out,17.02,0.00,2200915.64
4767,2021-12-01,2021-12-02,,Groceries - Online Delivery,52.91,0.00,2200862.73
4768,2021-12-02,2021-12-02,,Transfer Received,0.00,2387.79,2203250.52
4769,2021-12-01,2021-12-02,,ATM Withdrawal,409.99,0.00,2202840.53
4770,2021-12-01,2021-12-02,,Transfer Received,0.00,2816.41,2205656.94
4771,2021-12-03,2021-12-02,,Transfer Received,0.00,2674.14,2208331.08
4772,2021-12-02,2021-12-02,,Salary Credit,0.00,3408.98,2211740.06
4773,2021-12-02,2021-12-02,,Salary Credit,0.00,4981.26,2216721.32
4774,2021-12-03,2021-12-02,,Loan EMI,1700.81,0.00,2215020.51
4775,2021-12-03,2021-12-03,,ATM Withdrawal,373.11,0.00,2214647.40
4776,2021-12-02,2021-12-03,,Salary Credit,0.00,3594.46,2218241.86
4777,2021-12-03,2021-12-03,,Rental Income,0.00,1649.18,2219891.04
4778,2021-12-03,2021-12-03,,Transfer Received,0.00,845.91,2220736.95
4779,2021-12-05,2021-12-04,,Transfer Received,0.00,1091.03,2221827.98
4780,2021-12-05,2021-12-04,,Transfer Received,0.00,2853.70,2224681.68
4781,2021-12-04,2021-12-04,,Groceries - Supermarket,105.67,0.00,2224576.01
4782,2021-12-04,2021-12-04,,Interest Credited,0.00,15.42,2224591.43
4783,2021-12-04,2021-12-04,,Loan EMI,1020.16,0.00,2223571.27
4784,2021-12-04,2021-12-04,,Interest Credited,0.00,73.94,2223645.21
4785,2021-12-04,2021-12-05,,Transfer Received,0.00,2342.09,2225987.30
4786,2021-12-05,2021-12-05,,Credit Card Payment,741.03,0.00,2225246.27
4787,2021-12-06,2021-12-05,,Groceries - Online Delivery,136.15,0.00,2225110.12
4788,2021-12-05,2021-12-05,,Salary Credit,0.00,3563.68,2228673.80
4789,2021-12-04,2021-12-05,,Transfer Received,0.00,1822.07,2230495.87
4790,2021-12-06,2021-12-05,,Salary Credit,0.00,2954.94,2233450.81
4791,2021-12-06,2021-12-06,,Transfer Received,0.00,2507.04,2235957.85
4792,2021-12-06,2021-12-06,,Credit Card Payment,254.74,0.00,2235703.11
4793,2021-12-05,2021-12-06,100110,Cheque Issued,903.65,0.00,2234799.46
4794,2021-12-06,2021-12-06,,Credit Card Payment,549.37,0.00,2234250.09
4795,2021-12-06,2021-12-06,,Transfer Received,0.00,2364.33,2236614.42
4796,2021-12-06,2021-12-06,,Transfer Received,0.00,2852.19,2239466.61
4797,2021-12-06,2021-12-06,,Takeout,13.13,0.00,2239453.48
4798,2021-12-06,2021-12-06,,Investment Returns,0.00,710.44,2240163.92
4799,2021-12-07,2021-12-07,,Salary Credit,0.00,4314.96,2244478.88
4800,2021-12-07,2021-12-07,,Dividend Received,0.00,463.42,2244942.30
4801,2021-12-07,2021-12-07,,Transfer Received,0.00,2236.05,2247178.35
4802,2021-12-07,2021-12-07,,Interest Credited,0.00,57.69,2247236.04
4803,2021-12-07,2021-12-07,,Groceries - Supermarket,45.74,0.00,2247190.30
4804,2021-12-06,2021-12-07,,Online Transfer,727.51,0.00,2246462.79
4805,2021-12-08,2021-12-07,,Groceries - Online Delivery,102.58,0.00,2246360.21
4806,2021-12-06,2021-12-07,,Online Transfer,533.25,0.00,2245826.96
4807,2021-12-07,2021-12-07,,Utility Payment,235.06,0.00,2245591.90
4808,2021-12-08,2021-12-08,,Credit Card Payment,849.29,0.00,2244742.61
4809,2021-12-09,2021-12-08,,Dining Out,86.55,0.00,2244656.06
4810,2021-12-09,2021-12-08,,Credit Card Payment,560.28,0.00,2244095.78
4811,2021-12-09,2021-12-09,,ATM Withdrawal,189.29,0.00,2243906.49
4812,2021-12-09,2021-12-09,,Utility Payment,190.59,0.00,2243715.90
4813,2021-12-09,2021-12-09,100111,Cheque Issued,1594.25,0.00,2242121.65
4814,2021-12-09,2021-12-09,,Transfer Received,0.00,614.08,2242735.73
4815,2021-12-09,2021-12-09,,Transfer Received,0.00,2835.89,2245571.62
4816,2021-12-09,2021-12-09,,Salary Credit,0.00,4453.54,2250025.16
4817,2021-12-09,2021-12-09,,Credit Card Payment,631.37,0.00,2249393.79
4818,2021-12-08,2021-12-09,,Transfer Received,0.00,1887.86,2251281.65
4819,2021-12-09,2021-12-09,,Groceries - Supermarket,44.66,0.00,2251236.99
4820,2021-12-09,2021-12-10,,Credit Card Payment,811.44,0.00,2250425.55
4821,2021-12-10,2021-12-10,,Rental Income,0.00,2659.03,2253084.58
4822,2021-12-11,2021-12-10,,Transfer Received,0.00,2024.56,2255109.14
4823,2021-12-11,2021-12-10,,Salary Credit,0.00,3202.68,2258311.82
4824,2021-12-10,2021-12-10,,Online Transfer,1468.96,0.00,2256842.86
4825,2021-12-11,2021-12-10,,Rental Income,0.00,1723.79,2258566.65
4826,2021-12-10,2021-12-10,,Salary Credit,0.00,2771.35,2261338.00
4827,2021-12-11,2021-12-10,,Transfer Received,0.00,532.23,2261870.23
4828,2021-12-10,2021-12-10,,Investment - Mutual Funds,2232.08,0.00,2259638.15
4829,2021-12-10,2021-12-10,,Salary Credit,0.00,2860.80,2262498.95
4830,2021-12-11,2021-12-10,,Salary Credit,0.00,4273.44,2266772.39
4831,2021-12-11,2021-12-10,,Transfer Received,0.00,1323.80,2268096.19
4832,2021-12-11,2021-12-11,,Cash Deposit,0.00,393.68,2268489.87
4833,2021-12-11,2021-12-11,,Online Transfer,889.51,0.00,2267600.36
4834,2021-12-11,2021-12-11,,Salary Credit,0.00,2341.40,2269941.76
4835,2021-12-10,2021-12-11,,Daily Essentials,9.02,0.00,2269932.74
4836,2021-12-11,2021-12-11,,Online Transfer,1224.89,0.00,2268707.85
4837,2021-12-12,2021-12-11,,Transfer Received,0.00,2119.55,2270827.40
4838,2021-12-10,2021-12-11,,ATM Withdrawal,147.76,0.00,2270679.64
4839,2021-12-11,2021-12-11,,Groceries - Supermarket,57.36,0.00,2270622.28
4840,2021-12-11,2021-12-11,,ATM Withdrawal,264.17,0.00,2270358.11
4841,2021-12-11,2021-12-11,,Salary Credit,0.00,4486.69,2274844.80
4842,2021-12-12,2021-12-12,,Transfer Received,0.00,1508.75,2276353.55
4843,2021-12-12,2021-12-12,,ATM Withdrawal,319.92,0.00,2276033.63
4844,2021-12-11,2021-12-12,,Transfer Received,0.00,1090.91,2277124.54
4845,2021-12-12,2021-12-12,,ATM Withdrawal,332.07,0.00,2276792.47
4846,2021-12-12,2021-12-12,,Online Transfer,1509.39,0.00,2275283.08
4847,2021-12-12,2021-12-12,100112,Cheque Issued,1998.23,0.00,2273284.85
4848,2021-12-13,2021-12-13,,Dining Out,90.54,0.00,2273194.31
4849,2021-12-12,2021-12-13,,Credit Card Payment,511.25,0.00,2272683.06
4850,2021-12-12,2021-12-13,,Transfer Received,0.00,1421.75,2274104.81
4851,2021-12-12,2021-12-13,,ATM Withdrawal,381.47,0.00,2273723.34
4852,2021-12-14,2021-12-14,,ATM Withdrawal,60.81,0.00,2273662.53
4853,2021-12-14,2021-12-14,,Groceries - Supermarket,166.45,0.00,2273496.08
4854,2021-12-15,2021-12-14,,Salary Credit,0.00,3351.15,2276847.23
4855,2021-12-15,2021-12-14,,ATM Withdrawal,54.21,0.00,2276793.02
4856,2021-12-15,2021-12-14,,Salary Credit,0.00,3382.57,2280175.59
4857,2021-12-15,2021-12-14,,Online Transfer,905.13,0.00,2279270.46
4858,2021-12-14,2021-12-14,,Cash Deposit,0.00,934.96,2280205.42
4859,2021-12-13,2021-12-14,,Salary Credit,0.00,4504.04,2284709.46
4860,2021-12-13,2021-12-14,,Interest Credited,0.00,29.71,2284739.17
4861,2021-12-15,2021-12-15,,Interest Credited,0.00,51.82,2284790.99
4862,2021-12-15,2021-12-15,,Utility Payment,144.51,0.00,2284646.48
4863,2021-12-15,2021-12-15,,Utility Payment,171.29,0.00,2284475.19
4864,2021-12-14,2021-12-15,,Utility Payment,214.15,0.00,2284261.04
4865,2021-12-15,2021-12-15,,Salary Credit,0.00,2500.85,2286761.89
4866,2021-12-14,2021-12-15,,Utility Payment,273.87,0.00,2286488.02
4867,2021-12-16,2021-12-15,,Online Transfer,1343.75,0.00,2285144.27
4868,2021-12-15,2021-12-15,,ATM Withdrawal,395.85,0.00,2284748.42
4869,2021-12-16,2021-12-16,,Dining Out,71.59,0.00,2284676.83
4870,2021-12-15,2021-12-16,,Interest Credited,0.00,41.54,2284718.37
4871,2021-12-16,2021-12-16,,Online Transfer,1796.20,0.00,2282922.17
4872,2021-12-16,2021-12-16,,Groceries - Supermarket,96.90,0.00,2282825.27
4873,2021-12-17,2021-12-16,,Credit Card Payment,235.04,0.00,2282590.23
4874,2021-12-16,2021-12-16,,Interest Credited,0.00,58.48,2282648.71
4875,2021-12-16,2021-12-16,,Transfer Received,0.00,2576.93,2285225.64
4876,2021-12-16,2021-12-17,,Credit Card Payment,880.47,0.00,2284345.17
4877,2021-12-16,2021-12-17,,ATM Withdrawal,379.95,0.00,2283965.22
4878,2021-12-17,2021-12-17,,Loan EMI,1544.49,0.00,2282420.73
4879,2021-12-17,2021-12-17,,Salary Credit,0.00,3738.56,2286159.29
4880,2021-12-17,2021-12-17,,Transfer Received,0.00,1688.66,2287847.95
4881,2021-12-17,2021-12-17,,ATM Withdrawal,102.47,0.00,2287745.48
4882,2021-12-18,2021-12-18,,Interest Credited,0.00,47.40,2287792.88
4883,2021-12-18,2021-12-18,,Utility Payment,261.95,0.00,2287530.93
4884,2021-12-18,2021-12-18,,Utility Payment,239.89,0.00,2287291.04
4885,2021-12-17,2021-12-18,,Groceries - Online Delivery,138.66,0.00,2287152.38
4886,2021-12-18,2021-12-18,,Credit Card Payment,532.05,0.00,2286620.33
4887,2021-12-17,2021-12-18,,Utility Payment,183.97,0.00,2286436.36
4888,2021-12-19,2021-12-18,,Online Transfer,400.97,0.00,2286035.39
4889,2021-12-19,2021-12-19,,Utility Payment,165.29,0.00,2285870.10
4890,2021-12-19,2021-12-19,,ATM Withdrawal,132.97,0.00,2285737.13
4891,2021-12-18,2021-12-19,,Utility Payment,290.30,0.00,2285446.83
4892,2021-12-19,2021-12-19,,Groceries - Supermarket,102.03,0.00,2285344.80
4893,2021-12-19,2021-12-19,,Salary Credit,0.00,3313.65,2288658.45
4894,2021-12-18,2021-12-19,,Interest Credited,0.00,95.87,2288754.32
4895,2021-12-19,2021-12-19,,Transfer Received,0.00,812.94,2289567.26
4896,2021-12-20,2021-12-20,,Utility Payment,116.59,0.00,2289450.67
4897,2021-12-21,2021-12-20,,Online Transfer,116.91,0.00,2289333.76
4898,2021-12-20,2021-12-20,,ATM Withdrawal,236.32,0.00,2289097.44
4899,2021-12-20,2021-12-20,,Groceries - Online Delivery,106.17,0.00,2288991.27
4900,2021-12-20,2021-12-20,,Online Transfer,1894.54,0.00,2287096.73
4901,2021-12-21,2021-12-20,,Groceries - Supermarket,59.76,0.00,2287036.97
4902,2021-12-20,2021-12-21,,Utility Payment,255.55,0.00,2286781.42
4903,2021-12-21,2021-12-21,,ATM Withdrawal,412.39,0.00,2286369.03
4904,2021-12-21,2021-12-21,,Transfer Received,0.00,2977.89,2289346.92
4905,2021-12-21,2021-12-21,,ATM Withdrawal,140.58,0.00,2289206.34
4906,2021-12-21,2021-12-21,,Interest Credited,0.00,73.31,2289279.65
4907,2021-12-21,2021-12-21,,Credit Card Payment,974.03,0.00,2288305.62
4908,2021-12-20,2021-12-21,,Groceries - Supermarket,139.75,0.00,2288165.87
4909,2021-12-21,2021-12-22,,Online Transfer,339.76,0.00,2287826.11
4910,2021-12-22,2021-12-22,,Salary Credit,0.00,3732.52,2291558.63
4911,2021-12-23,2021-12-22,,ATM Withdrawal,163.79,0.00,2291394.84
4912,2021-12-23,2021-12-22,,Transfer Received,0.00,604.60,2291999.44
4913,2021-12-22,2021-12-22,,Loan EMI,1251.54,0.00,2290747.90
4914,2021-12-22,2021-12-22,,Transfer Received,0.00,1874.63,2292622.53
4915,2021-12-22,2021-12-22,,Transfer Received,0.00,2474.40,2295096.93
4916,2021-12-23,2021-12-23,,Salary Credit,0.00,3186.17,2298283.10
4917,2021-12-22,2021-12-23,,Transfer Received,0.00,886.67,2299169.77
4918,2021-12-24,2021-12-23,,Online Transfer,922.54,0.00,2298247.23
4919,2021-12-24,2021-12-23,,Rental Income,0.00,1346.69,2299593.92
4920,2021-12-23,2021-12-23,,Online Transfer,1631.69,0.00,2297962.23
4921,2021-12-23,2021-12-23,,Transfer Received,0.00,2327.32,2300289.55
4922,2021-12-22,2021-12-23,,Investment - Mutual Funds,588.10,0.00,2299701.45
4923,2021-12-24,2021-12-23,,Online Transfer,1646.20,0.00,2298055.25
4924,2021-12-23,2021-12-23,,Groceries - Supermarket,145.87,0.00,2297909.38
4925,2021-12-23,2021-12-23,,Dividend Received,0.00,469.25,2298378.63
4926,2021-12-24,2021-12-24,,Cash Deposit,0.00,719.38,2299098.01
4927,2021-12-24,2021-12-24,,Salary Credit,0.00,4132.52,2303230.53
4928,2021-12-23,2021-12-24,,Utility Payment,91.25,0.00,2303139.28
4929,2021-12-24,2021-12-24,,Transfer Received,0.00,1732.15,2304871.43
4930,2021-12-24,2021-12-24,,ATM Withdrawal,377.17,0.00,2304494.26
4931,2021-12-25,2021-12-24,,Transfer Received,0.00,1607.63,2306101.89
4932,2021-12-25,2021-12-25,,Groceries - Supermarket,80.06,0.00,2306021.83
4933,2021-12-25,2021-12-25,,Credit Card Payment,851.26,0.00,2305170.57
4934,2021-12-25,2021-12-25,,Transfer Received,0.00,1653.85,2306824.42
4935,2021-12-26,2021-12-25,,Transfer Received,0.00,1346.95,2308171.37
4936,2021-12-26,2021-12-25,,Online Transfer,171.36,0.00,2308000.01
4937,2021-12-26,2021-12-26,,Utility Payment,211.53,0.00,2307788.48
4938,2021-12-27,2021-12-26,,Transfer Received,0.00,795.78,2308584.26
4939,2021-12-27,2021-12-27,,Utility Payment,70.76,0.00,2308513.50
4940,2021-12-27,2021-12-27,,Online Transfer,1518.24,0.00,2306995.26
4941,2021-12-27,2021-12-27,,Loan EMI,769.95,0.00,2306225.31
4942,2021-12-27,2021-12-27,,Rental Income,0.00,2789.78,2309015.09
4943,2021-12-27,2021-12-27,,Daily Essentials,15.47,0.00,2308999.62
4944,2021-12-26,2021-12-27,,ATM Withdrawal,44.02,0.00,2308955.60
4945,2021-12-29,2021-12-28,,Online Transfer,284.84,0.00,2308670.76
4946,2021-12-28,2021-12-28,,Dining Out,24.30,0.00,2308646.46
4947,2021-12-29,2021-12-28,,Salary Credit,0.00,4897.95,2313544.41
4948,2021-12-28,2021-12-28,,Credit Card Payment,832.68,0.00,2312711.73
4949,2021-12-28,2021-12-28,,Salary Credit,0.00,3816.18,2316527.91
4950,2021-12-29,2021-12-29,,Utility Payment,268.26,0.00,2316259.65
4951,2021-12-29,2021-12-29,,Daily Essentials,20.03,0.00,2316239.62
4952,2021-12-29,2021-12-29,,Dining Out,29.18,0.00,2316210.44
4953,2021-12-29,2021-12-29,,ATM Withdrawal,39.02,0.00,2316171.42
4954,2021-12-29,2021-12-29,,Groceries - Supermarket,128.94,0.00,2316042.48
4955,2021-12-31,2021-12-30,,Salary Credit,0.00,3071.49,2319113.97
4956,2021-12-31,2021-12-30,,Transfer Received,0.00,1582.25,2320696.22
4957,2021-12-29,2021-12-30,,Transfer Received,0.00,1503.81,2322200.03
4958,2021-12-30,2021-12-30,,Groceries - Supermarket,158.94,0.00,2322041.09
4959,2021-12-30,2021-12-30,,Transfer Received,0.00,2283.00,2324324.09
4960,2022-01-01,2021-12-31,,Utility Payment,177.93,0.00,2324146.16
4961,2021-12-30,2021-12-31,,Takeout,35.68,0.00,2324110.48
4962,2021-12-31,2021-12-31,,Dining Out,82.78,0.00,2324027.70
4963,2021-12-31,2021-12-31,,Coffee Shop,7.17,0.00,2324020.53
4964,2021-12-31,2021-12-31,,Rental Income,0.00,1495.07,2325515.60
4965,2021-12-31,2021-12-31,,ATM Withdrawal,237.49,0.00,2325278.11
4966,2022-01-01,2022-01-01,,Salary Credit,0.00,2856.20,2328134.31
4967,2022-01-02,2022-01-01,,Online Transfer,254.39,0.00,2327879.92
4968,2022-01-01,2022-01-01,,Transfer Received,0.00,788.47,2328668.39
4969,2022-01-01,2022-01-01,,Dining Out,24.83,0.00,2328643.56
4970,2021-12-31,2022-01-01,,Interest Credited,0.00,92.24,2328735.80
4971,2021-12-31,2022-01-01,,ATM Withdrawal,119.55,0.00,2328616.25
4972,2021-12-31,2022-01-01,,Transfer Received,0.00,2682.63,2331298.88
4973,2022-01-01,2022-01-02,,ATM Withdrawal,337.68,0.00,2330961.20
4974,2022-01-02,2022-01-02,,Investment - Stocks,4704.88,0.00,2326256.32
4975,2022-01-02,2022-01-02,,Salary Credit,0.00,2486.50,2328742.82
4976,2022-01-01,2022-01-02,,Salary Credit,0.00,3416.62,2332159.44
4977,2022-01-02,2022-01-02,,Takeout,25.61,0.00,2332133.83
4978,2022-01-02,2022-01-02,,Groceries - Supermarket,76.97,0.00,2332056.86
4979,2022-01-02,2022-01-02,,Investment - Mutual Funds,2794.18,0.00,2329262.68
4980,2022-01-01,2022-01-02,,Dining Out,32.42,0.00,2329230.26
4981,2022-01-02,2022-01-02,,Takeout,37.15,0.00,2329193.11
4982,2022-01-02,2022-01-02,,Credit Card Payment,844.35,0.00,2328348.76
4983,2022-01-01,2022-01-02,,ATM Withdrawal,322.81,0.00,2328025.95
4984,2022-01-03,2022-01-02,,Dining Out,37.81,0.00,2327988.14
4985,2022-01-01,2022-01-02,,Salary Credit,0.00,2200.52,2330188.66
4986,2022-01-02,2022-01-02,,Groceries - Supermarket,147.33,0.00,2330041.33
4987,2022-01-03,2022-01-03,,ATM Withdrawal,38.31,0.00,2330003.02
4988,2022-01-03,2022-01-03,,Transfer Received,0.00,838.02,2330841.04
4989,2022-01-02,2022-01-03,,Daily Essentials,36.56,0.00,2330804.48
4990,2022-01-03,2022-01-03,,Coffee Shop,5.29,0.00,2330799.19
4991,2022-01-03,2022-01-03,100113,Cheque Issued,1229.73,0.00,2329569.46
4992,2022-01-04,2022-01-04,,Transfer Received,0.00,1455.95,2331025.41
4993,2022-01-04,2022-01-04,,Cash Deposit,0.00,529.91,2331555.32
4994,2022-01-04,2022-01-04,,ATM Withdrawal,294.43,0.00,2331260.89
4995,2022-01-04,2022-01-04,,Transfer Received,0.00,2105.89,2333366.78
4996,2022-01-04,2022-01-04,,Online Transfer,1180.13,0.00,2332186.65
4997,2022-01-04,2022-01-05,,Online Transfer,357.48,0.00,2331829.17
4998,2022-01-05,2022-01-05,,Credit Card Payment,515.78,0.00,2331313.39
4999,2022-01-06,2022-01-05,,Interest Credited,0.00,66.20,2331379.59
5000,2022-01-06,2022-01-05,,Utility Payment,255.03,0.00,2331124.56
5001,2022-01-05,2022-01-05,,Salary Credit,0.00,3672.96,2334797.52
5002,2022-01-06,2022-01-06,,Online Transfer,1528.88,0.00,2333268.64
5003,2022-01-06,2022-01-06,,Salary Credit,0.00,3944.18,2337212.82
5004,2022-01-06,2022-01-06,,Interest Credited,0.00,39.49,2337252.31
5005,2022-01-06,2022-01-06,,Salary Credit,0.00,2789.60,2340041.91
5006,2022-01-06,2022-01-07,,Online Transfer,296.29,0.00,2339745.62
5007,2022-01-07,2022-01-07,,Interest Credited,0.00,59.70,2339805.32
5008,2022-01-07,2022-01-07,,ATM Withdrawal,122.86,0.00,2339682.46
5009,2022-01-06,2022-01-07,,Groceries - Supermarket,75.02,0.00,2339607.44
5010,2022-01-07,2022-01-07,,Groceries - Supermarket,183.30,0.00,2339424.14
5011,2022-01-08,2022-01-07,,Salary Credit,0.00,4960.97,2344385.11
5012,2022-01-08,2022-01-08,,Salary Credit,0.00,3383.27,2347768.38
5013,2022-01-09,2022-01-08,,Salary Credit,0.00,4319.63,2352088.01
5014,2022-01-08,2022-01-08,,ATM Withdrawal,121.44,0.00,2351966.57
5015,2022-01-08,2022-01-08,,ATM Withdrawal,123.56,0.00,2351843.01
5016,2022-01-08,2022-01-08,,Online Transfer,883.65,0.00,2350959.36
5017,2022-01-08,2022-01-08,,Online Transfer,1498.01,0.00,2349461.35
5018,2022-01-08,2022-01-08,,Online Transfer,1236.73,0.00,2348224.62
5019,2022-01-07,2022-01-08,,Groceries - Supermarket,170.19,0.00,2348054.43
5020,2022-01-09,2022-01-09,,Groceries - Supermarket,119.34,0.00,2347935.09
5021,2022-01-09,2022-01-09,,Groceries - Supermarket,95.53,0.00,2347839.56
5022,2022-01-09,2022-01-09,,Utility Payment,296.30,0.00,2347543.26
5023,2022-01-09,2022-01-09,,Transfer Received,0.00,2684.73,2350227.99
5024,2022-01-09,2022-01-09,,Interest Credited,0.00,70.37,2350298.36
5025,2022-01-09,2022-01-09,,Transfer Received,0.00,862.43,2351160.79
5026,2022-01-10,2022-01-09,,Transfer Received,0.00,602.87,2351763.66
5027,2022-01-10,2022-01-10,,Groceries - Supermarket,27.31,0.00,2351736.35
5028,2022-01-10,2022-01-10,100114,Cheque Issued,1635.83,0.00,2350100.52
5029,2022-01-10,2022-01-10,,Groceries - Supermarket,64.96,0.00,2350035.56
5030,2022-01-10,2022-01-10,,Credit Card Payment,987.37,0.00,2349048.19
5031,2022-01-11,2022-01-10,,Investment - Stocks,2219.96,0.00,2346828.23
5032,2022-01-10,2022-01-10,,Groceries - Supermarket,35.01,0.00,2346793.22
5033,2022-01-12,2022-01-11,,Salary Credit,0.00,3254.47,2350047.69
5034,2022-01-11,2022-01-11,,Transfer Received,0.00,2250.71,2352298.40
5035,2022-01-11,2022-01-11,,Investment - SIP,191.75,0.00,2352106.65
5036,2022-01-11,2022-01-11,,Online Transfer,1298.19,0.00,2350808.46
5037,2022-01-13,2022-01-12,100115,Cheque Issued,2595.27,0.00,2348213.19
5038,2022-01-12,2022-01-12,,Groceries - Supermarket,121.46,0.00,2348091.73
5039,2022-01-12,2022-01-12,,Coffee Shop,10.19,0.00,2348081.54
5040,2022-01-13,2022-01-12,,Salary Credit,0.00,2810.70,2350892.24
5041,2022-01-12,2022-01-12,,Interest Credited,0.00,87.22,2350979.46
5042,2022-01-12,2022-01-12,,Salary Credit,0.00,2510.44,2353489.90
5043,2022-01-12,2022-01-12,,Online Transfer,1179.79,0.00,2352310.11
5044,2022-01-13,2022-01-13,,Credit Card Payment,528.08,0.00,2351782.03
5045,2022-01-13,2022-01-13,,Transfer Received,0.00,2204.58,2353986.61
5046,2022-01-13,2022-01-13,,Utility Payment,72.86,0.00,2353913.75
5047,2022-01-14,2022-01-14,,Online Transfer,1147.07,0.00,2352766.68
5048,2022-01-14,2022-01-14,,Interest Credited,0.00,38.09,2352804.77
5049,2022-01-14,2022-01-14,,Online Transfer,821.94,0.00,2351982.83
5050,2022-01-15,2022-01-14,,Investment - Stocks,2470.48,0.00,2349512.35
5051,2022-01-15,2022-01-15,,Cash Deposit,0.00,257.65,2349770.00
5052,2022-01-15,2022-01-15,,Salary Credit,0.00,2983.86,2352753.86
5053,2022-01-16,2022-01-15,,Investment Returns,0.00,162.91,2352916.77
5054,2022-01-15,2022-01-15,,Groceries - Supermarket,23.22,0.00,2352893.55
5055,2022-01-15,2022-01-15,,Transfer Received,0.00,1950.95,2354844.50
5056,2022-01-15,2022-01-15,,Credit Card Payment,882.91,0.00,2353961.59
5057,2022-01-15,2022-01-15,,Utility Payment,59.44,0.00,2353902.15
5058,2022-01-16,2022-01-15,,Salary Credit,0.00,4500.52,2358402.67
5059,2022-01-16,2022-01-16,,Online Transfer,962.54,0.00,2357440.13
5060,2022-01-16,2022-01-16,,Groceries - Supermarket,69.61,0.00,2357370.52
5061,2022-01-16,2022-01-16,,Utility Payment,183.34,0.00,2357187.18
5062,2022-01-17,2022-01-17,,Salary Credit,0.00,4848.36,2362035.54
5063,2022-01-17,2022-01-17,,Groceries - Supermarket,92.56,0.00,2361942.98
5064,2022-01-17,2022-01-17,,Online Transfer,1010.91,0.00,2360932.07
5065,2022-01-17,2022-01-17,,Transfer Received,0.00,2747.80,2363679.87
5066,2022-01-18,2022-01-17,,Transfer Received,0.00,1955.76,2365635.63
5067,2022-01-17,2022-01-17,,Groceries - Supermarket,171.39,0.00,2365464.24
5068,2022-01-19,2022-01-18,,ATM Withdrawal,433.53,0.00,2365030.71
5069,2022-01-18,2022-01-18,100116,Cheque Issued,606.78,0.00,2364423.93
5070,2022-01-18,2022-01-18,,Interest Credited,0.00,56.25,2364480.18
5071,2022-01-17,2022-01-18,,Groceries - Supermarket,29.86,0.00,2364450.32
5072,2022-01-18,2022-01-18,,Utility Payment,107.50,0.00,2364342.82
5073,2022-01-17,2022-01-18,,Utility Payment,183.74,0.00,2364159.08
5074,2022-01-17,2022-01-18,,Groceries - Supermarket,100.02,0.00,2364059.06
5075,2022-01-19,2022-01-18,,Salary Credit,0.00,2966.80,2367025.86
5076,2022-01-19,2022-01-18,,Salary Credit,0.00,4423.46,2371449.32
5077,2022-01-19,2022-01-19,,Salary Credit,0.00,2070.03,2373519.35
5078,2022-01-19,2022-01-19,,Online Transfer,1966.16,0.00,2371553.19
5079,2022-01-19,2022-01-19,,Salary Credit,0.00,2988.52,2374541.71
5080,2022-01-19,2022-01-19,,Credit Card Payment,785.31,0.00,2373756.40
5081,2022-01-20,2022-01-20,,Transfer Received,0.00,1599.61,2375356.01
5082,2022-01-20,2022-01-20,,Utility Payment,171.99,0.00,2375184.02
5083,2022-01-20,2022-01-20,,Online Transfer,1752.48,0.00,2373431.54
5084,2022-01-20,2022-01-20,,Dining Out,43.03,0.00,2373388.51
5085,2022-01-19,2022-01-20,,Online Transfer,875.97,0.00,2372512.54
5086,2022-01-20,2022-01-20,,ATM Withdrawal,430.32,0.00,2372082.22
5087,2022-01-21,2022-01-21,,Transfer Received,0.00,1181.10,2373263.32
5088,2022-01-22,2022-01-21,,Interest Credited,0.00,51.13,2373314.45
5089,2022-01-20,2022-01-21,,Transfer Received,0.00,714.14,2374028.59
5090,2022-01-22,2022-01-22,,Loan EMI,1153.81,0.00,2372874.78
5091,2022-01-22,2022-01-22,100117,Cheque Issued,1693.92,0.00,2371180.86
5092,2022-01-22,2022-01-23,,Takeout,12.58,0.00,2371168.28
5093,2022-01-23,2022-01-23,,Utility Payment,51.65,0.00,2371116.63
5094,2022-01-23,2022-01-23,,Transfer Received,0.00,2777.31,2373893.94
5095,2022-01-23,2022-01-23,,Online Transfer,1512.01,0.00,2372381.93
5096,2022-01-23,2022-01-23,,Groceries - Online Delivery,113.54,0.00,2372268.39
5097,2022-01-23,2022-01-23,,Groceries - Supermarket,54.62,0.00,2372213.77
5098,2022-01-23,2022-01-24,,Cash Deposit,0.00,968.87,2373182.64
5099,2022-01-24,2022-01-24,,Salary Credit,0.00,2357.59,2375540.23
5100,2022-01-23,2022-01-24,,Groceries - Supermarket,54.76,0.00,2375485.47
5101,2022-01-25,2022-01-24,,Dining Out,98.67,0.00,2375386.80
5102,2022-01-24,2022-01-24,,Online Transfer,1974.34,0.00,2373412.46
5103,2022-01-24,2022-01-24,,Salary Credit,0.00,4760.53,2378172.99
5104,2022-01-25,2022-01-24,,Credit Card Payment,553.40,0.00,2377619.59
5105,2022-01-24,2022-01-24,,Groceries - Supermarket,58.32,0.00,2377561.27
5106,2022-01-23,2022-01-24,,Salary Credit,0.00,3766.73,2381328.00
5107,2022-01-24,2022-01-24,,Transfer Received,0.00,2184.87,2383512.87
5108,2022-01-23,2022-01-24,,Groceries - Online Delivery,108.65,0.00,2383404.22
5109,2022-01-25,2022-01-25,,Investment - SIP,984.00,0.00,2382420.22
5110,2022-01-25,2022-01-25,,Dining Out,97.84,0.00,2382322.38
5111,2022-01-25,2022-01-25,,Investment - Mutual Funds,790.46,0.00,2381531.92
5112,2022-01-24,2022-01-25,,Rental Income,0.00,2381.26,2383913.18
5113,2022-01-25,2022-01-25,,ATM Withdrawal,339.75,0.00,2383573.43
5114,2022-01-25,2022-01-25,,Utility Payment,227.64,0.00,2383345.79
5115,2022-01-26,2022-01-26,,ATM Withdrawal,381.48,0.00,2382964.31
5116,2022-01-25,2022-01-26,,Transfer Received,0.00,678.09,2383642.40
5117,2022-01-25,2022-01-26,,Loan EMI,1331.30,0.00,2382311.10
5118,2022-01-27,2022-01-26,,Investment - SIP,225.53,0.00,2382085.57
5119,2022-01-26,2022-01-26,,Salary Credit,0.00,2503.47,2384589.04
5120,2022-01-27,2022-01-26,,Groceries - Supermarket,146.15,0.00,2384442.89
5121,2022-01-26,2022-01-26,,Transfer Received,0.00,1169.66,2385612.55
5122,2022-01-26,2022-01-26,100118,Cheque Issued,1610.03,0.00,2384002.52
5123,2022-01-26,2022-01-26,,Groceries - Online Delivery,118.01,0.00,2383884.51
5124,2022-01-26,2022-01-26,,ATM Withdrawal,225.27,0.00,2383659.24
5125,2022-01-26,2022-01-27,,Interest Credited,0.00,75.23,2383734.47
5126,2022-01-27,2022-01-27,,ATM Withdrawal,338.34,0.00,2383396.13
5127,2022-01-27,2022-01-27,100119,Cheque Issued,2889.81,0.00,2380506.32
5128,2022-01-28,2022-01-27,,ATM Withdrawal,35.56,0.00,2380470.76
5129,2022-01-29,2022-01-28,,Transfer Received,0.00,1799.37,2382270.13
5130,2022-01-28,2022-01-28,,Coffee Shop,8.60,0.00,2382261.53
5131,2022-01-27,2022-01-28,,Salary Credit,0.00,2668.88,2384930.41
5132,2022-01-28,2022-01-28,,Online Transfer,493.78,0.00,2384436.63
5133,2022-01-28,2022-01-28,,Transfer Received,0.00,2550.05,2386986.68
5134,2022-01-28,2022-01-28,,Groceries - Supermarket,35.34,0.00,2386951.34
5135,2022-01-28,2022-01-28,,Dining Out,81.52,0.00,2386869.82
5136,2022-01-28,2022-01-28,,ATM Withdrawal,76.77,0.00,2386793.05
5137,2022-01-28,2022-01-28,,Coffee Shop,9.77,0.00,2386783.28
5138,2022-01-30,2022-01-29,,Transfer Received,0.00,1068.12,2387851.40
5139,2022-01-29,2022-01-29,,Transfer Received,0.00,613.63,2388465.03
5140,2022-01-29,2022-01-29,,ATM Withdrawal,489.91,0.00,2387975.12
5141,2022-01-29,2022-01-29,,Loan EMI,666.95,0.00,2387308.17
5142,2022-01-29,2022-01-29,,Groceries - Online Delivery,56.45,0.00,2387251.72
5143,2022-01-28,2022-01-29,,Utility Payment,53.39,0.00,2387198.33
5144,2022-01-28,2022-01-29,,ATM Withdrawal,460.27,0.00,2386738.06
5145,2022-01-28,2022-01-29,100120,Cheque Issued,1172.70,0.00,2385565.36
5146,2022-01-29,2022-01-29,100121,Cheque Issued,765.94,0.00,2384799.42
5147,2022-01-30,2022-01-30,,Salary Credit,0.00,2614.57,2387413.99
5148,2022-01-30,2022-01-30,,Investment Returns,0.00,248.63,2387662.62
5149,2022-01-30,2022-01-30,,Groceries - Supermarket,145.03,0.00,2387517.59
5150,2022-01-31,2022-01-30,,Dining Out,67.83,0.00,2387449.76
5151,2022-01-30,2022-01-30,,ATM Withdrawal,45.17,0.00,2387404.59
5152,2022-01-30,2022-01-30,100122,Cheque Issued,1032.17,0.00,2386372.42
5153,2022-01-31,2022-01-31,,Dividend Received,0.00,77.18,2386449.60
5154,2022-01-31,2022-01-31,,Groceries - Supermarket,66.69,0.00,2386382.91
5155,2022-01-31,2022-01-31,,Salary Credit,0.00,2119.11,2388502.02
5156,2022-01-31,2022-01-31,,Investment - Mutual Funds,2190.61,0.00,2386311.41
5157,2022-01-31,2022-01-31,100123,Cheque Issued,2199.61,0.00,2384111.80
5158,2022-01-31,2022-01-31,,ATM Withdrawal,135.52,0.00,2383976.28
5159,2022-01-31,2022-01-31,,Utility Payment,113.58,0.00,2383862.70
5160,2022-01-31,2022-01-31,,Transfer Received,0.00,2653.36,2386516.06
5161,2022-01-31,2022-01-31,,Investment - Mutual Funds,316.74,0.00,2386199.32
5162,2022-01-31,2022-01-31,,Dividend Received,0.00,205.21,2386404.53
5163,2022-01-31,2022-02-01,,ATM Withdrawal,308.72,0.00,2386095.81
5164,2022-02-01,2022-02-01,,Groceries - Supermarket,94.27,0.00,2386001.54
5165,2022-02-02,2022-02-01,,Interest Credited,0.00,55.92,2386057.46
5166,2022-02-01,2022-02-01,,Credit Card Payment,499.93,0.00,2385557.53
5167,2022-02-01,2022-02-01,,Groceries - Online Delivery,52.78,0.00,2385504.75
5168,2022-02-01,2022-02-01,,Loan EMI,1387.95,0.00,2384116.80
5169,2022-02-01,2022-02-01,,Salary Credit,0.00,2812.43,2386929.23
5170,2022-02-02,2022-02-02,,Salary Credit,0.00,4223.30,2391152.53
5171,2022-02-02,2022-02-02,,Online Transfer,1598.96,0.00,2389553.57
5172,2022-02-02,2022-02-02,100124,Cheque Issued,540.49,0.00,2389013.08
5173,2022-02-01,2022-02-02,,Groceries - Online Delivery,75.31,0.00,2388937.77
5174,2022-02-02,2022-02-02,,Online Transfer,1479.83,0.00,2387457.94
5175,2022-02-03,2022-02-02,,Groceries - Supermarket,117.79,0.00,2387340.15
5176,2022-02-03,2022-02-03,,Online Transfer,787.50,0.00,2386552.65
5177,2022-02-03,2022-02-03,,ATM Withdrawal,486.83,0.00,2386065.82
5178,2022-02-03,2022-02-03,,Groceries - Supermarket,192.99,0.00,2385872.83
5179,2022-02-03,2022-02-03,,Utility Payment,96.14,0.00,2385776.69
5180,2022-02-03,2022-02-03,,Transfer Received,0.00,2989.22,2388765.91
5181,2022-02-03,2022-02-03,,Transfer Received,0.00,671.75,2389437.66
5182,2022-02-02,2022-02-03,,Credit Card Payment,216.44,0.00,2389221.22
5183,2022-02-03,2022-02-04,,Rental Income,0.00,1480.82,2390702.04
5184,2022-02-04,2022-02-04,,Dividend Received,0.00,404.73,2391106.77
5185,2022-02-03,2022-02-04,,ATM Withdrawal,235.58,0.00,2390871.19
5186,2022-02-05,2022-02-04,,Rental Income,0.00,1762.04,2392633.23
5187,2022-02-04,2022-02-04,,Loan EMI,1812.82,0.00,2390820.41
5188,2022-02-04,2022-02-04,,Salary Credit,0.00,3937.83,2394758.24
5189,2022-02-05,2022-02-04,,ATM Withdrawal,271.31,0.00,2394486.93
5190,2022-02-04,2022-02-05,,Groceries - Supermarket,115.65,0.00,2394371.28
5191,2022-02-06,2022-02-05,,Groceries - Supermarket,21.99,0.00,2394349.29
5192,2022-02-05,2022-02-05,,Credit Card Payment,352.18,0.00,2393997.11
5193,2022-02-05,2022-02-05,,Takeout,43.19,0.00,2393953.92
5194,2022-02-05,2022-02-05,,ATM Withdrawal,381.13,0.00,2393572.79
5195,2022-02-06,2022-02-06,,Online Transfer,891.32,0.00,2392681.47
5196,2022-02-06,2022-02-06,,Investment - SIP,421.05,0.00,2392260.42
5197,2022-02-06,2022-02-06,,Transfer Received,0.00,1219.99,2393480.41
5198,2022-02-06,2022-02-06,,Salary Credit,0.00,2985.25,2396465.66
5199,2022-02-06,2022-02-06,,Salary Credit,0.00,4663.80,2401129.46
5200,2022-02-06,2022-02-06,,Coffee Shop,19.22,0.00,2401110.24
5201,2022-02-06,2022-02-06,,Salary Credit,0.00,4922.46,2406032.70
5202,2022-02-08,2022-02-07,,Groceries - Supermarket,43.92,0.00,2405988.78
5203,2022-02-06,2022-02-07,,Cash Deposit,0.00,650.28,2406639.06
5204,2022-02-07,2022-02-07,,Credit Card Payment,864.27,0.00,2405774.79
5205,2022-02-07,2022-02-07,,Daily Essentials,34.04,0.00,2405740.75
5206,2022-02-07,2022-02-07,,Interest Credited,0.00,84.06,2405824.81
5207,2022-02-07,2022-02-07,,Interest Credited,0.00,51.34,2405876.15
5208,2022-02-08,2022-02-08,,Groceries - Supermarket,83.43,0.00,2405792.72
5209,2022-02-08,2022-02-08,,Utility Payment,140.06,0.00,2405652.66
5210,2022-02-09,2022-02-08,,Online Transfer,337.92,0.00,2405314.74
5211,2022-02-07,2022-02-08,,Investment - SIP,406.37,0.00,2404908.37
5212,2022-02-08,2022-02-08,,Utility Payment,99.86,0.00,2404808.51
5213,2022-02-09,2022-02-08,,Credit Card Payment,894.33,0.00,2403914.18
5214,2022-02-07,2022-02-08,,Utility Payment,231.79,0.00,2403682.39
5215,2022-02-09,2022-02-09,,Groceries - Supermarket,159.52,0.00,2403522.87
5216,2022-02-10,2022-02-09,,Transfer Received,0.00,1607.71,2405130.58
5217,2022-02-09,2022-02-09,,Loan EMI,1339.34,0.00,2403791.24
5218,2022-02-08,2022-02-09,,Transfer Received,0.00,2469.12,2406260.36
5219,2022-02-10,2022-02-09,,Dining Out,21.21,0.00,2406239.15
5220,2022-02-10,2022-02-09,,Groceries - Supermarket,133.91,0.00,2406105.24
5221,2022-02-09,2022-02-09,100125,Cheque Issued,2347.15,0.00,2403758.09
5222,2022-02-10,2022-02-09,,Interest Credited,0.00,24.88,2403782.97
5223,2022-02-09,2022-02-09,,Daily Essentials,20.82,0.00,2403762.15
5224,2022-02-10,2022-02-10,,Transfer Received,0.00,2020.53,2405782.68
5225,2022-02-10,2022-02-10,,Salary Credit,0.00,3448.87,2409231.55
5226,2022-02-09,2022-02-10,,Investment Returns,0.00,989.36,2410220.91
5227,2022-02-11,2022-02-11,,ATM Withdrawal,31.79,0.00,2410189.12
5228,2022-02-11,2022-02-11,,Online Transfer,1408.06,0.00,2408781.06
5229,2022-02-11,2022-02-11,,Loan EMI,1729.48,0.00,2407051.58
5230,2022-02-11,2022-02-11,,Transfer Received,0.00,1023.86,2408075.44
5231,2022-02-11,2022-02-11,,Credit Card Payment,766.97,0.00,2407308.47
5232,2022-02-11,2022-02-11,,Loan EMI,1674.62,0.00,2405633.85
5233,2022-02-11,2022-02-11,,Salary Credit,0.00,2713.96,2408347.81
5234,2022-02-12,2022-02-12,,Transfer Received,0.00,1021.57,2409369.38
5235,2022-02-12,2022-02-12,,Salary Credit,0.00,4290.04,2413659.42
5236,2022-02-13,2022-02-12,,Transfer Received,0.00,1634.74,2415294.16
5237,2022-02-13,2022-02-12,,Investment - Stocks,2383.25,0.00,2412910.91
5238,2022-02-12,2022-02-12,,Online Transfer,294.33,0.00,2412616.58
5239,2022-02-11,2022-02-12,,Salary Credit,0.00,2904.80,2415521.38
5240,2022-02-11,2022-02-12,,Investment - SIP,875.15,0.00,2414646.23
5241,2022-02-13,2022-02-13,,ATM Withdrawal,104.95,0.00,2414541.28
5242,2022-02-13,2022-02-13,,Transfer Received,0.00,1830.87,2416372.15
5243,2022-02-13,2022-02-13,,ATM Withdrawal,284.67,0.00,2416087.48
5244,2022-02-13,2022-02-13,,ATM Withdrawal,340.93,0.00,2415746.55
5245,2022-02-13,2022-02-13,,Transfer Received,0.00,1311.53,2417058.08
5246,2022-02-15,2022-02-14,,ATM Withdrawal,449.66,0.00,2416608.42
5247,2022-02-13,2022-02-14,,Rental Income,0.00,2979.47,2419587.89
5248,2022-02-14,2022-02-14,100126,Cheque Issued,937.01,0.00,2418650.88
5249,2022-02-14,2022-02-14,,Transfer Received,0.00,2942.92,2421593.80
5250,2022-02-13,2022-02-14,,Salary Credit,0.00,3329.52,2424923.32
5251,2022-02-15,2022-02-14,,Salary Credit,0.00,2498.16,2427421.48
5252,2022-02-15,2022-02-14,100127,Cheque Issued,1534.04,0.00,2425887.44
5253,2022-02-14,2022-02-14,,Investment - Stocks,2415.63,0.00,2423471.81
5254,2022-02-15,2022-02-14,,Dividend Received,0.00,364.78,2423836.59
5255,2022-02-14,2022-02-14,,Groceries - Supermarket,35.03,0.00,2423801.56
5256,2022-02-14,2022-02-14,,Transfer Received,0.00,2283.69,2426085.25
5257,2022-02-14,2022-02-14,,Utility Payment,191.44,0.00,2425893.81
5258,2022-02-14,2022-02-14,,Salary Credit,0.00,4732.42,2430626.23
5259,2022-02-14,2022-02-15,,Transfer Received,0.00,2927.65,2433553.88
5260,2022-02-14,2022-02-15,,Salary Credit,0.00,4104.12,2437658.00
5261,2022-02-15,2022-02-15,,Transfer Received,0.00,2850.18,2440508.18
5262,2022-02-15,2022-02-15,,Dining Out,94.64,0.00,2440413.54
5263,2022-02-15,2022-02-15,,Coffee Shop,19.10,0.00,2440394.44
5264,2022-02-16,2022-02-16,,Groceries - Supermarket,176.08,0.00,2440218.36
5265,2022-02-17,2022-02-16,,Transfer Received,0.00,1721.77,2441940.13
5266,2022-02-17,2022-02-16,,Transfer Received,0.00,2100.65,2444040.78
5267,2022-02-16,2022-02-16,,Interest Credited,0.00,29.68,2444070.46
5268,2022-02-17,2022-02-16,,Rental Income,0.00,2669.46,2446739.92
5269,2022-02-17,2022-02-16,,Online Transfer,1142.91,0.00,2445597.01
5270,2022-02-16,2022-02-16,,Credit Card Payment,459.80,0.00,2445137.21
5271,2022-02-16,2022-02-16,,Online Transfer,827.52,0.00,2444309.69
5272,2022-02-17,2022-02-17,,ATM Withdrawal,349.55,0.00,2443960.14
5273,2022-02-17,2022-02-17,,Salary Credit,0.00,4710.91,2448671.05
5274,2022-02-17,2022-02-17,,ATM Withdrawal,317.57,0.00,2448353.48
5275,2022-02-17,2022-02-17,,Loan EMI,1792.68,0.00,2446560.80
5276,2022-02-16,2022-02-17,,Credit Card Payment,566.53,0.00,2445994.27
5277,2022-02-18,2022-02-18,,Transfer Received,0.00,1691.41,2447685.68
5278,2022-02-18,2022-02-18,,Salary Credit,0.00,4588.72,2452274.40
5279,2022-02-18,2022-02-18,,Investment - Mutual Funds,2560.70,0.00,2449713.70
5280,2022-02-18,2022-02-18,,Cash Deposit,0.00,110.40,2449824.10
5281,2022-02-19,2022-02-18,,ATM Withdrawal,91.47,0.00,2449732.63
5282,2022-02-19,2022-02-18,,Online Transfer,1815.07,0.00,2447917.56
5283,2022-02-19,2022-02-18,,Coffee Shop,17.36,0.00,2447900.20
5284,2022-02-19,2022-02-19,,Salary Credit,0.00,4966.39,2452866.59
5285,2022-02-19,2022-02-19,,Salary Credit,0.00,2514.90,2455381.49
5286,2022-02-19,2022-02-19,,Transfer Received,0.00,2197.15,2457578.64
5287,2022-02-19,2022-02-19,,Credit Card Payment,396.46,0.00,2457182.18
5288,2022-02-20,2022-02-19,,Transfer Received,0.00,1660.06,2458842.24
5289,2022-02-18,2022-02-19,,Salary Credit,0.00,3492.17,2462334.41
5290,2022-02-19,2022-02-19,,Utility Payment,250.08,0.00,2462084.33
5291,2022-02-19,2022-02-19,,Daily Essentials,14.56,0.00,2462069.77
5292,2022-02-19,2022-02-19,,Loan EMI,710.31,0.00,2461359.46
5293,2022-02-18,2022-02-19,,Utility Payment,269.81,0.00,2461089.65
5294,2022-02-19,2022-02-19,,Utility Payment,72.43,0.00,2461017.22
5295,2022-02-20,2022-02-20,,Investment - Stocks,1429.08,0.00,2459588.14
5296,2022-02-20,2022-02-20,,Credit Card Payment,938.68,0.00,2458649.46
5297,2022-02-20,2022-02-20,,Salary Credit,0.00,2414.04,2461063.50
5298,2022-02-19,2022-02-20,,Investment - Stocks,2783.17,0.00,2458280.33
5299,2022-02-20,2022-02-21,,Transfer Received,0.00,1308.44,2459588.77
5300,2022-02-21,2022-02-21,,Salary Credit,0.00,4870.22,2464458.99
5301,2022-02-21,2022-02-21,,Credit Card Payment,417.73,0.00,2464041.26
5302,2022-02-21,2022-02-21,,Daily Essentials,25.45,0.00,2464015.81
5303,2022-02-22,2022-02-22,,Interest Credited,0.00,28.59,2464044.40
5304,2022-02-21,2022-02-22,,Investment - Mutual Funds,2238.05,0.00,2461806.35
5305,2022-02-21,2022-02-22,,Investment - Mutual Funds,1994.35,0.00,2459812.00
5306,2022-02-21,2022-02-22,,Interest Credited,0.00,82.88,2459894.88
5307,2022-02-22,2022-02-22,,Investment - Mutual Funds,668.74,0.00,2459226.14
5308,2022-02-23,2022-02-22,,Transfer Received,0.00,1030.31,2460256.45
5309,2022-02-22,2022-02-22,,Investment - SIP,971.41,0.00,2459285.04
5310,2022-02-23,2022-02-23,,Cash Deposit,0.00,492.89,2459777.93
5311,2022-02-23,2022-02-23,,Utility Payment,126.08,0.00,2459651.85
5312,2022-02-24,2022-02-23,,Transfer Received,0.00,1570.27,2461222.12
5313,2022-02-24,2022-02-23,,Transfer Received,0.00,2624.23,2463846.35
5314,2022-02-23,2022-02-23,,Investment - Mutual Funds,612.90,0.00,2463233.45
5315,2022-02-22,2022-02-23,,Transfer Received,0.00,2799.10,2466032.55
5316,2022-02-24,2022-02-24,,Credit Card Payment,594.47,0.00,2465438.08
5317,2022-02-24,2022-02-24,,Groceries - Supermarket,163.46,0.00,2465274.62
5318,2022-02-25,2022-02-24,,Transfer Received,0.00,2785.86,2468060.48
5319,2022-02-24,2022-02-24,,Coffee Shop,8.72,0.00,2468051.76
5320,2022-02-24,2022-02-24,,Salary Credit,0.00,3170.00,2471221.76
5321,2022-02-24,2022-02-24,,Daily Essentials,32.82,0.00,2471188.94
5322,2022-02-24,2022-02-24,,Loan EMI,1736.71,0.00,2469452.23
5323,2022-02-23,2022-02-24,,ATM Withdrawal,233.82,0.00,2469218.41
5324,2022-02-24,2022-02-24,,Interest Credited,0.00,64.91,2469283.32
5325,2022-02-23,2022-02-24,,Interest Credited,0.00,46.61,2469329.93
5326,2022-02-25,2022-02-25,100128,Cheque Issued,1178.32,0.00,2468151.61
5327,2022-02-24,2022-02-25,,Transfer Received,0.00,1329.56,2469481.17
5328,2022-02-25,2022-02-25,,Online Transfer,1285.72,0.00,2468195.45
5329,2022-02-25,2022-02-25,,ATM Withdrawal,105.40,0.00,2468090.05
5330,2022-02-25,2022-02-25,,Transfer Received,0.00,1610.17,2469700.22
5331,2022-02-26,2022-02-26,,Investment - SIP,557.79,0.00,2469142.43
5332,2022-02-27,2022-02-26,,Investment - Mutual Funds,1378.79,0.00,2467763.64
5333,2022-02-25,2022-02-26,,Coffee Shop,10.60,0.00,2467753.04
5334,2022-02-26,2022-02-26,,Interest Credited,0.00,59.60,2467812.64
5335,2022-02-26,2022-02-26,,ATM Withdrawal,266.06,0.00,2467546.58
5336,2022-02-26,2022-02-26,,Dining Out,57.40,0.00,2467489.18
5337,2022-02-26,2022-02-26,,Transfer Received,0.00,2000.39,2469489.57
5338,2022-02-26,2022-02-26,,Groceries - Supermarket,114.47,0.00,2469375.10
5339,2022-02-26,2022-02-26,,Online Transfer,110.80,0.00,2469264.30
5340,2022-02-26,2022-02-26,,Groceries - Supermarket,122.90,0.00,2469141.40
5341,2022-02-25,2022-02-26,,Groceries - Supermarket,53.99,0.00,2469087.41
5342,2022-02-26,2022-02-26,,Investment Returns,0.00,211.82,2469299.23
5343,2022-02-27,2022-02-27,,Loan EMI,1464.00,0.00,2467835.23
5344,2022-02-27,2022-02-27,,Utility Payment,129.40,0.00,2467705.83
5345,2022-02-27,2022-02-27,,Salary Credit,0.00,4169.95,2471875.78
5346,2022-02-27,2022-02-27,,Credit Card Payment,484.91,0.00,2471390.87
5347,2022-02-27,2022-02-27,,Credit Card Payment,653.08,0.00,2470737.79
5348,2022-02-27,2022-02-27,,Salary Credit,0.00,2154.09,2472891.88
5349,2022-02-26,2022-02-27,100129,Cheque Issued,2350.57,0.00,2470541.31
5350,2022-02-27,2022-02-27,,ATM Withdrawal,127.43,0.00,2470413.88
5351,2022-02-28,2022-02-28,100130,Cheque Issued,2611.15,0.00,2467802.73
5352,2022-02-28,2022-02-28,,Transfer Received,0.00,2547.90,2470350.63
5353,2022-02-28,2022-02-28,,Dividend Received,0.00,280.63,2470631.26
5354,2022-02-28,2022-02-28,,Transfer Received,0.00,2236.44,2472867.70
5355,2022-03-01,2022-02-28,,Groceries - Supermarket,123.54,0.00,2472744.16
5356,2022-02-28,2022-02-28,100131,Cheque Issued,2122.58,0.00,2470621.58
5357,2022-02-28,2022-02-28,,ATM Withdrawal,93.81,0.00,2470527.77
5358,2022-02-28,2022-02-28,,Online Transfer,146.06,0.00,2470381.71
5359,2022-02-28,2022-02-28,,Utility Payment,265.65,0.00,2470116.06
5360,2022-02-28,2022-02-28,,Online Transfer,1859.31,0.00,2468256.75
5361,2022-03-01,2022-02-28,,Takeout,41.66,0.00,2468215.09
5362,2022-03-02,2022-03-01,,Credit Card Payment,458.37,0.00,2467756.72
5363,2022-02-28,2022-03-01,,Salary Credit,0.00,3611.55,2471368.27
5364,2022-03-01,2022-03-01,,Salary Credit,0.00,3039.36,2474407.63
5365,2022-03-01,2022-03-01,,Salary Credit,0.00,2772.72,2477180.35
5366,2022-03-02,2022-03-01,,Dividend Received,0.00,249.77,2477430.12
5367,2022-02-28,2022-03-01,,Investment - SIP,306.04,0.00,2477124.08
5368,2022-03-02,2022-03-02,,ATM Withdrawal,240.95,0.00,2476883.13
5369,2022-03-02,2022-03-02,,Online Transfer,1146.23,0.00,2475736.90
5370,2022-03-02,2022-03-02,,Salary Credit,0.00,2113.60,2477850.50
5371,2022-03-03,2022-03-02,,Groceries - Supermarket,171.47,0.00,2477679.03
5372,2022-03-03,2022-03-02,,ATM Withdrawal,67.85,0.00,2477611.18
5373,2022-03-02,2022-03-02,,Daily Essentials,22.63,0.00,2477588.55
5374,2022-03-03,2022-03-02,,Utility Payment,137.93,0.00,2477450.62
5375,2022-03-02,2022-03-02,,Salary Credit,0.00,2545.17,2479995.79
5376,2022-03-02,2022-03-02,,Investment - Mutual Funds,281.57,0.00,2479714.22
5377,2022-03-03,2022-03-03,,Utility Payment,241.74,0.00,2479472.48
5378,2022-03-02,2022-03-03,,ATM Withdrawal,119.24,0.00,2479353.24
5379,2022-03-03,2022-03-03,,Salary Credit,0.00,3836.03,2483189.27
5380,2022-03-02,2022-03-03,,Salary Credit,0.00,4632.28,2487821.55
5381,2022-03-03,2022-03-03,,Interest Credited,0.00,24.33,2487845.88
5382,2022-03-02,2022-03-03,,Credit Card Payment,532.07,0.00,2487313.81
5383,2022-03-03,2022-03-03,,Takeout,36.83,0.00,2487276.98
5384,2022-03-03,2022-03-03,,Dining Out,13.07,0.00,2487263.91
5385,2022-03-05,2022-03-04,,ATM Withdrawal,184.45,0.00,2487079.46
5386,2022-03-04,2022-03-04,,Investment Returns,0.00,305.74,2487385.20
5387,2022-03-03,2022-03-04,,ATM Withdrawal,118.42,0.00,2487266.78
5388,2022-03-04,2022-03-04,,ATM Withdrawal,223.18,0.00,2487043.60
5389,2022-03-04,2022-03-04,,Groceries - Supermarket,63.43,0.00,2486980.17
5390,2022-03-05,2022-03-04,,Transfer Received,0.00,1674.25,2488654.42
5391,2022-03-04,2022-03-04,,Dividend Received,0.00,459.87,2489114.29
5392,2022-03-05,2022-03-04,,Transfer Received,0.00,2186.86,2491301.15
5393,2022-03-04,2022-03-04,,Salary Credit,0.00,3206.54,2494507.69
5394,2022-03-05,2022-03-05,,Credit Card Payment,761.45,0.00,2493746.24
5395,2022-03-06,2022-03-05,,Transfer Received,0.00,2385.69,2496131.93
5396,2022-03-06,2022-03-05,,Interest Credited,0.00,30.86,2496162.79
5397,2022-03-05,2022-03-05,,Groceries - Supermarket,168.93,0.00,2495993.86
5398,2022-03-06,2022-03-06,,Transfer Received,0.00,1062.70,2497056.56
5399,2022-03-06,2022-03-06,,Groceries - Supermarket,67.37,0.00,2496989.19
5400,2022-03-06,2022-03-06,,Transfer Received,0.00,1352.96,2498342.15
5401,2022-03-06,2022-03-06,,Credit Card Payment,679.95,0.00,2497662.20
5402,2022-03-07,2022-03-06,100132,Cheque Issued,1929.85,0.00,2495732.35
5403,2022-03-06,2022-03-06,,Online Transfer,1937.67,0.00,2493794.68
5404,2022-03-05,2022-03-06,,Utility Payment,237.44,0.00,2493557.24
5405,2022-03-07,2022-03-06,,Transfer Received,0.00,1669.64,2495226.88
5406,2022-03-07,2022-03-06,,Interest Credited,0.00,79.25,2495306.13
5407,2022-03-05,2022-03-06,100133,Cheque Issued,2042.80,0.00,2493263.33
5408,2022-03-06,2022-03-07,,Salary Credit,0.00,3024.61,2496287.94
5409,2022-03-07,2022-03-07,,Credit Card Payment,324.09,0.00,2495963.85
5410,2022-03-07,2022-03-07,,Online Transfer,1201.09,0.00,2494762.76
5411,2022-03-07,2022-03-07,,Transfer Received,0.00,1254.74,2496017.50
5412,2022-03-06,2022-03-07,,Online Transfer,946.01,0.00,2495071.49
5413,2022-03-06,2022-03-07,,Utility Payment,170.83,0.00,2494900.66
5414,2022-03-07,2022-03-07,,Transfer Received,0.00,2094.46,2496995.12
5415,2022-03-07,2022-03-07,,Groceries - Supermarket,189.34,0.00,2496805.78
5416,2022-03-08,2022-03-07,,Online Transfer,1675.17,0.00,2495130.61
5417,2022-03-07,2022-03-07,,Rental Income,0.00,1503.97,2496634.58
5418,2022-03-07,2022-03-07,,Transfer Received,0.00,621.37,2497255.95
5419,2022-03-07,2022-03-07,,Groceries - Online Delivery,140.14,0.00,2497115.81
5420,2022-03-08,2022-03-08,,Salary Credit,0.00,4970.54,2502086.35
5421,2022-03-09,2022-03-08,,Transfer Received,0.00,1323.54,2503409.89
5422,2022-03-08,2022-03-08,,ATM Withdrawal,139.27,0.00,2503270.62
5423,2022-03-08,2022-03-08,,Interest Credited,0.00,31.98,2503302.60
5424,2022-03-10,2022-03-10,,Online Transfer,1239.54,0.00,2502063.06
5425,2022-03-10,2022-03-10,,Utility Payment,282.68,0.00,2501780.38
5426,2022-03-11,2022-03-10,,ATM Withdrawal,339.22,0.00,2501441.16
5427,2022-03-09,2022-03-10,,Transfer Received,0.00,1446.40,2502887.56
5428,2022-03-11,2022-03-10,,Salary Credit,0.00,3947.45,2506835.01
5429,2022-03-10,2022-03-10,100134,Cheque Issued,2586.39,0.00,2504248.62
5430,2022-03-10,2022-03-10,,Online Transfer,1248.45,0.00,2503000.17
5431,2022-03-10,2022-03-10,,Transfer Received,0.00,1810.44,2504810.61
5432,2022-03-09,2022-03-10,,Investment - Mutual Funds,944.47,0.00,2503866.14
5433,2022-03-11,2022-03-10,,Groceries - Supermarket,176.61,0.00,2503689.53
5434,2022-03-11,2022-03-11,,Transfer Received,0.00,1904.65,2505594.18
5435,2022-03-10,2022-03-11,,Transfer Received,0.00,1227.82,2506822.00
5436,2022-03-11,2022-03-11,,Utility Payment,288.17,0.00,2506533.83
5437,2022-03-11,2022-03-11,,Takeout,47.57,0.00,2506486.26
5438,2022-03-12,2022-03-11,,Groceries - Supermarket,138.00,0.00,2506348.26
5439,2022-03-12,2022-03-12,,Credit Card Payment,981.49,0.00,2505366.77
5440,2022-03-12,2022-03-12,,Groceries - Supermarket,45.69,0.00,2505321.08
5441,2022-03-13,2022-03-12,,Transfer Received,0.00,2342.69,2507663.77
5442,2022-03-13,2022-03-12,,Transfer Received,0.00,2014.23,2509678.00
5443,2022-03-13,2022-03-12,,Groceries - Supermarket,29.58,0.00,2509648.42
5444,2022-03-12,2022-03-12,,Transfer Received,0.00,726.37,2510374.79
5445,2022-03-12,2022-03-12,,Transfer Received,0.00,1800.30,2512175.09
5446,2022-03-12,2022-03-12,,Transfer Received,0.00,1153.39,2513328.48
5447,2022-03-13,2022-03-13,,Groceries - Supermarket,69.84,0.00,2513258.64
5448,2022-03-13,2022-03-13,,Transfer Received,0.00,1362.18,2514620.82
5449,2022-03-14,2022-03-14,,Online Transfer,1167.83,0.00,2513452.99
5450,2022-03-13,2022-03-14,,Utility Payment,279.38,0.00,2513173.61
5451,2022-03-15,2022-03-14,,Dividend Received,0.00,86.61,2513260.22
5452,2022-03-14,2022-03-14,,Cash Deposit,0.00,708.58,2513968.80
5453,2022-03-14,2022-03-14,,Loan EMI,951.03,0.00,2513017.77
5454,2022-03-14,2022-03-14,,Salary Credit,0.00,2702.45,2515720.22
5455,2022-03-14,2022-03-14,,ATM Withdrawal,254.83,0.00,2515465.39
5456,2022-03-15,2022-03-15,,Online Transfer,1115.13,0.00,2514350.26
5457,2022-03-16,2022-03-15,,Groceries - Supermarket,137.35,0.00,2514212.91
5458,2022-03-15,2022-03-16,,Groceries - Supermarket,168.64,0.00,2514044.27
5459,2022-03-17,2022-03-16,,Online Transfer,736.45,0.00,2513307.82
5460,2022-03-15,2022-03-16,,Investment - Mutual Funds,1155.82,0.00,2512152.00
5461,2022-03-16,2022-03-16,,Rental Income,0.00,2245.95,2514397.95
5462,2022-03-17,2022-03-16,,Salary Credit,0.00,2029.80,2516427.75
5463,2022-03-16,2022-03-17,,Loan EMI,1917.65,0.00,2514510.10
5464,2022-03-17,2022-03-17,,Salary Credit,0.00,2002.95,2516513.05
5465,2022-03-16,2022-03-17,,Groceries - Online Delivery,56.47,0.00,2516456.58
5466,2022-03-16,2022-03-17,,Groceries - Online Delivery,76.06,0.00,2516380.52
5467,2022-03-17,2022-03-17,,ATM Withdrawal,473.16,0.00,2515907.36
5468,2022-03-18,2022-03-17,,Credit Card Payment,963.36,0.00,2514944.00
5469,2022-03-17,2022-03-17,,Investment Returns,0.00,266.10,2515210.10
5470,2022-03-18,2022-03-17,,Salary Credit,0.00,3517.03,2518727.13
5471,2022-03-17,2022-03-17,,Groceries - Online Delivery,102.87,0.00,2518624.26
5472,2022-03-17,2022-03-17,,Utility Payment,212.79,0.00,2518411.47
5473,2022-03-18,2022-03-17,,Online Transfer,1030.84,0.00,2517380.63
5474,2022-03-17,2022-03-17,,Groceries - Supermarket,50.58,0.00,2517330.05
5475,2022-03-19,2022-03-18,,Groceries - Online Delivery,64.18,0.00,2517265.87
5476,2022-03-18,2022-03-18,,Utility Payment,177.32,0.00,2517088.55
5477,2022-03-18,2022-03-18,,Utility Payment,291.49,0.00,2516797.06
5478,2022-03-18,2022-03-18,,Dining Out,58.09,0.00,2516738.97
5479,2022-03-17,2022-03-18,,Salary Credit,0.00,2686.45,2519425.42
5480,2022-03-18,2022-03-18,,Transfer Received,0.00,2192.49,2521617.91
5481,2022-03-20,2022-03-19,,ATM Withdrawal,331.12,0.00,2521286.79
5482,2022-03-19,2022-03-19,,Investment - Mutual Funds,1339.42,0.00,2519947.37
5483,2022-03-18,2022-03-19,,Transfer Received,0.00,904.76,2520852.13
5484,2022-03-20,2022-03-19,,Utility Payment,249.40,0.00,2520602.73
5485,2022-03-19,2022-03-19,,Groceries - Supermarket,81.83,0.00,2520520.90
5486,2022-03-20,2022-03-20,,Utility Payment,269.26,0.00,2520251.64
5487,2022-03-20,2022-03-20,,Transfer Received,0.00,1829.22,2522080.86
5488,2022-03-19,2022-03-20,,Groceries - Supermarket,181.41,0.00,2521899.45
5489,2022-03-20,2022-03-20,,Credit Card Payment,245.92,0.00,2521653.53
5490,2022-03-20,2022-03-20,,Investment - SIP,395.54,0.00,2521257.99
5491,2022-03-21,2022-03-20,,Transfer Received,0.00,1238.45,2522496.44
5492,2022-03-21,2022-03-20,,Cash Deposit,0.00,124.74,2522621.18
5493,2022-03-20,2022-03-20,,Interest Credited,0.00,18.67,2522639.85
5494,2022-03-20,2022-03-20,,Transfer Received,0.00,806.58,2523446.43
5495,2022-03-21,2022-03-20,,Salary Credit,0.00,3909.63,2527356.06
5496,2022-03-20,2022-03-21,,ATM Withdrawal,376.63,0.00,2526979.43
5497,2022-03-22,2022-03-21,,Groceries - Online Delivery,82.88,0.00,2526896.55
5498,2022-03-23,2022-03-22,100135,Cheque Issued,842.25,0.00,2526054.30
5499,2022-03-22,2022-03-22,,Salary Credit,0.00,2085.58,2528139.88
5500,2022-03-22,2022-03-22,,Salary Credit,0.00,3731.12,2531871.00
5501,2022-03-22,2022-03-22,,Transfer Received,0.00,2131.88,2534002.88
5502,2022-03-22,2022-03-22,,Utility Payment,268.94,0.00,2533733.94
5503,2022-03-22,2022-03-22,,Transfer Received,0.00,1846.54,2535580.48
5504,2022-03-22,2022-03-22,,Coffee Shop,15.51,0.00,2535564.97
5505,2022-03-22,2022-03-22,,Investment - SIP,659.05,0.00,2534905.92
5506,2022-03-24,2022-03-23,,Groceries - Supermarket,28.10,0.00,2534877.82
5507,2022-03-22,2022-03-23,100136,Cheque Issued,2933.49,0.00,2531944.33
5508,2022-03-22,2022-03-23,,ATM Withdrawal,291.42,0.00,2531652.91
5509,2022-03-23,2022-03-23,,Groceries - Supermarket,146.03,0.00,2531506.88
5510,2022-03-23,2022-03-23,,Credit Card Payment,816.94,0.00,2530689.94
5511,2022-03-23,2022-03-23,,Interest Credited,0.00,41.62,2530731.56
5512,2022-03-23,2022-03-23,,ATM Withdrawal,358.95,0.00,2530372.61
5513,2022-03-25,2022-03-24,,Investment Returns,0.00,360.91,2530733.52
5514,2022-03-24,2022-03-24,,Groceries - Supermarket,157.00,0.00,2530576.52
5515,2022-03-25,2022-03-25,,Cash Deposit,0.00,149.90,2530726.42
5516,2022-03-24,2022-03-25,,Utility Payment,149.95,0.00,2530576.47
5517,2022-03-24,2022-03-25,,Transfer Received,0.00,1621.17,2532197.64
5518,2022-03-25,2022-03-25,,ATM Withdrawal,412.44,0.00,2531785.20
5519,2022-03-25,2022-03-25,,Groceries - Online Delivery,141.14,0.00,2531644.06
5520,2022-03-25,2022-03-25,,Utility Payment,77.98,0.00,2531566.08
5521,2022-03-25,2022-03-25,,Salary Credit,0.00,3033.40,2534599.48
5522,2022-03-26,2022-03-26,,Loan EMI,957.92,0.00,2533641.56
5523,2022-03-27,2022-03-26,,Salary Credit,0.00,3637.50,2537279.06
5524,2022-03-25,2022-03-26,,Salary Credit,0.00,2028.30,2539307.36
5525,2022-03-25,2022-03-26,,ATM Withdrawal,81.32,0.00,2539226.04
5526,2022-03-27,2022-03-27,,Online Transfer,1266.48,0.00,2537959.56
5527,2022-03-28,2022-03-27,,Transfer Received,0.00,1970.83,2539930.39
5528,2022-03-28,2022-03-27,,Utility Payment,157.32,0.00,2539773.07
5529,2022-03-27,2022-03-27,,Cash Deposit,0.00,798.92,2540571.99
5530,2022-03-27,2022-03-27,,Dividend Received,0.00,373.86,2540945.85
5531,2022-03-27,2022-03-27,,ATM Withdrawal,127.55,0.00,2540818.30
5532,2022-03-28,2022-03-28,,Rental Income,0.00,1640.92,2542459.22
5533,2022-03-28,2022-03-28,,Utility Payment,108.31,0.00,2542350.91
5534,2022-03-28,2022-03-28,,Transfer Received,0.00,1682.24,2544033.15
5535,2022-03-28,2022-03-28,,Investment - SIP,771.76,0.00,2543261.39
5536,2022-03-28,2022-03-28,,Salary Credit,0.00,3247.56,2546508.95
5537,2022-03-28,2022-03-28,,Loan EMI,666.49,0.00,2545842.46
5538,2022-03-28,2022-03-28,,Credit Card Payment,255.81,0.00,2545586.65
5539,2022-03-27,2022-03-28,,Investment - Mutual Funds,2978.47,0.00,2542608.18
5540,2022-03-28,2022-03-28,100137,Cheque Issued,813.60,0.00,2541794.58
5541,2022-03-29,2022-03-29,,Rental Income,0.00,1455.75,2543250.33
5542,2022-03-29,2022-03-29,,Salary Credit,0.00,2045.02,2545295.35
5543,2022-03-29,2022-03-29,,Utility Payment,201.85,0.00,2545093.50
5544,2022-03-30,2022-03-29,,Transfer Received,0.00,2832.03,2547925.53
5545,2022-03-29,2022-03-29,,Interest Credited,0.00,39.61,2547965.14
5546,2022-03-28,2022-03-29,,Salary Credit,0.00,4684.63,2552649.77
5547,2022-03-29,2022-03-29,,Investment - Mutual Funds,2224.83,0.00,2550424.94
5548,2022-03-29,2022-03-29,,ATM Withdrawal,123.81,0.00,2550301.13
5549,2022-03-30,2022-03-30,,Salary Credit,0.00,2682.67,2552983.80
5550,2022-03-30,2022-03-30,,Investment - Mutual Funds,458.63,0.00,2552525.17
5551,2022-03-31,2022-03-30,,Groceries - Online Delivery,79.42,0.00,2552445.75
5552,2022-03-30,2022-03-30,,Utility Payment,140.35,0.00,2552305.40
5553,2022-03-30,2022-03-30,,ATM Withdrawal,346.92,0.00,2551958.48
5554,2022-03-30,2022-03-30,,Investment - SIP,174.40,0.00,2551784.08
5555,2022-03-30,2022-03-30,,Dining Out,52.77,0.00,2551731.31
5556,2022-03-30,2022-03-30,,Groceries - Supermarket,158.20,0.00,2551573.11
5557,2022-03-30,2022-03-30,,ATM Withdrawal,325.63,0.00,2551247.48
5558,2022-03-31,2022-03-31,,Utility Payment,117.63,0.00,2551129.85
5559,2022-03-31,2022-03-31,,ATM Withdrawal,375.59,0.00,2550754.26
5560,2022-04-01,2022-03-31,,Online Transfer,1230.93,0.00,2549523.33
5561,2022-04-01,2022-03-31,,Salary Credit,0.00,2039.66,2551562.99
5562,2022-03-31,2022-03-31,,Transfer Received,0.00,1236.38,2552799.37
5563,2022-03-31,2022-03-31,,Online Transfer,203.86,0.00,2552595.51
5564,2022-03-31,2022-03-31,,Salary Credit,0.00,4118.50,2556714.01
5565,2022-03-31,2022-04-01,,ATM Withdrawal,461.96,0.00,2556252.05
5566,2022-04-01,2022-04-01,,Investment - Mutual Funds,1933.25,0.00,2554318.80
5567,2022-04-01,2022-04-01,,Groceries - Supermarket,186.68,0.00,2554132.12
5568,2022-04-02,2022-04-01,,Transfer Received,0.00,2482.41,2556614.53
5569,2022-04-01,2022-04-01,,Transfer Received,0.00,2922.18,2559536.71
5570,2022-03-31,2022-04-01,,Interest Credited,0.00,74.50,2559611.21
5571,2022-04-01,2022-04-01,100138,Cheque Issued,1623.58,0.00,2557987.63
5572,2022-04-01,2022-04-01,,Transfer Received,0.00,2249.63,2560237.26
5573,2022-04-02,2022-04-01,,Daily Essentials,19.34,0.00,2560217.92
5574,2022-04-02,2022-04-02,,Groceries - Online Delivery,147.99,0.00,2560069.93
5575,2022-04-02,2022-04-02,,ATM Withdrawal,258.36,0.00,2559811.57
5576,2022-04-02,2022-04-02,,Cash Deposit,0.00,429.47,2560241.04
5577,2022-04-02,2022-04-03,,Groceries - Supermarket,104.89,0.00,2560136.15
5578,2022-04-03,2022-04-03,,ATM Withdrawal,304.11,0.00,2559832.04
5579,2022-04-02,2022-04-03,,Takeout,46.84,0.00,2559785.20
5580,2022-04-04,2022-04-04,,Transfer Received,0.00,1557.87,2561343.07
5581,2022-04-04,2022-04-04,,Transfer Received,0.00,1658.71,2563001.78
5582,2022-04-04,2022-04-04,,ATM Withdrawal,343.37,0.00,2562658.41
5583,2022-04-05,2022-04-04,,Interest Credited,0.00,58.08,2562716.49
5584,2022-04-05,2022-04-04,,Salary Credit,0.00,2039.06,2564755.55
5585,2022-04-04,2022-04-04,,Interest Credited,0.00,34.60,2564790.15
5586,2022-04-04,2022-04-04,,Credit Card Payment,668.49,0.00,2564121.66
5587,2022-04-05,2022-04-05,,Online Transfer,1183.52,0.00,2562938.14
5588,2022-04-05,2022-04-05,,Credit Card Payment,835.47,0.00,2562102.67
5589,2022-04-06,2022-04-05,,Salary Credit,0.00,3720.65,2565823.32
5590,2022-04-05,2022-04-05,,Interest Credited,0.00,20.61,2565843.93
5591,2022-04-04,2022-04-05,,Transfer Received,0.00,2755.48,2568599.41
5592,2022-04-05,2022-04-05,,Salary Credit,0.00,4459.08,2573058.49
5593,2022-04-05,2022-04-05,,Online Transfer,261.40,0.00,2572797.09
5594,2022-04-05,2022-04-05,,Interest Credited,0.00,21.78,2572818.87
5595,2022-04-05,2022-04-05,,Salary Credit,0.00,4668.81,2577487.68
5596,2022-04-05,2022-04-05,,Transfer Received,0.00,1973.50,2579461.18
5597,2022-04-04,2022-04-05,,Interest Credited,0.00,41.35,2579502.53
5598,2022-04-06,2022-04-06,,ATM Withdrawal,392.89,0.00,2579109.64
5599,2022-04-05,2022-04-06,,ATM Withdrawal,429.18,0.00,2578680.46
5600,2022-04-06,2022-04-06,,Dining Out,97.25,0.00,2578583.21
5601,2022-04-06,2022-04-06,,Groceries - Supermarket,198.65,0.00,2578384.56
5602,2022-04-06,2022-04-06,,Utility Payment,249.49,0.00,2578135.07
5603,2022-04-06,2022-04-06,,Utility Payment,75.20,0.00,2578059.87
5604,2022-04-07,2022-04-06,,Groceries - Supermarket,43.65,0.00,2578016.22
5605,2022-04-07,2022-04-06,,Groceries - Supermarket,134.44,0.00,2577881.78
5606,2022-04-06,2022-04-06,,Salary Credit,0.00,3586.47,2581468.25
5607,2022-04-07,2022-04-06,,Investment Returns,0.00,649.45,2582117.70
5608,2022-04-07,2022-04-07,,Salary Credit,0.00,2576.58,2584694.28
5609,2022-04-06,2022-04-07,,Credit Card Payment,671.35,0.00,2584022.93
5610,2022-04-07,2022-04-07,,Investment - Stocks,4084.70,0.00,2579938.23
5611,2022-04-07,2022-04-07,,Groceries - Supermarket,70.59,0.00,2579867.64
5612,2022-04-07,2022-04-07,,Takeout,40.28,0.00,2579827.36
5613,2022-04-07,2022-04-07,,Online Transfer,1042.71,0.00,2578784.65
5614,2022-04-07,2022-04-07,,Utility Payment,54.22,0.00,2578730.43
5615,2022-04-08,2022-04-07,,Interest Credited,0.00,84.93,2578815.36
5616,2022-04-07,2022-04-07,,Transfer Received,0.00,2353.53,2581168.89
5617,2022-04-08,2022-04-07,,Transfer Received,0.00,1015.66,2582184.55
5618,2022-04-08,2022-04-08,,Utility Payment,206.44,0.00,2581978.11
5619,2022-04-09,2022-04-08,,Interest Credited,0.00,41.14,2582019.25
5620,2022-04-08,2022-04-08,,Investment - Mutual Funds,2984.53,0.00,2579034.72
5621,2022-04-09,2022-04-09,,Groceries - Online Delivery,100.96,0.00,2578933.76
5622,2022-04-10,2022-04-09,,ATM Withdrawal,376.01,0.00,2578557.75
5623,2022-04-09,2022-04-09,,Transfer Received,0.00,983.83,2579541.58
5624,2022-04-09,2022-04-09,,Investment - Mutual Funds,2361.65,0.00,2577179.93
5625,2022-04-08,2022-04-09,,Dining Out,43.89,0.00,2577136.04
5626,2022-04-08,2022-04-09,,Investment - Mutual Funds,2703.37,0.00,2574432.67
5627,2022-04-10,2022-04-10,,Daily Essentials,41.61,0.00,2574391.06
5628,2022-04-10,2022-04-10,,Loan EMI,1368.33,0.00,2573022.73
5629,2022-04-10,2022-04-10,,ATM Withdrawal,262.20,0.00,2572760.53
5630,2022-04-09,2022-04-10,,Cash Deposit,0.00,567.61,2573328.14
5631,2022-04-10,2022-04-10,,Groceries - Supermarket,167.74,0.00,2573160.40
5632,2022-04-10,2022-04-10,,Interest Credited,0.00,28.26,2573188.66
5633,2022-04-09,2022-04-10,,Transfer Received,0.00,2108.40,2575297.06
5634,2022-04-11,2022-04-11,,Online Transfer,167.30,0.00,2575129.76
5635,2022-04-11,2022-04-11,,Salary Credit,0.00,3534.19,2578663.95
5636,2022-04-11,2022-04-11,,Groceries - Supermarket,25.44,0.00,2578638.51
5637,2022-04-12,2022-04-11,,Coffee Shop,19.16,0.00,2578619.35
5638,2022-04-11,2022-04-11,,Transfer Received,0.00,1544.33,2580163.68
5639,2022-04-11,2022-04-11,,Interest Credited,0.00,12.02,2580175.70
5640,2022-04-12,2022-04-12,,Salary Credit,0.00,4295.46,2584471.16
5641,2022-04-12,2022-04-12,,Groceries - Online Delivery,86.34,0.00,2584384.82
5642,2022-04-12,2022-04-12,,Transfer Received,0.00,640.38,2585025.20
5643,2022-04-11,2022-04-12,,Salary Credit,0.00,4396.07,2589421.27
5644,2022-04-12,2022-04-12,,Transfer Received,0.00,2296.73,2591718.00
5645,2022-04-12,2022-04-12,,ATM Withdrawal,472.30,0.00,2591245.70
5646,2022-04-13,2022-04-13,,ATM Withdrawal,280.02,0.00,2590965.68
5647,2022-04-13,2022-04-13,,Interest Credited,0.00,87.78,2591053.46
5648,2022-04-13,2022-04-13,,Rental Income,0.00,1682.78,2592736.24
5649,2022-04-13,2022-04-13,100139,Cheque Issued,1886.25,0.00,2590849.99
5650,2022-04-13,2022-04-13,,Loan EMI,1613.18,0.00,2589236.81
5651,2022-04-12,2022-04-13,,Transfer Received,0.00,2718.51,2591955.32
5652,2022-04-12,2022-04-13,,Coffee Shop,7.47,0.00,2591947.85
5653,2022-04-13,2022-04-13,,Groceries - Supermarket,126.62,0.00,2591821.23
5654,2022-04-13,2022-04-13,,Interest Credited,0.00,78.93,2591900.16
5655,2022-04-13,2022-04-13,,Salary Credit,0.00,3382.79,2595282.95
5656,2022-04-13,2022-04-13,,Salary Credit,0.00,2898.04,2598180.99
5657,2022-04-14,2022-04-14,,Salary Credit,0.00,4838.23,2603019.22
5658,2022-04-15,2022-04-14,,Salary Credit,0.00,4513.76,2607532.98
5659,2022-04-14,2022-04-14,,Salary Credit,0.00,3651.97,2611184.95
5660,2022-04-14,2022-04-14,,Groceries - Supermarket,176.24,0.00,2611008.71
5661,2022-04-14,2022-04-14,,Groceries - Supermarket,169.34,0.00,2610839.37
5662,2022-04-14,2022-04-14,,Groceries - Online Delivery,92.24,0.00,2610747.13
5663,2022-04-14,2022-04-14,,ATM Withdrawal,134.79,0.00,2610612.34
5664,2022-04-14,2022-04-14,,Salary Credit,0.00,2898.54,2613510.88
5665,2022-04-15,2022-04-14,,Salary Credit,0.00,2105.52,2615616.40
5666,2022-04-15,2022-04-15,,ATM Withdrawal,70.51,0.00,2615545.89
5667,2022-04-15,2022-04-15,,Credit Card Payment,313.93,0.00,2615231.96
5668,2022-04-15,2022-04-15,,Investment Returns,0.00,157.96,2615389.92
5669,2022-04-16,2022-04-15,,Transfer Received,0.00,582.79,2615972.71
5670,2022-04-15,2022-04-15,,Credit Card Payment,505.19,0.00,2615467.52
5671,2022-04-15,2022-04-15,,Salary Credit,0.00,4259.71,2619727.23
5672,2022-04-15,2022-04-15,,Transfer Received,0.00,1198.96,2620926.19
5673,2022-04-16,2022-04-15,,Transfer Received,0.00,1409.91,2622336.10
5674,2022-04-15,2022-04-15,,Utility Payment,268.73,0.00,2622067.37
5675,2022-04-15,2022-04-15,,Utility Payment,228.59,0.00,2621838.78
5676,2022-04-15,2022-04-16,,Online Transfer,1571.62,0.00,2620267.16
5677,2022-04-16,2022-04-16,,Interest Credited,0.00,17.54,2620284.70
5678,2022-04-16,2022-04-16,,ATM Withdrawal,381.30,0.00,2619903.40
5679,2022-04-16,2022-04-16,,ATM Withdrawal,295.13,0.00,2619608.27
5680,2022-04-15,2022-04-16,,Cash Deposit,0.00,614.76,2620223.03
5681,2022-04-16,2022-04-16,,ATM Withdrawal,226.68,0.00,2619996.35
5682,2022-04-16,2022-04-16,,ATM Withdrawal,192.50,0.00,2619803.85
5683,2022-04-17,2022-04-16,,Online Transfer,1237.56,0.00,2618566.29
5684,2022-04-17,2022-04-17,,Online Transfer,1272.93,0.00,2617293.36
5685,2022-04-18,2022-04-17,,Salary Credit,0.00,3512.48,2620805.84
5686,2022-04-17,2022-04-17,,Salary Credit,0.00,2973.83,2623779.67
5687,2022-04-16,2022-04-17,,ATM Withdrawal,23.24,0.00,2623756.43
5688,2022-04-17,2022-04-17,,Investment Returns,0.00,104.35,2623860.78
5689,2022-04-17,2022-04-17,,Groceries - Online Delivery,118.71,0.00,2623742.07
5690,2022-04-17,2022-04-17,,ATM Withdrawal,218.77,0.00,2623523.30
5691,2022-04-18,2022-04-18,,Interest Credited,0.00,20.94,2623544.24
5692,2022-04-18,2022-04-18,,ATM Withdrawal,369.19,0.00,2623175.05
5693,2022-04-18,2022-04-18,,Transfer Received,0.00,961.61,2624136.66
5694,2022-04-18,2022-04-18,,ATM Withdrawal,351.48,0.00,2623785.18
5695,2022-04-18,2022-04-18,,Cash Deposit,0.00,602.89,2624388.07
5696,2022-04-18,2022-04-18,,Salary Credit,0.00,2662.27,2627050.34
5697,2022-04-18,2022-04-18,,Rental Income,0.00,2693.40,2629743.74
5698,2022-04-18,2022-04-18,,Interest Credited,0.00,54.02,2629797.76
5699,2022-04-18,2022-04-18,,Transfer Received,0.00,2468.02,2632265.78
5700,2022-04-19,2022-04-19,,Transfer Received,0.00,2989.17,2635254.95
5701,2022-04-19,2022-04-19,,Salary Credit,0.00,2550.07,2637805.02
5702,2022-04-18,2022-04-19,,Credit Card Payment,366.44,0.00,2637438.58
5703,2022-04-19,2022-04-19,,Credit Card Payment,530.57,0.00,2636908.01
5704,2022-04-19,2022-04-19,,Online Transfer,390.06,0.00,2636517.95
5705,2022-04-19,2022-04-19,,Credit Card Payment,235.59,0.00,2636282.36
5706,2022-04-19,2022-04-20,,Interest Credited,0.00,48.40,2636330.76
5707,2022-04-20,2022-04-20,,Transfer Received,0.00,1839.81,2638170.57
5708,2022-04-20,2022-04-20,,Loan EMI,545.49,0.00,2637625.08
5709,2022-04-19,2022-04-20,,Online Transfer,425.79,0.00,2637199.29
5710,2022-04-20,2022-04-20,,Transfer Received,0.00,1441.51,2638640.80
5711,2022-04-19,2022-04-20,,Utility Payment,133.34,0.00,2638507.46
5712,2022-04-20,2022-04-20,,Credit Card Payment,266.23,0.00,2638241.23
5713,2022-04-21,2022-04-21,,Groceries - Supermarket,139.42,0.00,2638101.81
5714,2022-04-22,2022-04-21,,Online Transfer,982.93,0.00,2637118.88
5715,2022-04-21,2022-04-21,,Interest Credited,0.00,96.95,2637215.83
5716,2022-04-21,2022-04-21,,Utility Payment,88.34,0.00,2637127.49
5717,2022-04-21,2022-04-21,,ATM Withdrawal,396.89,0.00,2636730.60
5718,2022-04-22,2022-04-22,,Salary Credit,0.00,3840.37,2640570.97
5719,2022-04-22,2022-04-22,,Dining Out,85.35,0.00,2640485.62
5720,2022-04-22,2022-04-22,,ATM Withdrawal,328.02,0.00,2640157.60
5721,2022-04-22,2022-04-22,,Loan EMI,1267.63,0.00,2638889.97
5722,2022-04-22,2022-04-22,,Salary Credit,0.00,4568.90,2643458.87
5723,2022-04-22,2022-04-22,,ATM Withdrawal,336.80,0.00,2643122.07
5724,2022-04-22,2022-04-23,,Transfer Received,0.00,2261.03,2645383.10
5725,2022-04-23,2022-04-23,,Salary Credit,0.00,3898.52,2649281.62
5726,2022-04-23,2022-04-23,,Salary Credit,0.00,2884.65,2652166.27
5727,2022-04-23,2022-04-23,,Transfer Received,0.00,2507.09,2654673.36
5728,2022-04-23,2022-04-23,,Salary Credit,0.00,4616.92,2659290.28
5729,2022-04-24,2022-04-23,,Groceries - Online Delivery,77.82,0.00,2659212.46
5730,2022-04-23,2022-04-24,,Groceries - Supermarket,72.77,0.00,2659139.69
5731,2022-04-24,2022-04-24,,ATM Withdrawal,62.78,0.00,2659076.91
5732,2022-04-24,2022-04-24,,Interest Credited,0.00,86.19,2659163.10
5733,2022-04-24,2022-04-24,,Dining Out,82.02,0.00,2659081.08
5734,2022-04-24,2022-04-24,,Online Transfer,1825.26,0.00,2657255.82
5735,2022-04-24,2022-04-24,,Daily Essentials,32.52,0.00,2657223.30
5736,2022-04-25,2022-04-24,,Groceries - Supermarket,184.40,0.00,2657038.90
5737,2022-04-23,2022-04-24,,Loan EMI,1200.54,0.00,2655838.36
5738,2022-04-24,2022-04-24,,Salary Credit,0.00,3729.19,2659567.55
5739,2022-04-25,2022-04-25,,Takeout,10.15,0.00,2659557.40
5740,2022-04-25,2022-04-25,,Credit Card Payment,842.18,0.00,2658715.22
5741,2022-04-26,2022-04-25,,Utility Payment,75.78,0.00,2658639.44
5742,2022-04-26,2022-04-25,,Credit Card Payment,417.74,0.00,2658221.70
5743,2022-04-25,2022-04-25,,Interest Credited,0.00,28.45,2658250.15
5744,2022-04-25,2022-04-25,,Online Transfer,156.91,0.00,2658093.24
5745,2022-04-25,2022-04-25,,ATM Withdrawal,463.88,0.00,2657629.36
5746,2022-04-24,2022-04-25,,Transfer Received,0.00,1008.65,2658638.01
5747,2022-04-25,2022-04-25,,ATM Withdrawal,392.93,0.00,2658245.08
5748,2022-04-25,2022-04-25,,Transfer Received,0.00,1170.67,2659415.75
5749,2022-04-26,2022-04-26,,Transfer Received,0.00,647.31,2660063.06
5750,2022-04-27,2022-04-26,,Loan EMI,918.22,0.00,2659144.84
5751,2022-04-27,2022-04-26,,Online Transfer,1412.71,0.00,2657732.13
5752,2022-04-25,2022-04-26,,Groceries - Online Delivery,83.52,0.00,2657648.61
5753,2022-04-25,2022-04-26,,Transfer Received,0.00,2797.44,2660446.05
5754,2022-04-26,2022-04-26,,Credit Card Payment,760.41,0.00,2659685.64
5755,2022-04-26,2022-04-26,,Utility Payment,216.88,0.00,2659468.76
5756,2022-04-27,2022-04-27,,Credit Card Payment,568.44,0.00,2658900.32
5757,2022-04-27,2022-04-27,,Utility Payment,236.29,0.00,2658664.03
5758,2022-04-28,2022-04-27,,Transfer Received,0.00,2128.81,2660792.84
5759,2022-04-27,2022-04-27,,Utility Payment,234.51,0.00,2660558.33
5760,2022-04-27,2022-04-27,,Online Transfer,939.98,0.00,2659618.35
5761,2022-04-27,2022-04-27,,Groceries - Supermarket,25.52,0.00,2659592.83
5762,2022-04-27,2022-04-27,,ATM Withdrawal,386.17,0.00,2659206.66
5763,2022-04-27,2022-04-27,,ATM Withdrawal,118.21,0.00,2659088.45
5764,2022-04-29,2022-04-28,,Salary Credit,0.00,2624.79,2661713.24
5765,2022-04-28,2022-04-28,,Daily Essentials,48.12,0.00,2661665.12
5766,2022-04-28,2022-04-28,,Credit Card Payment,835.58,0.00,2660829.54
5767,2022-04-27,2022-04-28,,Online Transfer,1165.52,0.00,2659664.02
5768,2022-04-28,2022-04-28,100140,Cheque Issued,756.11,0.00,2658907.91
5769,2022-04-28,2022-04-28,,Groceries - Supermarket,61.35,0.00,2658846.56
5770,2022-04-28,2022-04-28,,Groceries - Supermarket,189.08,0.00,2658657.48
5771,2022-04-28,2022-04-28,,Investment Returns,0.00,244.24,2658901.72
5772,2022-04-28,2022-04-28,,Online Transfer,1799.69,0.00,2657102.03
5773,2022-04-28,2022-04-28,,Transfer Received,0.00,2925.03,2660027.06
5774,2022-04-28,2022-04-28,,Online Transfer,363.05,0.00,2659664.01
5775,2022-04-29,2022-04-29,,Salary Credit,0.00,3778.07,2663442.08
5776,2022-04-30,2022-04-29,,Online Transfer,1005.93,0.00,2662436.15
5777,2022-04-30,2022-04-29,,Online Transfer,738.09,0.00,2661698.06
5778,2022-04-29,2022-04-29,,Utility Payment,217.23,0.00,2661480.83
5779,2022-04-29,2022-04-29,,Dining Out,25.10,0.00,2661455.73
5780,2022-04-29,2022-04-29,,Dividend Received,0.00,394.92,2661850.65
5781,2022-04-29,2022-04-29,,ATM Withdrawal,23.17,0.00,2661827.48
5782,2022-04-28,2022-04-29,,Loan EMI,1003.06,0.00,2660824.42
5783,2022-04-30,2022-04-30,,Salary Credit,0.00,4499.37,2665323.79
5784,2022-04-30,2022-04-30,,Credit Card Payment,817.29,0.00,2664506.50
5785,2022-04-30,2022-04-30,,Transfer Received,0.00,2293.35,2666799.85
5786,2022-05-01,2022-04-30,,Groceries - Supermarket,116.33,0.00,2666683.52
5787,2022-04-30,2022-04-30,,Investment - Stocks,1495.72,0.00,2665187.80
5788,2022-04-29,2022-04-30,,ATM Withdrawal,80.46,0.00,2665107.34
5789,2022-04-29,2022-04-30,,Transfer Received,0.00,1894.63,2667001.97
5790,2022-04-30,2022-04-30,,Dividend Received,0.00,252.55,2667254.52
5791,2022-04-29,2022-04-30,,Credit Card Payment,975.59,0.00,2666278.93
5792,2022-04-30,2022-04-30,,Transfer Received,0.00,1534.11,2667813.04
5793,2022-05-01,2022-05-01,,Transfer Received,0.00,2553.12,2670366.16
5794,2022-04-30,2022-05-01,,Utility Payment,141.17,0.00,2670224.99
5795,2022-05-01,2022-05-01,,Transfer Received,0.00,1391.89,2671616.88
5796,2022-05-03,2022-05-02,,Online Transfer,1482.62,0.00,2670134.26
5797,2022-05-01,2022-05-02,,Utility Payment,253.35,0.00,2669880.91
5798,2022-05-02,2022-05-02,,Transfer Received,0.00,1176.88,2671057.79
5799,2022-05-02,2022-05-02,,Cash Deposit,0.00,497.02,2671554.81
5800,2022-05-02,2022-05-02,,ATM Withdrawal,288.65,0.00,2671266.16
5801,2022-05-02,2022-05-02,,Salary Credit,0.00,3700.93,2674967.09
5802,2022-05-04,2022-05-03,,Transfer Received,0.00,556.16,2675523.25
5803,2022-05-03,2022-05-03,,Transfer Received,0.00,2664.06,2678187.31
5804,2022-05-03,2022-05-03,,Online Transfer,1441.52,0.00,2676745.79
5805,2022-05-02,2022-05-03,,Cash Deposit,0.00,538.01,2677283.80
5806,2022-05-04,2022-05-03,,Transfer Received,0.00,733.63,2678017.43
5807,2022-05-03,2022-05-03,,Dividend Received,0.00,175.09,2678192.52
5808,2022-05-05,2022-05-04,,Dining Out,63.26,0.00,2678129.26
5809,2022-05-05,2022-05-04,,Online Transfer,1219.11,0.00,2676910.15
5810,2022-05-03,2022-05-04,,Salary Credit,0.00,3171.17,2680081.32
5811,2022-05-04,2022-05-04,100141,Cheque Issued,880.09,0.00,2679201.23
5812,2022-05-04,2022-05-04,,Transfer Received,0.00,2401.29,2681602.52
5813,2022-05-04,2022-05-04,,Coffee Shop,12.39,0.00,2681590.13
5814,2022-05-05,2022-05-04,,Transfer Received,0.00,2530.93,2684121.06
5815,2022-05-04,2022-05-04,,Investment Returns,0.00,584.44,2684705.50
5816,2022-05-04,2022-05-04,,Groceries - Supermarket,107.86,0.00,2684597.64
5817,2022-05-05,2022-05-05,,Groceries - Supermarket,198.59,0.00,2684399.05
5818,2022-05-05,2022-05-05,,Transfer Received,0.00,1865.85,2686264.90
5819,2022-05-05,2022-05-05,,Groceries - Supermarket,115.25,0.00,2686149.65
5820,2022-05-05,2022-05-05,,Salary Credit,0.00,3135.73,2689285.38
5821,2022-05-05,2022-05-05,,Dividend Received,0.00,82.92,2689368.30
5822,2022-05-04,2022-05-05,,Transfer Received,0.00,2564.27,2691932.57
5823,2022-05-05,2022-05-05,,Credit Card Payment,314.20,0.00,2691618.37
5824,2022-05-06,2022-05-06,100142,Cheque Issued,1241.90,0.00,2690376.47
5825,2022-05-06,2022-05-06,,Utility Payment,191.70,0.00,2690184.77
5826,2022-05-06,2022-05-06,,Transfer Received,0.00,2974.45,2693159.22
5827,2022-05-06,2022-05-06,,Transfer Received,0.00,1468.30,2694627.52
5828,2022-05-08,2022-05-07,,Dividend Received,0.00,377.76,2695005.28
5829,2022-05-07,2022-05-07,,Cash Deposit,0.00,227.02,2695232.30
5830,2022-05-07,2022-05-07,,Groceries - Supermarket,124.26,0.00,2695108.04
5831,2022-05-07,2022-05-07,,Dining Out,30.64,0.00,2695077.40
5832,2022-05-07,2022-05-07,,Transfer Received,0.00,1893.73,2696971.13
5833,2022-05-08,2022-05-08,,Transfer Received,0.00,2481.15,2699452.28
5834,2022-05-08,2022-05-08,,Groceries - Supermarket,119.38,0.00,2699332.90
5835,2022-05-08,2022-05-08,,ATM Withdrawal,175.32,0.00,2699157.58
5836,2022-05-09,2022-05-08,100143,Cheque Issued,2531.07,0.00,2696626.51
5837,2022-05-09,2022-05-09,,Salary Credit,0.00,3684.32,2700310.83
5838,2022-05-09,2022-05-09,,Investment - Stocks,2140.13,0.00,2698170.70
5839,2022-05-09,2022-05-09,100144,Cheque Issued,1821.73,0.00,2696348.97
5840,2022-05-09,2022-05-09,,Utility Payment,120.11,0.00,2696228.86
5841,2022-05-10,2022-05-09,,Transfer Received,0.00,1680.54,2697909.40
5842,2022-05-10,2022-05-09,,Salary Credit,0.00,2902.10,2700811.50
5843,2022-05-10,2022-05-10,,Loan EMI,757.51,0.00,2700053.99
5844,2022-05-09,2022-05-10,,Rental Income,0.00,1897.60,2701951.59
5845,2022-05-10,2022-05-10,,Transfer Received,0.00,2660.92,2704612.51
5846,2022-05-10,2022-05-10,,Dining Out,33.90,0.00,2704578.61
5847,2022-05-10,2022-05-10,,Online Transfer,1278.85,0.00,2703299.76
5848,2022-05-10,2022-05-10,,Investment Returns,0.00,324.67,2703624.43
5849,2022-05-10,2022-05-10,,Loan EMI,1282.91,0.00,2702341.52
5850,2022-05-10,2022-05-10,,Interest Credited,0.00,79.21,2702420.73
5851,2022-05-12,2022-05-11,,Salary Credit,0.00,4706.82,2707127.55
5852,2022-05-11,2022-05-11,,Groceries - Supermarket,85.32,0.00,2707042.23
5853,2022-05-12,2022-05-11,,ATM Withdrawal,222.45,0.00,2706819.78
5854,2022-05-11,2022-05-11,,Cash Deposit,0.00,658.56,2707478.34
5855,2022-05-12,2022-05-12,,ATM Withdrawal,389.53,0.00,2707088.81
5856,2022-05-12,2022-05-12,,Salary Credit,0.00,4620.11,2711708.92
5857,2022-05-12,2022-05-12,,ATM Withdrawal,317.81,0.00,2711391.11
5858,2022-05-12,2022-05-12,,Transfer Received,0.00,2657.36,2714048.47
5859,2022-05-13,2022-05-12,,Transfer Received,0.00,2736.66,2716785.13
5860,2022-05-12,2022-05-13,,Transfer Received,0.00,1524.50,2718309.63
5861,2022-05-13,2022-05-13,,Credit Card Payment,699.76,0.00,2717609.87
5862,2022-05-13,2022-05-13,,Transfer Received,0.00,980.74,2718590.61
5863,2022-05-13,2022-05-13,,ATM Withdrawal,345.67,0.00,2718244.94
5864,2022-05-13,2022-05-13,,Transfer Received,0.00,1012.26,2719257.20
5865,2022-05-13,2022-05-13,,Credit Card Payment,603.37,0.00,2718653.83
5866,2022-05-14,2022-05-13,,Transfer Received,0.00,1266.13,2719919.96
5867,2022-05-13,2022-05-13,100145,Cheque Issued,2812.40,0.00,2717107.56
5868,2022-05-12,2022-05-13,,Transfer Received,0.00,1532.17,2718639.73
5869,2022-05-14,2022-05-14,,Groceries - Supermarket,40.21,0.00,2718599.52
5870,2022-05-14,2022-05-14,,Dividend Received,0.00,246.99,2718846.51
5871,2022-05-14,2022-05-14,,ATM Withdrawal,126.70,0.00,2718719.81
5872,2022-05-14,2022-05-14,,Groceries - Supermarket,115.11,0.00,2718604.70
5873,2022-05-14,2022-05-14,,ATM Withdrawal,22.84,0.00,2718581.86
5874,2022-05-14,2022-05-14,,Credit Card Payment,470.78,0.00,2718111.08
5875,2022-05-14,2022-05-14,,Transfer Received,0.00,2306.52,2720417.60
5876,2022-05-14,2022-05-15,,Utility Payment,137.60,0.00,2720280.00
5877,2022-05-14,2022-05-15,,Salary Credit,0.00,2816.82,2723096.82
5878,2022-05-15,2022-05-15,,Transfer Received,0.00,1120.66,2724217.48
5879,2022-05-15,2022-05-15,,Dining Out,80.84,0.00,2724136.64
5880,2022-05-16,2022-05-15,,Salary Credit,0.00,2138.17,2726274.81
5881,2022-05-15,2022-05-15,,ATM Withdrawal,73.10,0.00,2726201.71
5882,2022-05-16,2022-05-16,,Online Transfer,1629.90,0.00,2724571.81
5883,2022-05-15,2022-05-16,,Groceries - Online Delivery,102.86,0.00,2724468.95
5884,2022-05-16,2022-05-16,,ATM Withdrawal,298.13,0.00,2724170.82
5885,2022-05-17,2022-05-17,,Interest Credited,0.00,81.93,2724252.75
5886,2022-05-17,2022-05-17,,Groceries - Supermarket,194.14,0.00,2724058.61
5887,2022-05-17,2022-05-17,,Transfer Received,0.00,2116.96,2726175.57
5888,2022-05-17,2022-05-17,100146,Cheque Issued,1477.34,0.00,2724698.23
5889,2022-05-18,2022-05-18,,ATM Withdrawal,142.16,0.00,2724556.07
5890,2022-05-18,2022-05-18,,Loan EMI,1345.22,0.00,2723210.85
5891,2022-05-18,2022-05-18,,Credit Card Payment,629.03,0.00,2722581.82
5892,2022-05-18,2022-05-18,,Salary Credit,0.00,4185.63,2726767.45
5893,2022-05-19,2022-05-18,,Investment Returns,0.00,95.70,2726863.15
5894,2022-05-18,2022-05-18,,Groceries - Online Delivery,87.13,0.00,2726776.02
5895,2022-05-17,2022-05-18,,Credit Card Payment,687.26,0.00,2726088.76
5896,2022-05-18,2022-05-18,,Credit Card Payment,938.65,0.00,2725150.11
5897,2022-05-19,2022-05-19,,Loan EMI,700.98,0.00,2724449.13
5898,2022-05-18,2022-05-19,,Transfer Received,0.00,726.30,2725175.43
5899,2022-05-19,2022-05-19,,Groceries - Supermarket,160.96,0.00,2725014.47
5900,2022-05-19,2022-05-19,,Dividend Received,0.00,181.30,2725195.77
5901,2022-05-19,2022-05-19,,Rental Income,0.00,1789.58,2726985.35
5902,2022-05-19,2022-05-19,,Transfer Received,0.00,1885.15,2728870.50
5903,2022-05-19,2022-05-19,,Transfer Received,0.00,1863.59,2730734.09
5904,2022-05-19,2022-05-19,,Transfer Received,0.00,1868.12,2732602.21
5905,2022-05-21,2022-05-21,,Utility Payment,185.50,0.00,2732416.71
5906,2022-05-21,2022-05-21,,Dining Out,95.53,0.00,2732321.18
5907,2022-05-22,2022-05-21,,ATM Withdrawal,343.48,0.00,2731977.70
5908,2022-05-21,2022-05-21,,Interest Credited,0.00,74.11,2732051.81
5909,2022-05-22,2022-05-21,,Transfer Received,0.00,545.14,2732596.95
5910,2022-05-21,2022-05-21,,Transfer Received,0.00,2035.83,2734632.78
5911,2022-05-21,2022-05-21,,Credit Card Payment,991.21,0.00,2733641.57
5912,2022-05-22,2022-05-21,,Credit Card Payment,420.93,0.00,2733220.64
5913,2022-05-22,2022-05-21,,Investment Returns,0.00,775.31,2733995.95
5914,2022-05-23,2022-05-22,,Credit Card Payment,548.48,0.00,2733447.47
5915,2022-05-22,2022-05-22,,Online Transfer,978.34,0.00,2732469.13
5916,2022-05-22,2022-05-22,,Salary Credit,0.00,3806.49,2736275.62
5917,2022-05-22,2022-05-22,,Online Transfer,883.28,0.00,2735392.34
5918,2022-05-21,2022-05-22,,Transfer Received,0.00,830.67,2736223.01
5919,2022-05-22,2022-05-22,,Utility Payment,176.64,0.00,2736046.37
5920,2022-05-22,2022-05-22,,Investment - Mutual Funds,2669.92,0.00,2733376.45
5921,2022-05-24,2022-05-23,,ATM Withdrawal,26.74,0.00,2733349.71
5922,2022-05-23,2022-05-23,,Credit Card Payment,923.91,0.00,2732425.80
5923,2022-05-24,2022-05-23,,Online Transfer,1969.52,0.00,2730456.28
5924,2022-05-23,2022-05-23,,Investment - Mutual Funds,881.91,0.00,2729574.37
5925,2022-05-24,2022-05-23,,Investment Returns,0.00,121.26,2729695.63
5926,2022-05-22,2022-05-23,,Online Transfer,1903.81,0.00,2727791.82
5927,2022-05-23,2022-05-23,,ATM Withdrawal,222.68,0.00,2727569.14
5928,2022-05-22,2022-05-23,,Transfer Received,0.00,2258.51,2729827.65
5929,2022-05-23,2022-05-23,,Investment Returns,0.00,305.85,2730133.50
5930,2022-05-24,2022-05-24,,Utility Payment,205.52,0.00,2729927.98
5931,2022-05-24,2022-05-24,,Credit Card Payment,461.86,0.00,2729466.12
5932,2022-05-24,2022-05-24,,Salary Credit,0.00,4771.96,2734238.08
5933,2022-05-25,2022-05-24,,Transfer Received,0.00,1168.75,2735406.83
5934,2022-05-24,2022-05-24,,Online Transfer,578.19,0.00,2734828.64
5935,2022-05-24,2022-05-24,,Dining Out,88.18,0.00,2734740.46
5936,2022-05-24,2022-05-25,,Transfer Received,0.00,2989.13,2737729.59
5937,2022-05-25,2022-05-25,,Utility Payment,290.81,0.00,2737438.78
5938,2022-05-24,2022-05-25,,Utility Payment,65.98,0.00,2737372.80
5939,2022-05-24,2022-05-25,,Salary Credit,0.00,4810.10,2742182.90
5940,2022-05-26,2022-05-26,,Utility Payment,168.99,0.00,2742013.91
5941,2022-05-26,2022-05-26,,Interest Credited,0.00,15.32,2742029.23
5942,2022-05-27,2022-05-26,,Coffee Shop,19.53,0.00,2742009.70
5943,2022-05-27,2022-05-26,,Salary Credit,0.00,4334.63,2746344.33
5944,2022-05-26,2022-05-26,,Salary Credit,0.00,3553.86,2749898.19
5945,2022-05-26,2022-05-26,,Online Transfer,1633.58,0.00,2748264.61
5946,2022-05-26,2022-05-26,,Transfer Received,0.00,2585.40,2750850.01
5947,2022-05-26,2022-05-26,,Online Transfer,603.22,0.00,2750246.79
5948,2022-05-26,2022-05-26,,Online Transfer,1323.60,0.00,2748923.19
5949,2022-05-26,2022-05-26,,Transfer Received,0.00,2775.84,2751699.03
5950,2022-05-25,2022-05-26,,Transfer Received,0.00,1903.54,2753602.57
5951,2022-05-27,2022-05-27,,ATM Withdrawal,340.13,0.00,2753262.44
5952,2022-05-28,2022-05-27,,Groceries - Supermarket,91.89,0.00,2753170.55
5953,2022-05-27,2022-05-27,,Credit Card Payment,708.92,0.00,2752461.63
5954,2022-05-27,2022-05-27,,Cash Deposit,0.00,737.84,2753199.47
5955,2022-05-27,2022-05-27,,Investment Returns,0.00,966.83,2754166.30
5956,2022-05-28,2022-05-28,,Utility Payment,113.30,0.00,2754053.00
5957,2022-05-29,2022-05-28,,ATM Withdrawal,171.80,0.00,2753881.20
5958,2022-05-29,2022-05-28,,Groceries - Supermarket,117.97,0.00,2753763.23
5959,2022-05-28,2022-05-28,,Transfer Received,0.00,2969.36,2756732.59
5960,2022-05-28,2022-05-28,,Utility Payment,273.59,0.00,2756459.00
5961,2022-05-29,2022-05-29,,Utility Payment,99.36,0.00,2756359.64
5962,2022-05-30,2022-05-29,,ATM Withdrawal,334.70,0.00,2756024.94
5963,2022-05-29,2022-05-29,,Transfer Received,0.00,2264.30,2758289.24
5964,2022-05-29,2022-05-29,,ATM Withdrawal,183.41,0.00,2758105.83
5965,2022-05-29,2022-05-29,,Credit Card Payment,395.78,0.00,2757710.05
5966,2022-05-30,2022-05-30,,ATM Withdrawal,290.81,0.00,2757419.24
5967,2022-05-29,2022-05-30,,Salary Credit,0.00,2953.34,2760372.58
5968,2022-05-30,2022-05-30,,Utility Payment,70.02,0.00,2760302.56
5969,2022-05-30,2022-05-30,,Investment - SIP,195.86,0.00,2760106.70
5970,2022-05-29,2022-05-30,,Online Transfer,1451.99,0.00,2758654.71
5971,2022-05-31,2022-05-30,,Groceries - Supermarket,77.56,0.00,2758577.15
5972,2022-05-31,2022-05-30,,Salary Credit,0.00,3491.43,2762068.58
5973,2022-05-30,2022-05-30,,Interest Credited,0.00,68.22,2762136.80
5974,2022-05-30,2022-05-30,,Transfer Received,0.00,2477.27,2764614.07
5975,2022-05-31,2022-05-31,,Salary Credit,0.00,3273.24,2767887.31
5976,2022-05-31,2022-05-31,,ATM Withdrawal,463.31,0.00,2767424.00
5977,2022-05-31,2022-05-31,,Daily Essentials,28.72,0.00,2767395.28
5978,2022-05-30,2022-05-31,,ATM Withdrawal,51.67,0.00,2767343.61
5979,2022-05-31,2022-05-31,,Utility Payment,167.65,0.00,2767175.96
5980,2022-05-31,2022-05-31,,Groceries - Supermarket,30.10,0.00,2767145.86
5981,2022-06-01,2022-06-01,,Rental Income,0.00,1168.77,2768314.63
5982,2022-06-01,2022-06-01,,Transfer Received,0.00,1999.62,2770314.25
5983,2022-06-01,2022-06-01,,Groceries - Supermarket,140.99,0.00,2770173.26
5984,2022-06-01,2022-06-01,,Utility Payment,186.62,0.00,2769986.64
5985,2022-05-31,2022-06-01,,Online Transfer,587.36,0.00,2769399.28
5986,2022-06-02,2022-06-02,,Salary Credit,0.00,2412.74,2771812.02
5987,2022-06-02,2022-06-02,,Credit Card Payment,681.30,0.00,2771130.72
5988,2022-06-02,2022-06-02,,Salary Credit,0.00,3489.31,2774620.03
5989,2022-06-02,2022-06-02,,Salary Credit,0.00,2952.32,2777572.35
5990,2022-06-02,2022-06-02,,Groceries - Supermarket,85.12,0.00,2777487.23
5991,2022-06-02,2022-06-02,,Utility Payment,131.23,0.00,2777356.00
5992,2022-06-02,2022-06-02,,Groceries - Online Delivery,87.87,0.00,2777268.13
5993,2022-06-02,2022-06-02,,Dividend Received,0.00,447.00,2777715.13
5994,2022-06-02,2022-06-02,,Online Transfer,1367.64,0.00,2776347.49
5995,2022-06-02,2022-06-02,,Utility Payment,149.53,0.00,2776197.96
5996,2022-06-04,2022-06-03,,Groceries - Supermarket,146.77,0.00,2776051.19
5997,2022-06-03,2022-06-03,,Loan EMI,1289.72,0.00,2774761.47
5998,2022-06-04,2022-06-03,,Transfer Received,0.00,2946.07,2777707.54
5999,2022-06-03,2022-06-03,,Cash Deposit,0.00,979.16,2778686.70
6000,2022-06-03,2022-06-03,,Rental Income,0.00,2753.32,2781440.02
6001,2022-06-04,2022-06-03,,Transfer Received,0.00,2680.30,2784120.32
6002,2022-06-03,2022-06-03,,Salary Credit,0.00,3792.36,2787912.68
6003,2022-06-03,2022-06-03,,Utility Payment,197.93,0.00,2787714.75
6004,2022-06-03,2022-06-03,,Daily Essentials,48.34,0.00,2787666.41
6005,2022-06-02,2022-06-03,,ATM Withdrawal,140.49,0.00,2787525.92
6006,2022-06-05,2022-06-04,,Transfer Received,0.00,1981.42,2789507.34
6007,2022-06-04,2022-06-04,,Salary Credit,0.00,4050.27,2793557.61
6008,2022-06-04,2022-06-04,,Utility Payment,252.16,0.00,2793305.45
6009,2022-06-05,2022-06-04,,Transfer Received,0.00,917.09,2794222.54
6010,2022-06-03,2022-06-04,,Transfer Received,0.00,1357.67,2795580.21
6011,2022-06-05,2022-06-04,,Credit Card Payment,348.28,0.00,2795231.93
6012,2022-06-05,2022-06-04,,Transfer Received,0.00,1773.36,2797005.29
6013,2022-06-04,2022-06-04,,Transfer Received,0.00,1593.89,2798599.18
6014,2022-06-06,2022-06-05,,Online Transfer,1228.29,0.00,2797370.89
6015,2022-06-06,2022-06-05,,ATM Withdrawal,252.46,0.00,2797118.43
6016,2022-06-05,2022-06-05,,Utility Payment,157.99,0.00,2796960.44
6017,2022-06-05,2022-06-05,,Utility Payment,296.34,0.00,2796664.10
6018,2022-06-06,2022-06-05,,Transfer Received,0.00,1092.55,2797756.65
6019,2022-06-06,2022-06-05,,Transfer Received,0.00,1807.90,2799564.55
6020,2022-06-06,2022-06-06,,ATM Withdrawal,189.06,0.00,2799375.49
6021,2022-06-06,2022-06-06,,Transfer Received,0.00,1653.38,2801028.87
6022,2022-06-05,2022-06-06,,ATM Withdrawal,146.73,0.00,2800882.14
6023,2022-06-07,2022-06-06,,Groceries - Supermarket,91.10,0.00,2800791.04
6024,2022-06-07,2022-06-07,,Coffee Shop,14.65,0.00,2800776.39
6025,2022-06-07,2022-06-07,,Dining Out,36.47,0.00,2800739.92
6026,2022-06-06,2022-06-07,,Salary Credit,0.00,2209.91,2802949.83
6027,2022-06-07,2022-06-07,,Transfer Received,0.00,2306.33,2805256.16
6028,2022-06-06,2022-06-07,,Takeout,26.06,0.00,2805230.10
6029,2022-06-08,2022-06-07,,Dividend Received,0.00,426.55,2805656.65
6030,2022-06-08,2022-06-07,,Salary Credit,0.00,3900.35,2809557.00
6031,2022-06-08,2022-06-08,,Takeout,32.16,0.00,2809524.84
6032,2022-06-08,2022-06-08,,Online Transfer,1813.63,0.00,2807711.21
6033,2022-06-08,2022-06-08,,Groceries - Supermarket,197.22,0.00,2807513.99
6034,2022-06-09,2022-06-08,,Salary Credit,0.00,3567.40,2811081.39
6035,2022-06-07,2022-06-08,,Transfer Received,0.00,1593.62,2812675.01
6036,2022-06-08,2022-06-08,,Groceries - Supermarket,136.99,0.00,2812538.02
6037,2022-06-09,2022-06-09,,Credit Card Payment,940.97,0.00,2811597.05
6038,2022-06-09,2022-06-09,,ATM Withdrawal,346.81,0.00,2811250.24
6039,2022-06-08,2022-06-09,,ATM Withdrawal,334.55,0.00,2810915.69
6040,2022-06-09,2022-06-09,,ATM Withdrawal,211.26,0.00,2810704.43
6041,2022-06-09,2022-06-09,,ATM Withdrawal,230.76,0.00,2810473.67
6042,2022-06-08,2022-06-09,,Investment Returns,0.00,690.90,2811164.57
6043,2022-06-09,2022-06-09,,ATM Withdrawal,162.13,0.00,2811002.44
6044,2022-06-09,2022-06-09,,Loan EMI,843.30,0.00,2810159.14
6045,2022-06-09,2022-06-10,,Online Transfer,426.28,0.00,2809732.86
6046,2022-06-10,2022-06-10,,Utility Payment,102.90,0.00,2809629.96
6047,2022-06-09,2022-06-10,,ATM Withdrawal,415.24,0.00,2809214.72
6048,2022-06-11,2022-06-10,,Loan EMI,1742.14,0.00,2807472.58
6049,2022-06-10,2022-06-11,,Transfer Received,0.00,2907.43,2810380.01
6050,2022-06-11,2022-06-11,,Groceries - Supermarket,143.55,0.00,2810236.46
6051,2022-06-11,2022-06-11,,ATM Withdrawal,55.68,0.00,2810180.78
6052,2022-06-11,2022-06-11,,Transfer Received,0.00,648.48,2810829.26
6053,2022-06-11,2022-06-11,,Interest Credited,0.00,12.55,2810841.81
6054,2022-06-10,2022-06-11,,Investment - Stocks,1398.67,0.00,2809443.14
6055,2022-06-11,2022-06-11,,Online Transfer,1981.07,0.00,2807462.07
6056,2022-06-11,2022-06-11,,Online Transfer,998.58,0.00,2806463.49
6057,2022-06-11,2022-06-11,,Investment - Stocks,4500.40,0.00,2801963.09
6058,2022-06-12,2022-06-12,,Utility Payment,294.10,0.00,2801668.99
6059,2022-06-12,2022-06-12,,Investment - Stocks,3662.81,0.00,2798006.18
6060,2022-06-13,2022-06-12,,ATM Withdrawal,188.86,0.00,2797817.32
6061,2022-06-12,2022-06-12,,Transfer Received,0.00,722.82,2798540.14
6062,2022-06-12,2022-06-12,,Groceries - Supermarket,42.51,0.00,2798497.63
6063,2022-06-13,2022-06-12,,Transfer Received,0.00,2512.81,2801010.44
6064,2022-06-12,2022-06-13,,Credit Card Payment,761.65,0.00,2800248.79
6065,2022-06-12,2022-06-13,,Investment - Stocks,866.88,0.00,2799381.91
6066,2022-06-12,2022-06-13,,Utility Payment,142.21,0.00,2799239.70
6067,2022-06-14,2022-06-13,,Transfer Received,0.00,2684.10,2801923.80
6068,2022-06-13,2022-06-13,,Online Transfer,450.91,0.00,2801472.89
6069,2022-06-13,2022-06-13,,ATM Withdrawal,295.47,0.00,2801177.42
6070,2022-06-13,2022-06-14,,Investment - SIP,237.08,0.00,2800940.34
6071,2022-06-13,2022-06-14,,Rental Income,0.00,1885.01,2802825.35
6072,2022-06-14,2022-06-14,,Salary Credit,0.00,3465.76,2806291.11
6073,2022-06-15,2022-06-14,,ATM Withdrawal,351.17,0.00,2805939.94
6074,2022-06-14,2022-06-14,,Salary Credit,0.00,3916.09,2809856.03
6075,2022-06-15,2022-06-14,,Credit Card Payment,270.89,0.00,2809585.14
6076,2022-06-14,2022-06-14,,Transfer Received,0.00,1789.74,2811374.88
6077,2022-06-14,2022-06-14,,Credit Card Payment,510.84,0.00,2810864.04
6078,2022-06-14,2022-06-15,,Loan EMI,1887.18,0.00,2808976.86
6079,2022-06-14,2022-06-15,,Online Transfer,892.90,0.00,2808083.96
6080,2022-06-15,2022-06-15,,Transfer Received,0.00,1040.32,2809124.28
6081,2022-06-15,2022-06-15,,Groceries - Supermarket,124.46,0.00,2808999.82
6082,2022-06-17,2022-06-16,,Dividend Received,0.00,53.39,2809053.21
6083,2022-06-16,2022-06-16,,Transfer Received,0.00,2147.14,2811200.35
6084,2022-06-16,2022-06-16,,Dining Out,54.18,0.00,2811146.17
6085,2022-06-15,2022-06-16,,Loan EMI,1831.60,0.00,2809314.57
6086,2022-06-16,2022-06-16,,Salary Credit,0.00,4380.29,2813694.86
6087,2022-06-17,2022-06-17,,ATM Withdrawal,150.80,0.00,2813544.06
6088,2022-06-17,2022-06-17,,ATM Withdrawal,428.41,0.00,2813115.65
6089,2022-06-17,2022-06-17,,Groceries - Supermarket,30.78,0.00,2813084.87
6090,2022-06-17,2022-06-17,,Transfer Received,0.00,1652.06,2814736.93
6091,2022-06-16,2022-06-17,,Transfer Received,0.00,748.86,2815485.79
6092,2022-06-17,2022-06-17,100147,Cheque Issued,928.43,0.00,2814557.36
6093,2022-06-18,2022-06-17,,ATM Withdrawal,478.67,0.00,2814078.69
6094,2022-06-16,2022-06-17,,Salary Credit,0.00,2409.99,2816488.68
6095,2022-06-18,2022-06-17,,ATM Withdrawal,445.02,0.00,2816043.66
6096,2022-06-17,2022-06-17,,Dining Out,68.48,0.00,2815975.18
6097,2022-06-17,2022-06-17,100148,Cheque Issued,1577.53,0.00,2814397.65
6098,2022-06-18,2022-06-18,,Salary Credit,0.00,4508.81,2818906.46
6099,2022-06-18,2022-06-18,,Groceries - Supermarket,84.78,0.00,2818821.68
6100,2022-06-18,2022-06-18,,ATM Withdrawal,494.34,0.00,2818327.34
6101,2022-06-19,2022-06-18,,Utility Payment,134.92,0.00,2818192.42
6102,2022-06-18,2022-06-18,,Groceries - Supermarket,88.55,0.00,2818103.87
6103,2022-06-18,2022-06-18,,Groceries - Online Delivery,100.02,0.00,2818003.85
6104,2022-06-18,2022-06-18,,Loan EMI,1640.13,0.00,2816363.72
6105,2022-06-17,2022-06-18,,Groceries - Online Delivery,62.85,0.00,2816300.87
6106,2022-06-18,2022-06-18,,Utility Payment,63.91,0.00,2816236.96
6107,2022-06-18,2022-06-19,,Investment Returns,0.00,181.90,2816418.86
6108,2022-06-19,2022-06-19,,Salary Credit,0.00,2337.39,2818756.25
6109,2022-06-19,2022-06-19,,Salary Credit,0.00,4606.42,2823362.67
6110,2022-06-20,2022-06-19,,Credit Card Payment,881.71,0.00,2822480.96
6111,2022-06-20,2022-06-20,100149,Cheque Issued,2015.26,0.00,2820465.70
6112,2022-06-21,2022-06-20,,Groceries - Supermarket,26.67,0.00,2820439.03
6113,2022-06-19,2022-06-20,,Utility Payment,280.83,0.00,2820158.20
6114,2022-06-20,2022-06-20,,Loan EMI,733.61,0.00,2819424.59
6115,2022-06-21,2022-06-20,,ATM Withdrawal,71.73,0.00,2819352.86
6116,2022-06-21,2022-06-20,,Coffee Shop,19.05,0.00,2819333.81
6117,2022-06-20,2022-06-20,,ATM Withdrawal,215.35,0.00,2819118.46
6118,2022-06-21,2022-06-21,,Salary Credit,0.00,4194.96,2823313.42
6119,2022-06-21,2022-06-21,,Salary Credit,0.00,2994.31,2826307.73
6120,2022-06-21,2022-06-21,,Transfer Received,0.00,1036.11,2827343.84
6121,2022-06-20,2022-06-21,,Investment - Mutual Funds,1476.77,0.00,2825867.07
6122,2022-06-22,2022-06-21,,Takeout,12.38,0.00,2825854.69
6123,2022-06-22,2022-06-21,,Daily Essentials,35.51,0.00,2825819.18
6124,2022-06-21,2022-06-21,,Groceries - Supermarket,27.26,0.00,2825791.92
6125,2022-06-22,2022-06-21,100150,Cheque Issued,2870.61,0.00,2822921.31
6126,2022-06-22,2022-06-22,,Dividend Received,0.00,374.78,2823296.09
6127,2022-06-22,2022-06-22,,ATM Withdrawal,23.68,0.00,2823272.41
6128,2022-06-22,2022-06-22,,Takeout,19.34,0.00,2823253.07
6129,2022-06-22,2022-06-22,,Groceries - Online Delivery,52.38,0.00,2823200.69
6130,2022-06-22,2022-06-22,,Utility Payment,134.23,0.00,2823066.46
6131,2022-06-22,2022-06-22,,Daily Essentials,33.45,0.00,2823033.01
6132,2022-06-22,2022-06-22,,Transfer Received,0.00,2360.31,2825393.32
6133,2022-06-21,2022-06-22,,ATM Withdrawal,483.48,0.00,2824909.84
6134,2022-06-22,2022-06-22,,Credit Card Payment,653.22,0.00,2824256.62
6135,2022-06-22,2022-06-23,,Investment Returns,0.00,125.04,2824381.66
6136,2022-06-23,2022-06-23,,ATM Withdrawal,66.08,0.00,2824315.58
6137,2022-06-23,2022-06-23,,Coffee Shop,9.44,0.00,2824306.14
6138,2022-06-22,2022-06-23,,Groceries - Supermarket,88.59,0.00,2824217.55
6139,2022-06-23,2022-06-23,,Online Transfer,179.42,0.00,2824038.13
6140,2022-06-23,2022-06-23,,Groceries - Supermarket,192.54,0.00,2823845.59
6141,2022-06-23,2022-06-23,,Salary Credit,0.00,2416.72,2826262.31
6142,2022-06-23,2022-06-23,,Transfer Received,0.00,693.61,2826955.92
6143,2022-06-24,2022-06-23,,Transfer Received,0.00,2602.14,2829558.06
6144,2022-06-24,2022-06-24,,Transfer Received,0.00,2049.78,2831607.84
6145,2022-06-24,2022-06-24,,Utility Payment,205.95,0.00,2831401.89
6146,2022-06-23,2022-06-24,,Loan EMI,1983.88,0.00,2829418.01
6147,2022-06-24,2022-06-24,,Interest Credited,0.00,80.64,2829498.65
6148,2022-06-24,2022-06-24,,Transfer Received,0.00,1078.90,2830577.55
6149,2022-06-24,2022-06-24,,Utility Payment,187.55,0.00,2830390.00
6150,2022-06-24,2022-06-24,,Transfer Received,0.00,2480.51,2832870.51
6151,2022-06-25,2022-06-24,,ATM Withdrawal,34.40,0.00,2832836.11
6152,2022-06-24,2022-06-24,,Dining Out,44.80,0.00,2832791.31
6153,2022-06-24,2022-06-24,,Transfer Received,0.00,1638.94,2834430.25
6154,2022-06-24,2022-06-24,,ATM Withdrawal,58.81,0.00,2834371.44
6155,2022-06-24,2022-06-24,,Investment Returns,0.00,924.52,2835295.96
6156,2022-06-26,2022-06-25,,Dining Out,37.59,0.00,2835258.37
6157,2022-06-24,2022-06-25,,Investment Returns,0.00,981.85,2836240.22
6158,2022-06-25,2022-06-25,,Groceries - Supermarket,161.11,0.00,2836079.11
6159,2022-06-25,2022-06-25,,Salary Credit,0.00,3041.48,2839120.59
6160,2022-06-24,2022-06-25,,Investment - SIP,384.93,0.00,2838735.66
6161,2022-06-25,2022-06-25,,Dividend Received,0.00,321.03,2839056.69
6162,2022-06-25,2022-06-25,,ATM Withdrawal,201.52,0.00,2838855.17
6163,2022-06-25,2022-06-25,,Online Transfer,1955.62,0.00,2836899.55
6164,2022-06-27,2022-06-26,,Salary Credit,0.00,4777.60,2841677.15
6165,2022-06-26,2022-06-26,,ATM Withdrawal,68.66,0.00,2841608.49
6166,2022-06-26,2022-06-26,,Investment Returns,0.00,207.84,2841816.33
6167,2022-06-27,2022-06-26,,Credit Card Payment,972.33,0.00,2840844.00
6168,2022-06-25,2022-06-26,,Loan EMI,563.25,0.00,2840280.75
6169,2022-06-27,2022-06-26,,Investment - Mutual Funds,1925.83,0.00,2838354.92
6170,2022-06-26,2022-06-26,,Transfer Received,0.00,806.01,2839160.93
6171,2022-06-26,2022-06-26,,Coffee Shop,5.28,0.00,2839155.65
6172,2022-06-26,2022-06-26,,Online Transfer,1487.04,0.00,2837668.61
6173,2022-06-27,2022-06-26,,Online Transfer,1450.77,0.00,2836217.84
6174,2022-06-27,2022-06-27,,Salary Credit,0.00,2680.16,2838898.00
6175,2022-06-27,2022-06-27,,Transfer Received,0.00,757.56,2839655.56
6176,2022-06-27,2022-06-27,,Investment - SIP,830.67,0.00,2838824.89
6177,2022-06-27,2022-06-27,,Salary Credit,0.00,3072.80,2841897.69
6178,2022-06-26,2022-06-27,,Salary Credit,0.00,2927.26,2844824.95
6179,2022-06-27,2022-06-27,,Transfer Received,0.00,1510.66,2846335.61
6180,2022-06-27,2022-06-27,,Loan EMI,663.56,0.00,2845672.05
6181,2022-06-28,2022-06-27,,Groceries - Supermarket,96.75,0.00,2845575.30
6182,2022-06-27,2022-06-27,,ATM Withdrawal,307.10,0.00,2845268.20
6183,2022-06-28,2022-06-27,100151,Cheque Issued,2759.45,0.00,2842508.75
6184,2022-06-26,2022-06-27,,Transfer Received,0.00,2540.15,2845048.90
6185,2022-06-28,2022-06-28,,Online Transfer,565.88,0.00,2844483.02
6186,2022-06-28,2022-06-28,,Groceries - Supermarket,117.37,0.00,2844365.65
6187,2022-06-28,2022-06-28,,ATM Withdrawal,88.26,0.00,2844277.39
6188,2022-06-28,2022-06-28,,Investment - Stocks,730.84,0.00,2843546.55
6189,2022-06-28,2022-06-28,,Groceries - Supermarket,147.18,0.00,2843399.37
6190,2022-06-27,2022-06-28,,ATM Withdrawal,65.02,0.00,2843334.35
6191,2022-06-28,2022-06-28,,Transfer Received,0.00,2544.97,2845879.32
6192,2022-06-27,2022-06-28,,Utility Payment,229.83,0.00,2845649.49
6193,2022-06-29,2022-06-29,,Rental Income,0.00,2249.72,2847899.21
6194,2022-06-29,2022-06-29,100152,Cheque Issued,551.57,0.00,2847347.64
6195,2022-06-28,2022-06-29,,Salary Credit,0.00,3603.19,2850950.83
6196,2022-06-29,2022-06-29,,Credit Card Payment,438.10,0.00,2850512.73
6197,2022-06-28,2022-06-29,,Loan EMI,698.70,0.00,2849814.03
6198,2022-06-30,2022-06-30,,ATM Withdrawal,386.01,0.00,2849428.02
6199,2022-06-30,2022-06-30,,Transfer Received,0.00,2406.49,2851834.51
6200,2022-06-29,2022-06-30,,Transfer Received,0.00,891.59,2852726.10
6201,2022-07-01,2022-06-30,,Groceries - Online Delivery,117.38,0.00,2852608.72
6202,2022-07-01,2022-06-30,,Salary Credit,0.00,2477.65,2855086.37
6203,2022-06-30,2022-06-30,,Investment - Mutual Funds,1427.53,0.00,2853658.84
6204,2022-06-29,2022-06-30,,Rental Income,0.00,2236.71,2855895.55
6205,2022-06-30,2022-06-30,,Dining Out,46.83,0.00,2855848.72
6206,2022-06-30,2022-06-30,,Investment - SIP,141.38,0.00,2855707.34
6207,2022-06-30,2022-06-30,,Rental Income,0.00,2519.61,2858226.95
6208,2022-06-30,2022-07-01,,Credit Card Payment,749.56,0.00,2857477.39
6209,2022-07-01,2022-07-01,100153,Cheque Issued,2955.23,0.00,2854522.16
6210,2022-07-01,2022-07-01,,Transfer Received,0.00,1452.43,2855974.59
6211,2022-07-01,2022-07-01,,Utility Payment,88.69,0.00,2855885.90
6212,2022-07-01,2022-07-01,,Transfer Received,0.00,1588.23,2857474.13
6213,2022-07-02,2022-07-01,,Credit Card Payment,909.61,0.00,2856564.52
6214,2022-07-01,2022-07-01,,Credit Card Payment,975.83,0.00,2855588.69
6215,2022-07-02,2022-07-02,,Interest Credited,0.00,15.20,2855603.89
6216,2022-07-02,2022-07-02,,Coffee Shop,15.89,0.00,2855588.00
6217,2022-07-03,2022-07-02,,Utility Payment,198.33,0.00,2855389.67
6218,2022-07-03,2022-07-02,,ATM Withdrawal,185.31,0.00,2855204.36
6219,2022-07-02,2022-07-02,,ATM Withdrawal,456.94,0.00,2854747.42
6220,2022-07-02,2022-07-02,,Coffee Shop,8.27,0.00,2854739.15
6221,2022-07-03,2022-07-03,100154,Cheque Issued,2979.89,0.00,2851759.26
6222,2022-07-03,2022-07-03,,Utility Payment,149.10,0.00,2851610.16
6223,2022-07-03,2022-07-03,,Transfer Received,0.00,2795.26,2854405.42
6224,2022-07-03,2022-07-03,,Salary Credit,0.00,2239.32,2856644.74
6225,2022-07-04,2022-07-03,,Groceries - Supermarket,77.56,0.00,2856567.18
6226,2022-07-03,2022-07-04,,ATM Withdrawal,175.17,0.00,2856392.01
6227,2022-07-04,2022-07-04,,Salary Credit,0.00,3257.25,2859649.26
6228,2022-07-04,2022-07-04,,Credit Card Payment,809.80,0.00,2858839.46
6229,2022-07-04,2022-07-04,,Daily Essentials,21.52,0.00,2858817.94
6230,2022-07-04,2022-07-04,,Transfer Received,0.00,2219.70,2861037.64
6231,2022-07-05,2022-07-04,,Online Transfer,129.40,0.00,2860908.24
6232,2022-07-06,2022-07-05,,Transfer Received,0.00,2968.25,2863876.49
6233,2022-07-05,2022-07-05,,ATM Withdrawal,201.44,0.00,2863675.05
6234,2022-07-04,2022-07-05,,Interest Credited,0.00,33.47,2863708.52
6235,2022-07-05,2022-07-05,,ATM Withdrawal,239.10,0.00,2863469.42
6236,2022-07-05,2022-07-05,,Salary Credit,0.00,2836.17,2866305.59
6237,2022-07-06,2022-07-05,,Utility Payment,92.16,0.00,2866213.43
6238,2022-07-06,2022-07-06,,Salary Credit,0.00,3854.99,2870068.42
6239,2022-07-07,2022-07-06,100155,Cheque Issued,2024.94,0.00,2868043.48
6240,2022-07-06,2022-07-06,,Salary Credit,0.00,2546.83,2870590.31
6241,2022-07-06,2022-07-06,,ATM Withdrawal,196.34,0.00,2870393.97
6242,2022-07-06,2022-07-06,,Groceries - Online Delivery,118.23,0.00,2870275.74
6243,2022-07-06,2022-07-06,,Online Transfer,846.34,0.00,2869429.40
6244,2022-07-06,2022-07-07,,Daily Essentials,6.16,0.00,2869423.24
6245,2022-07-08,2022-07-07,,Utility Payment,103.60,0.00,2869319.64
6246,2022-07-07,2022-07-07,,Interest Credited,0.00,27.38,2869347.02
6247,2022-07-08,2022-07-08,,Salary Credit,0.00,2772.71,2872119.73
6248,2022-07-07,2022-07-08,,Investment - SIP,203.56,0.00,2871916.17
6249,2022-07-07,2022-07-08,,Online Transfer,767.09,0.00,2871149.08
6250,2022-07-09,2022-07-08,,Groceries - Supermarket,116.63,0.00,2871032.45
6251,2022-07-08,2022-07-08,,ATM Withdrawal,316.67,0.00,2870715.78
6252,2022-07-08,2022-07-08,,Loan EMI,893.24,0.00,2869822.54
6253,2022-07-08,2022-07-08,,Coffee Shop,9.00,0.00,2869813.54
6254,2022-07-09,2022-07-09,,ATM Withdrawal,108.60,0.00,2869704.94
6255,2022-07-09,2022-07-09,,Interest Credited,0.00,28.75,2869733.69
6256,2022-07-09,2022-07-09,,Transfer Received,0.00,2936.39,2872670.08
6257,2022-07-09,2022-07-09,,Transfer Received,0.00,2551.36,2875221.44
6258,2022-07-10,2022-07-10,,ATM Withdrawal,269.35,0.00,2874952.09
6259,2022-07-11,2022-07-10,,Credit Card Payment,378.76,0.00,2874573.33
6260,2022-07-10,2022-07-10,,Online Transfer,1257.35,0.00,2873315.98
6261,2022-07-11,2022-07-10,,Dining Out,83.64,0.00,2873232.34
6262,2022-07-09,2022-07-10,,Dividend Received,0.00,106.40,2873338.74
6263,2022-07-10,2022-07-10,,Transfer Received,0.00,2476.51,2875815.25
6264,2022-07-10,2022-07-10,,Transfer Received,0.00,1876.66,2877691.91
6265,2022-07-11,2022-07-11,,Salary Credit,0.00,2493.56,2880185.47
6266,2022-07-11,2022-07-11,,Salary Credit,0.00,3677.69,2883863.16
6267,2022-07-12,2022-07-11,,Dividend Received,0.00,306.32,2884169.48
6268,2022-07-11,2022-07-11,,ATM Withdrawal,212.78,0.00,2883956.70
6269,2022-07-10,2022-07-11,,ATM Withdrawal,368.28,0.00,2883588.42
6270,2022-07-11,2022-07-11,,Transfer Received,0.00,2447.87,2886036.29
6271,2022-07-11,2022-07-11,,Transfer Received,0.00,2079.99,2888116.28
6272,2022-07-11,2022-07-11,,Credit Card Payment,335.38,0.00,2887780.90
6273,2022-07-11,2022-07-11,,Groceries - Online Delivery,94.91,0.00,2887685.99
6274,2022-07-10,2022-07-11,,Dining Out,67.69,0.00,2887618.30
6275,2022-07-11,2022-07-11,,ATM Withdrawal,466.08,0.00,2887152.22
6276,2022-07-11,2022-07-12,,Daily Essentials,7.84,0.00,2887144.38
6277,2022-07-12,2022-07-12,,ATM Withdrawal,67.11,0.00,2887077.27
6278,2022-07-12,2022-07-12,,ATM Withdrawal,489.64,0.00,2886587.63
6279,2022-07-13,2022-07-13,,Groceries - Supermarket,33.91,0.00,2886553.72
6280,2022-07-13,2022-07-13,,ATM Withdrawal,214.19,0.00,2886339.53
6281,2022-07-13,2022-07-13,,Salary Credit,0.00,4513.43,2890852.96
6282,2022-07-13,2022-07-13,,Utility Payment,74.39,0.00,2890778.57
6283,2022-07-15,2022-07-14,,Transfer Received,0.00,1943.34,2892721.91
6284,2022-07-14,2022-07-14,,Salary Credit,0.00,2849.48,2895571.39
6285,2022-07-14,2022-07-14,,Interest Credited,0.00,19.03,2895590.42
6286,2022-07-14,2022-07-14,,Utility Payment,131.96,0.00,2895458.46
6287,2022-07-13,2022-07-14,100156,Cheque Issued,1519.48,0.00,2893938.98
6288,2022-07-13,2022-07-14,,Online Transfer,1692.29,0.00,2892246.69
6289,2022-07-14,2022-07-14,,Online Transfer,1370.74,0.00,2890875.95
6290,2022-07-14,2022-07-14,,Salary Credit,0.00,4186.39,2895062.34
6291,2022-07-14,2022-07-14,,Credit Card Payment,552.31,0.00,2894510.03
6292,2022-07-15,2022-07-14,,Transfer Received,0.00,2289.02,2896799.05
6293,2022-07-14,2022-07-14,,Groceries - Online Delivery,92.95,0.00,2896706.10
6294,2022-07-16,2022-07-15,,Online Transfer,1422.77,0.00,2895283.33
6295,2022-07-16,2022-07-15,,Dining Out,28.15,0.00,2895255.18
6296,2022-07-15,2022-07-15,,ATM Withdrawal,106.31,0.00,2895148.87
6297,2022-07-15,2022-07-15,,Transfer Received,0.00,1224.32,2896373.19
6298,2022-07-14,2022-07-15,,Utility Payment,139.66,0.00,2896233.53
6299,2022-07-16,2022-07-16,,ATM Withdrawal,125.11,0.00,2896108.42
6300,2022-07-16,2022-07-16,,Transfer Received,0.00,1681.31,2897789.73
6301,2022-07-16,2022-07-16,,Transfer Received,0.00,1377.69,2899167.42
6302,2022-07-16,2022-07-16,,Groceries - Online Delivery,91.66,0.00,2899075.76
6303,2022-07-16,2022-07-17,,Groceries - Supermarket,27.93,0.00,2899047.83
6304,2022-07-17,2022-07-17,,Salary Credit,0.00,2333.05,2901380.88
6305,2022-07-17,2022-07-17,,Interest Credited,0.00,94.78,2901475.66
6306,2022-07-17,2022-07-17,,Daily Essentials,48.45,0.00,2901427.21
6307,2022-07-17,2022-07-17,,ATM Withdrawal,483.66,0.00,2900943.55
6308,2022-07-17,2022-07-17,,Transfer Received,0.00,2495.04,2903438.59
6309,2022-07-17,2022-07-17,,Daily Essentials,33.18,0.00,2903405.41
6310,2022-07-18,2022-07-17,,Credit Card Payment,520.47,0.00,2902884.94
6311,2022-07-16,2022-07-17,,Salary Credit,0.00,4128.10,2907013.04
6312,2022-07-18,2022-07-18,,ATM Withdrawal,52.41,0.00,2906960.63
6313,2022-07-18,2022-07-18,,Credit Card Payment,757.62,0.00,2906203.01
6314,2022-07-18,2022-07-18,,Online Transfer,1604.44,0.00,2904598.57
6315,2022-07-17,2022-07-18,,Salary Credit,0.00,2133.90,2906732.47
6316,2022-07-18,2022-07-18,,Groceries - Supermarket,104.68,0.00,2906627.79
6317,2022-07-19,2022-07-18,,Transfer Received,0.00,1892.69,2908520.48
6318,2022-07-18,2022-07-18,,Salary Credit,0.00,4512.08,2913032.56
6319,2022-07-18,2022-07-18,,Transfer Received,0.00,690.31,2913722.87
6320,2022-07-19,2022-07-18,,Rental Income,0.00,1573.71,2915296.58
6321,2022-07-17,2022-07-18,100157,Cheque Issued,2255.69,0.00,2913040.89
6322,2022-07-19,2022-07-19,,Credit Card Payment,523.90,0.00,2912516.99
6323,2022-07-19,2022-07-19,,Utility Payment,196.54,0.00,2912320.45
6324,2022-07-18,2022-07-19,,Groceries - Supermarket,58.10,0.00,2912262.35
6325,2022-07-20,2022-07-20,,Transfer Received,0.00,1061.26,2913323.61
6326,2022-07-21,2022-07-20,,Utility Payment,284.63,0.00,2913038.98
6327,2022-07-20,2022-07-20,,Online Transfer,1365.44,0.00,2911673.54
6328,2022-07-20,2022-07-20,,Credit Card Payment,809.26,0.00,2910864.28
6329,2022-07-21,2022-07-20,,Transfer Received,0.00,1198.68,2912062.96
6330,2022-07-21,2022-07-20,,ATM Withdrawal,238.16,0.00,2911824.80
6331,2022-07-20,2022-07-20,,Transfer Received,0.00,1765.60,2913590.40
6332,2022-07-20,2022-07-20,,Salary Credit,0.00,2763.60,2916354.00
6333,2022-07-21,2022-07-21,,Online Transfer,1830.11,0.00,2914523.89
6334,2022-07-21,2022-07-21,,Transfer Received,0.00,1964.33,2916488.22
6335,2022-07-22,2022-07-21,,Investment - Mutual Funds,2056.47,0.00,2914431.75
6336,2022-07-21,2022-07-21,,Online Transfer,1669.12,0.00,2912762.63
6337,2022-07-21,2022-07-21,,Investment - SIP,279.93,0.00,2912482.70
6338,2022-07-21,2022-07-21,,ATM Withdrawal,417.41,0.00,2912065.29
6339,2022-07-20,2022-07-21,,Utility Payment,278.85,0.00,2911786.44
6340,2022-07-21,2022-07-21,,Coffee Shop,8.10,0.00,2911778.34
6341,2022-07-21,2022-07-21,,Utility Payment,152.72,0.00,2911625.62
6342,2022-07-21,2022-07-22,,Transfer Received,0.00,1633.38,2913259.00
6343,2022-07-22,2022-07-22,,Interest Credited,0.00,57.22,2913316.22
6344,2022-07-21,2022-07-22,,ATM Withdrawal,401.65,0.00,2912914.57
6345,2022-07-22,2022-07-22,,Credit Card Payment,910.91,0.00,2912003.66
6346,2022-07-22,2022-07-22,,Coffee Shop,12.07,0.00,2911991.59
6347,2022-07-22,2022-07-22,,Utility Payment,295.54,0.00,2911696.05
6348,2022-07-22,2022-07-22,,ATM Withdrawal,151.64,0.00,2911544.41
6349,2022-07-22,2022-07-23,,Utility Payment,294.65,0.00,2911249.76
6350,2022-07-23,2022-07-23,,Transfer Received,0.00,1492.20,2912741.96
6351,2022-07-23,2022-07-23,,Investment Returns,0.00,410.45,2913152.41
6352,2022-07-24,2022-07-23,,Salary Credit,0.00,4061.31,2917213.72
6353,2022-07-22,2022-07-23,,ATM Withdrawal,475.33,0.00,2916738.39
6354,2022-07-23,2022-07-23,,Online Transfer,1005.14,0.00,2915733.25
6355,2022-07-23,2022-07-23,,Groceries - Supermarket,129.36,0.00,2915603.89
6356,2022-07-23,2022-07-23,,Interest Credited,0.00,90.81,2915694.70
6357,2022-07-24,2022-07-24,,Utility Payment,107.99,0.00,2915586.71
6358,2022-07-24,2022-07-24,,ATM Withdrawal,446.88,0.00,2915139.83
6359,2022-07-25,2022-07-24,,Online Transfer,783.95,0.00,2914355.88
6360,2022-07-25,2022-07-24,,Transfer Received,0.00,1350.82,2915706.70
6361,2022-07-24,2022-07-24,,Credit Card Payment,489.75,0.00,2915216.95
6362,2022-07-24,2022-07-24,,Transfer Received,0.00,2189.13,2917406.08
6363,2022-07-24,2022-07-24,,Transfer Received,0.00,692.79,2918098.87
6364,2022-07-23,2022-07-24,,Groceries - Supermarket,129.27,0.00,2917969.60
6365,2022-07-24,2022-07-24,,Salary Credit,0.00,2635.61,2920605.21
6366,2022-07-25,2022-07-24,,Groceries - Online Delivery,74.63,0.00,2920530.58
6367,2022-07-26,2022-07-25,,Transfer Received,0.00,2154.21,2922684.79
6368,2022-07-25,2022-07-25,100158,Cheque Issued,501.59,0.00,2922183.20
6369,2022-07-25,2022-07-25,,Investment - Mutual Funds,1962.71,0.00,2920220.49
6370,2022-07-26,2022-07-25,,Transfer Received,0.00,1415.21,2921635.70
6371,2022-07-25,2022-07-25,,Groceries - Supermarket,112.98,0.00,2921522.72
6372,2022-07-24,2022-07-25,,Transfer Received,0.00,1761.18,2923283.90
6373,2022-07-27,2022-07-26,,Groceries - Online Delivery,108.93,0.00,2923174.97
6374,2022-07-26,2022-07-26,,Salary Credit,0.00,4700.05,2927875.02
6375,2022-07-25,2022-07-26,,Online Transfer,1801.79,0.00,2926073.23
6376,2022-07-25,2022-07-26,,Dining Out,70.39,0.00,2926002.84
6377,2022-07-26,2022-07-26,,Loan EMI,868.19,0.00,2925134.65
6378,2022-07-26,2022-07-26,,ATM Withdrawal,420.41,0.00,2924714.24
6379,2022-07-26,2022-07-26,,Transfer Received,0.00,2880.10,2927594.34
6380,2022-07-26,2022-07-26,,Cash Deposit,0.00,618.40,2928212.74
6381,2022-07-27,2022-07-27,,Salary Credit,0.00,4797.91,2933010.65
6382,2022-07-27,2022-07-27,,Cash Deposit,0.00,838.32,2933848.97
6383,2022-07-26,2022-07-27,,ATM Withdrawal,145.90,0.00,2933703.07
6384,2022-07-29,2022-07-28,,Interest Credited,0.00,91.60,2933794.67
6385,2022-07-27,2022-07-28,,Online Transfer,1762.16,0.00,2932032.51
6386,2022-07-27,2022-07-28,,Credit Card Payment,329.24,0.00,2931703.27
6387,2022-07-28,2022-07-28,,Groceries - Online Delivery,119.81,0.00,2931583.46
6388,2022-07-27,2022-07-28,,Dining Out,57.71,0.00,2931525.75
6389,2022-07-28,2022-07-28,,Groceries - Supermarket,52.83,0.00,2931472.92
6390,2022-07-28,2022-07-28,,Interest Credited,0.00,44.67,2931517.59
6391,2022-07-30,2022-07-29,,Groceries - Supermarket,149.80,0.00,2931367.79
6392,2022-07-29,2022-07-29,,Transfer Received,0.00,1959.81,2933327.60
6393,2022-07-29,2022-07-29,,Transfer Received,0.00,2985.42,2936313.02
6394,2022-07-29,2022-07-29,,Salary Credit,0.00,3831.69,2940144.71
6395,2022-07-31,2022-07-30,,Online Transfer,1619.68,0.00,2938525.03
6396,2022-07-30,2022-07-30,,Online Transfer,1445.72,0.00,2937079.31
6397,2022-07-30,2022-07-30,,Utility Payment,255.67,0.00,2936823.64
6398,2022-07-31,2022-07-30,,Takeout,30.98,0.00,2936792.66
6399,2022-07-30,2022-07-30,,Investment - Mutual Funds,1311.37,0.00,2935481.29
6400,2022-07-29,2022-07-30,,Investment Returns,0.00,171.39,2935652.68
6401,2022-07-29,2022-07-30,,Groceries - Supermarket,171.06,0.00,2935481.62
6402,2022-07-30,2022-07-30,,Cash Deposit,0.00,396.83,2935878.45
6403,2022-07-29,2022-07-30,,Loan EMI,1660.49,0.00,2934217.96
6404,2022-07-31,2022-07-30,,Transfer Received,0.00,884.02,2935101.98
6405,2022-07-30,2022-07-30,,Utility Payment,252.72,0.00,2934849.26
6406,2022-07-30,2022-07-30,,Online Transfer,1424.40,0.00,2933424.86
6407,2022-07-30,2022-07-30,,Online Transfer,1448.20,0.00,2931976.66
6408,2022-07-31,2022-07-31,,Daily Essentials,30.77,0.00,2931945.89
6409,2022-07-31,2022-07-31,,Online Transfer,1776.29,0.00,2930169.60
6410,2022-07-30,2022-07-31,,Rental Income,0.00,2329.51,2932499.11
6411,2022-07-31,2022-08-01,,Takeout,46.42,0.00,2932452.69
6412,2022-07-31,2022-08-01,,Credit Card Payment,306.47,0.00,2932146.22
6413,2022-08-01,2022-08-01,,Online Transfer,819.81,0.00,2931326.41
6414,2022-08-01,2022-08-01,,Salary Credit,0.00,2497.71,2933824.12
6415,2022-08-01,2022-08-01,,Transfer Received,0.00,1058.38,2934882.50
6416,2022-08-02,2022-08-01,,Transfer Received,0.00,2458.17,2937340.67
6417,2022-08-01,2022-08-01,,Groceries - Supermarket,191.00,0.00,2937149.67
6418,2022-08-01,2022-08-01,,Utility Payment,295.08,0.00,2936854.59
6419,2022-08-01,2022-08-01,,ATM Withdrawal,212.85,0.00,2936641.74
6420,2022-08-02,2022-08-02,,Salary Credit,0.00,2776.91,2939418.65
6421,2022-08-02,2022-08-02,,Transfer Received,0.00,2459.44,2941878.09
6422,2022-08-02,2022-08-02,,Transfer Received,0.00,1808.39,2943686.48
6423,2022-08-02,2022-08-02,100159,Cheque Issued,871.09,0.00,2942815.39
6424,2022-08-03,2022-08-02,,ATM Withdrawal,112.32,0.00,2942703.07
6425,2022-08-02,2022-08-02,,Salary Credit,0.00,3643.77,2946346.84
6426,2022-08-03,2022-08-03,,Groceries - Supermarket,171.09,0.00,2946175.75
6427,2022-08-04,2022-08-03,,Interest Credited,0.00,39.87,2946215.62
6428,2022-08-02,2022-08-03,,Daily Essentials,19.30,0.00,2946196.32
6429,2022-08-03,2022-08-03,,Transfer Received,0.00,643.61,2946839.93
6430,2022-08-03,2022-08-03,,Salary Credit,0.00,4978.93,2951818.86
6431,2022-08-03,2022-08-03,,Transfer Received,0.00,2824.63,2954643.49
6432,2022-08-04,2022-08-03,,Groceries - Supermarket,93.07,0.00,2954550.42
6433,2022-08-03,2022-08-03,,ATM Withdrawal,144.28,0.00,2954406.14
6434,2022-08-04,2022-08-03,,Salary Credit,0.00,2851.66,2957257.80
6435,2022-08-02,2022-08-03,,Groceries - Supermarket,196.34,0.00,2957061.46
6436,2022-08-03,2022-08-03,,Transfer Received,0.00,538.95,2957600.41
6437,2022-08-03,2022-08-03,,Salary Credit,0.00,2094.50,2959694.91
6438,2022-08-04,2022-08-04,,Investment - SIP,347.76,0.00,2959347.15
6439,2022-08-04,2022-08-04,,Groceries - Supermarket,55.95,0.00,2959291.20
6440,2022-08-04,2022-08-04,,Salary Credit,0.00,3205.75,2962496.95
6441,2022-08-04,2022-08-04,,Groceries - Online Delivery,146.00,0.00,2962350.95
6442,2022-08-04,2022-08-04,,Groceries - Supermarket,163.28,0.00,2962187.67
6443,2022-08-05,2022-08-05,,Daily Essentials,14.11,0.00,2962173.56
6444,2022-08-05,2022-08-05,,Transfer Received,0.00,1398.97,2963572.53
6445,2022-08-04,2022-08-05,,Coffee Shop,19.48,0.00,2963553.05
6446,2022-08-06,2022-08-05,,Transfer Received,0.00,1418.69,2964971.74
6447,2022-08-05,2022-08-05,,Salary Credit,0.00,3941.88,2968913.62
6448,2022-08-06,2022-08-05,,ATM Withdrawal,412.52,0.00,2968501.10
6449,2022-08-06,2022-08-06,,Transfer Received,0.00,767.95,2969269.05
6450,2022-08-06,2022-08-06,,Transfer Received,0.00,1279.58,2970548.63
6451,2022-08-06,2022-08-06,,Utility Payment,293.46,0.00,2970255.17
6452,2022-08-07,2022-08-07,,Groceries - Supermarket,144.90,0.00,2970110.27
6453,2022-08-06,2022-08-07,,Utility Payment,153.71,0.00,2969956.56
6454,2022-08-07,2022-08-07,,Utility Payment,95.42,0.00,2969861.14
6455,2022-08-08,2022-08-08,,Transfer Received,0.00,1074.38,2970935.52
6456,2022-08-08,2022-08-08,,Credit Card Payment,995.02,0.00,2969940.50
6457,2022-08-08,2022-08-08,,Salary Credit,0.00,3587.19,2973527.69
6458,2022-08-08,2022-08-08,,Investment Returns,0.00,874.25,2974401.94
6459,2022-08-08,2022-08-08,,Transfer Received,0.00,1217.91,2975619.85
6460,2022-08-08,2022-08-08,,Dividend Received,0.00,333.40,2975953.25
6461,2022-08-07,2022-08-08,,Credit Card Payment,215.20,0.00,2975738.05
6462,2022-08-10,2022-08-09,,Salary Credit,0.00,4241.41,2979979.46
6463,2022-08-09,2022-08-09,,Credit Card Payment,220.19,0.00,2979759.27
6464,2022-08-09,2022-08-09,,Loan EMI,1088.87,0.00,2978670.40
6465,2022-08-08,2022-08-09,,Salary Credit,0.00,2697.71,2981368.11
6466,2022-08-09,2022-08-09,,Transfer Received,0.00,828.54,2982196.65
6467,2022-08-09,2022-08-09,,Dining Out,49.51,0.00,2982147.14
6468,2022-08-10,2022-08-10,,Salary Credit,0.00,3543.59,2985690.73
6469,2022-08-10,2022-08-10,,Transfer Received,0.00,2134.06,2987824.79
6470,2022-08-10,2022-08-10,,Cash Deposit,0.00,576.13,2988400.92
6471,2022-08-10,2022-08-10,,ATM Withdrawal,69.11,0.00,2988331.81
6472,2022-08-09,2022-08-10,,ATM Withdrawal,418.92,0.00,2987912.89
6473,2022-08-09,2022-08-10,,Transfer Received,0.00,2613.14,2990526.03
6474,2022-08-11,2022-08-10,,Transfer Received,0.00,2199.61,2992725.64
6475,2022-08-12,2022-08-11,,Transfer Received,0.00,1315.23,2994040.87
6476,2022-08-12,2022-08-11,,Interest Credited,0.00,82.33,2994123.20
6477,2022-08-11,2022-08-11,,Online Transfer,214.24,0.00,2993908.96
6478,2022-08-11,2022-08-11,,Transfer Received,0.00,2721.45,2996630.41
6479,2022-08-11,2022-08-11,,Salary Credit,0.00,2861.81,2999492.22
6480,2022-08-12,2022-08-12,,Salary Credit,0.00,3255.14,3002747.36
6481,2022-08-12,2022-08-12,,Loan EMI,1765.36,0.00,3000982.00
6482,2022-08-12,2022-08-12,,Investment Returns,0.00,283.48,3001265.48
6483,2022-08-12,2022-08-12,,Transfer Received,0.00,970.61,3002236.09
6484,2022-08-12,2022-08-12,,Online Transfer,1215.48,0.00,3001020.61
6485,2022-08-13,2022-08-12,,Transfer Received,0.00,968.16,3001988.77
6486,2022-08-13,2022-08-12,100160,Cheque Issued,2103.75,0.00,2999885.02
6487,2022-08-13,2022-08-12,,Credit Card Payment,644.49,0.00,2999240.53
6488,2022-08-12,2022-08-13,,Rental Income,0.00,2335.21,3001575.74
6489,2022-08-12,2022-08-13,,Online Transfer,615.45,0.00,3000960.29
6490,2022-08-13,2022-08-13,,ATM Withdrawal,342.77,0.00,3000617.52
6491,2022-08-13,2022-08-13,,Dining Out,65.64,0.00,3000551.88
6492,2022-08-13,2022-08-13,,Loan EMI,1587.93,0.00,2998963.95
6493,2022-08-13,2022-08-13,,Credit Card Payment,911.05,0.00,2998052.90
6494,2022-08-12,2022-08-13,,Rental Income,0.00,2026.27,3000079.17
6495,2022-08-12,2022-08-13,,Online Transfer,1020.06,0.00,2999059.11
6496,2022-08-14,2022-08-14,,Salary Credit,0.00,4163.61,3003222.72
6497,2022-08-14,2022-08-14,,ATM Withdrawal,268.10,0.00,3002954.62
6498,2022-08-13,2022-08-14,,ATM Withdrawal,66.50,0.00,3002888.12
6499,2022-08-14,2022-08-14,,Groceries - Supermarket,46.92,0.00,3002841.20
6500,2022-08-14,2022-08-14,100161,Cheque Issued,2464.46,0.00,3000376.74
6501,2022-08-14,2022-08-14,,Investment - Mutual Funds,2754.51,0.00,2997622.23
6502,2022-08-15,2022-08-15,,Salary Credit,0.00,4788.85,3002411.08
6503,2022-08-14,2022-08-15,,Credit Card Payment,908.95,0.00,3001502.13
6504,2022-08-14,2022-08-15,,Salary Credit,0.00,2005.83,3003507.96
6505,2022-08-16,2022-08-15,,Groceries - Supermarket,156.75,0.00,3003351.21
6506,2022-08-15,2022-08-15,,Transfer Received,0.00,1707.48,3005058.69
6507,2022-08-14,2022-08-15,,Online Transfer,797.09,0.00,3004261.60
6508,2022-08-14,2022-08-15,,ATM Withdrawal,286.33,0.00,3003975.27
6509,2022-08-16,2022-08-16,,Interest Credited,0.00,35.53,3004010.80
6510,2022-08-17,2022-08-16,,Groceries - Supermarket,103.32,0.00,3003907.48
6511,2022-08-16,2022-08-16,,Interest Credited,0.00,71.88,3003979.36
6512,2022-08-16,2022-08-16,,Salary Credit,0.00,3152.19,3007131.55
6513,2022-08-15,2022-08-16,,Utility Payment,85.97,0.00,3007045.58
6514,2022-08-17,2022-08-16,,Salary Credit,0.00,2588.05,3009633.63
6515,2022-08-16,2022-08-16,,ATM Withdrawal,36.38,0.00,3009597.25
6516,2022-08-16,2022-08-16,,Transfer Received,0.00,1837.41,3011434.66
6517,2022-08-16,2022-08-16,,Groceries - Online Delivery,92.20,0.00,3011342.46
6518,2022-08-16,2022-08-16,,Dividend Received,0.00,272.04,3011614.50
6519,2022-08-15,2022-08-16,,Rental Income,0.00,2546.93,3014161.43
6520,2022-08-18,2022-08-17,,Groceries - Supermarket,175.11,0.00,3013986.32
6521,2022-08-18,2022-08-17,,Online Transfer,127.81,0.00,3013858.51
6522,2022-08-17,2022-08-17,,Salary Credit,0.00,3883.59,3017742.10
6523,2022-08-17,2022-08-17,,ATM Withdrawal,309.17,0.00,3017432.93
6524,2022-08-17,2022-08-17,,Salary Credit,0.00,4085.16,3021518.09
6525,2022-08-18,2022-08-18,,ATM Withdrawal,405.54,0.00,3021112.55
6526,2022-08-18,2022-08-18,,ATM Withdrawal,328.76,0.00,3020783.79
6527,2022-08-18,2022-08-18,,Transfer Received,0.00,2487.09,3023270.88
6528,2022-08-18,2022-08-18,,Coffee Shop,6.75,0.00,3023264.13
6529,2022-08-19,2022-08-18,,Investment Returns,0.00,206.15,3023470.28
6530,2022-08-18,2022-08-18,,Investment - SIP,561.99,0.00,3022908.29
6531,2022-08-19,2022-08-19,,Credit Card Payment,867.72,0.00,3022040.57
6532,2022-08-18,2022-08-19,,Dining Out,72.00,0.00,3021968.57
6533,2022-08-19,2022-08-19,100162,Cheque Issued,2984.64,0.00,3018983.93
6534,2022-08-20,2022-08-20,,Dining Out,53.77,0.00,3018930.16
6535,2022-08-20,2022-08-20,,Online Transfer,645.48,0.00,3018284.68
6536,2022-08-19,2022-08-20,,Salary Credit,0.00,4583.99,3022868.67
6537,2022-08-19,2022-08-20,,ATM Withdrawal,226.00,0.00,3022642.67
6538,2022-08-19,2022-08-20,,Credit Card Payment,634.49,0.00,3022008.18
6539,2022-08-19,2022-08-20,,ATM Withdrawal,26.98,0.00,3021981.20
6540,2022-08-21,2022-08-20,,Transfer Received,0.00,2677.86,3024659.06
6541,2022-08-21,2022-08-21,,Dining Out,61.30,0.00,3024597.76
6542,2022-08-20,2022-08-21,,Transfer Received,0.00,1427.49,3026025.25
6543,2022-08-21,2022-08-21,,Transfer Received,0.00,2108.36,3028133.61
6544,2022-08-22,2022-08-21,,Groceries - Supermarket,46.07,0.00,3028087.54
6545,2022-08-21,2022-08-21,,Salary Credit,0.00,2317.97,3030405.51
6546,2022-08-22,2022-08-22,,Dining Out,34.50,0.00,3030371.01
6547,2022-08-22,2022-08-22,,Rental Income,0.00,1839.95,3032210.96
6548,2022-08-22,2022-08-22,,Transfer Received,0.00,979.91,3033190.87
6549,2022-08-21,2022-08-22,,Online Transfer,778.75,0.00,3032412.12
6550,2022-08-22,2022-08-22,,Groceries - Supermarket,99.11,0.00,3032313.01
6551,2022-08-22,2022-08-22,,Credit Card Payment,679.93,0.00,3031633.08
6552,2022-08-22,2022-08-22,,Transfer Received,0.00,1852.22,3033485.30
6553,2022-08-22,2022-08-22,,Coffee Shop,11.57,0.00,3033473.73
6554,2022-08-23,2022-08-22,,Interest Credited,0.00,99.45,3033573.18
6555,2022-08-23,2022-08-23,,ATM Withdrawal,386.40,0.00,3033186.78
6556,2022-08-23,2022-08-23,,Transfer Received,0.00,2039.35,3035226.13
6557,2022-08-23,2022-08-23,,Utility Payment,133.38,0.00,3035092.75
6558,2022-08-22,2022-08-23,,Salary Credit,0.00,3166.01,3038258.76
6559,2022-08-23,2022-08-23,,Salary Credit,0.00,3468.29,3041727.05
6560,2022-08-23,2022-08-23,,Salary Credit,0.00,3150.31,3044877.36
6561,2022-08-24,2022-08-23,,Dividend Received,0.00,266.52,3045143.88
6562,2022-08-24,2022-08-24,,Dining Out,26.48,0.00,3045117.40
6563,2022-08-24,2022-08-24,,ATM Withdrawal,96.20,0.00,3045021.20
6564,2022-08-24,2022-08-24,,Utility Payment,240.45,0.00,3044780.75
6565,2022-08-24,2022-08-24,,Salary Credit,0.00,3032.89,3047813.64
6566,2022-08-25,2022-08-24,,Groceries - Online Delivery,106.43,0.00,3047707.21
6567,2022-08-24,2022-08-24,,Salary Credit,0.00,2757.17,3050464.38
6568,2022-08-25,2022-08-24,,Transfer Received,0.00,1893.84,3052358.22
6569,2022-08-24,2022-08-24,,Groceries - Supermarket,177.32,0.00,3052180.90
6570,2022-08-25,2022-08-25,,Interest Credited,0.00,49.60,3052230.50
6571,2022-08-24,2022-08-25,,Online Transfer,1052.46,0.00,3051178.04
6572,2022-08-25,2022-08-25,,Groceries - Supermarket,191.59,0.00,3050986.45
6573,2022-08-25,2022-08-25,,Credit Card Payment,592.21,0.00,3050394.24
6574,2022-08-25,2022-08-25,,Online Transfer,1327.68,0.00,3049066.56
6575,2022-08-26,2022-08-26,,Transfer Received,0.00,899.84,3049966.40
6576,2022-08-27,2022-08-27,,Utility Payment,134.94,0.00,3049831.46
6577,2022-08-27,2022-08-27,,Transfer Received,0.00,1674.20,3051505.66
6578,2022-08-27,2022-08-27,,Groceries - Supermarket,147.03,0.00,3051358.63
6579,2022-08-26,2022-08-27,,ATM Withdrawal,234.58,0.00,3051124.05
6580,2022-08-27,2022-08-27,,Transfer Received,0.00,905.41,3052029.46
6581,2022-08-28,2022-08-27,,Utility Payment,161.13,0.00,3051868.33
6582,2022-08-27,2022-08-27,,Rental Income,0.00,2991.25,3054859.58
6583,2022-08-29,2022-08-28,,Transfer Received,0.00,1374.94,3056234.52
6584,2022-08-28,2022-08-28,,Rental Income,0.00,2223.51,3058458.03
6585,2022-08-28,2022-08-28,,Investment - Stocks,1983.12,0.00,3056474.91
6586,2022-08-28,2022-08-28,,Rental Income,0.00,1146.16,3057621.07
6587,2022-08-29,2022-08-29,,Interest Credited,0.00,37.42,3057658.49
6588,2022-08-28,2022-08-29,,Salary Credit,0.00,3633.62,3061292.11
6589,2022-08-29,2022-08-29,100163,Cheque Issued,1197.73,0.00,3060094.38
6590,2022-08-29,2022-08-29,,Transfer Received,0.00,832.22,3060926.60
6591,2022-08-29,2022-08-29,,Coffee Shop,13.92,0.00,3060912.68
6592,2022-08-29,2022-08-29,,Interest Credited,0.00,52.85,3060965.53
6593,2022-08-30,2022-08-29,,Transfer Received,0.00,1452.43,3062417.96
6594,2022-08-29,2022-08-29,,ATM Withdrawal,69.51,0.00,3062348.45
6595,2022-08-30,2022-08-29,,Cash Deposit,0.00,997.67,3063346.12
6596,2022-08-29,2022-08-29,,ATM Withdrawal,419.16,0.00,3062926.96
6597,2022-08-29,2022-08-29,,Online Transfer,1661.59,0.00,3061265.37
6598,2022-08-30,2022-08-29,,Credit Card Payment,468.02,0.00,3060797.35
6599,2022-08-28,2022-08-29,,Salary Credit,0.00,4516.58,3065313.93
6600,2022-08-28,2022-08-29,,Transfer Received,0.00,1512.22,3066826.15
6601,2022-08-30,2022-08-30,,Credit Card Payment,402.80,0.00,3066423.35
6602,2022-08-31,2022-08-30,,Transfer Received,0.00,1391.83,3067815.18
6603,2022-08-29,2022-08-30,,Utility Payment,248.90,0.00,3067566.28
6604,2022-08-30,2022-08-30,,Transfer Received,0.00,1003.82,3068570.10
6605,2022-08-31,2022-08-31,,Online Transfer,436.37,0.00,3068133.73
6606,2022-08-30,2022-08-31,,ATM Withdrawal,59.26,0.00,3068074.47
6607,2022-08-30,2022-08-31,,Groceries - Supermarket,47.80,0.00,3068026.67
6608,2022-08-31,2022-08-31,,Transfer Received,0.00,2111.24,3070137.91
6609,2022-08-31,2022-08-31,,Groceries - Supermarket,184.43,0.00,3069953.48
6610,2022-08-30,2022-08-31,,Investment Returns,0.00,296.45,3070249.93
6611,2022-09-02,2022-09-01,,Online Transfer,1676.56,0.00,3068573.37
6612,2022-09-01,2022-09-01,,Coffee Shop,5.91,0.00,3068567.46
6613,2022-09-01,2022-09-01,,Salary Credit,0.00,2228.25,3070795.71
6614,2022-09-01,2022-09-01,,Groceries - Supermarket,181.09,0.00,3070614.62
6615,2022-09-02,2022-09-01,,Groceries - Online Delivery,130.62,0.00,3070484.00
6616,2022-09-02,2022-09-02,,Transfer Received,0.00,741.87,3071225.87
6617,2022-09-03,2022-09-02,,Dividend Received,0.00,358.84,3071584.71
6618,2022-09-02,2022-09-02,,Interest Credited,0.00,78.21,3071662.92
6619,2022-09-03,2022-09-02,,Interest Credited,0.00,64.30,3071727.22
6620,2022-09-03,2022-09-02,,Dividend Received,0.00,105.95,3071833.17
6621,2022-09-02,2022-09-02,,Transfer Received,0.00,810.44,3072643.61
6622,2022-09-02,2022-09-02,,Salary Credit,0.00,4546.86,3077190.47
6623,2022-09-03,2022-09-02,,Groceries - Supermarket,38.66,0.00,3077151.81
6624,2022-09-03,2022-09-02,,Investment - Stocks,4949.59,0.00,3072202.22
6625,2022-09-02,2022-09-02,,Groceries - Supermarket,125.01,0.00,3072077.21
6626,2022-09-02,2022-09-02,,Credit Card Payment,840.37,0.00,3071236.84
6627,2022-09-03,2022-09-03,,Interest Credited,0.00,50.72,3071287.56
6628,2022-09-02,2022-09-03,,Daily Essentials,40.70,0.00,3071246.86
6629,2022-09-04,2022-09-03,,Transfer Received,0.00,1549.41,3072796.27
6630,2022-09-03,2022-09-03,,Takeout,13.15,0.00,3072783.12
6631,2022-09-02,2022-09-03,,Credit Card Payment,491.53,0.00,3072291.59
6632,2022-09-04,2022-09-03,,Dining Out,35.14,0.00,3072256.45
6633,2022-09-03,2022-09-03,,ATM Withdrawal,433.54,0.00,3071822.91
6634,2022-09-03,2022-09-03,,Groceries - Supermarket,184.55,0.00,3071638.36
6635,2022-09-04,2022-09-03,,Transfer Received,0.00,1405.91,3073044.27
6636,2022-09-02,2022-09-03,,Salary Credit,0.00,4186.75,3077231.02
6637,2022-09-03,2022-09-03,,Groceries - Online Delivery,64.43,0.00,3077166.59
6638,2022-09-02,2022-09-03,,Investment Returns,0.00,485.24,3077651.83
6639,2022-09-03,2022-09-03,,Transfer Received,0.00,2369.65,3080021.48
6640,2022-09-03,2022-09-03,,Loan EMI,1136.93,0.00,3078884.55
6641,2022-09-04,2022-09-04,,Investment Returns,0.00,960.78,3079845.33
6642,2022-09-05,2022-09-04,,Interest Credited,0.00,77.56,3079922.89
6643,2022-09-03,2022-09-04,,Online Transfer,462.67,0.00,3079460.22
6644,2022-09-04,2022-09-04,,Online Transfer,1341.95,0.00,3078118.27
6645,2022-09-05,2022-09-04,,Credit Card Payment,987.22,0.00,3077131.05
6646,2022-09-04,2022-09-04,,ATM Withdrawal,342.89,0.00,3076788.16
6647,2022-09-05,2022-09-05,,Salary Credit,0.00,4216.66,3081004.82
6648,2022-09-05,2022-09-05,,Transfer Received,0.00,2757.07,3083761.89
6649,2022-09-05,2022-09-05,,Salary Credit,0.00,2812.62,3086574.51
6650,2022-09-04,2022-09-05,,Cash Deposit,0.00,459.53,3087034.04
6651,2022-09-05,2022-09-05,,Online Transfer,240.09,0.00,3086793.95
6652,2022-09-05,2022-09-05,,Transfer Received,0.00,840.64,3087634.59
6653,2022-09-05,2022-09-05,,Transfer Received,0.00,1000.58,3088635.17
6654,2022-09-06,2022-09-05,,Credit Card Payment,525.95,0.00,3088109.22
6655,2022-09-05,2022-09-05,,Groceries - Supermarket,69.41,0.00,3088039.81
6656,2022-09-05,2022-09-05,,Credit Card Payment,410.63,0.00,3087629.18
6657,2022-09-05,2022-09-05,,Daily Essentials,47.78,0.00,3087581.40
6658,2022-09-05,2022-09-05,,Groceries - Supermarket,65.40,0.00,3087516.00
6659,2022-09-05,2022-09-06,,Online Transfer,707.58,0.00,3086808.42
6660,2022-09-06,2022-09-06,,Dividend Received,0.00,183.62,3086992.04
6661,2022-09-06,2022-09-06,,Takeout,37.29,0.00,3086954.75
6662,2022-09-06,2022-09-06,,ATM Withdrawal,316.49,0.00,3086638.26
6663,2022-09-05,2022-09-06,,Online Transfer,775.07,0.00,3085863.19
6664,2022-09-07,2022-09-06,,Salary Credit,0.00,3056.85,3088920.04
6665,2022-09-06,2022-09-06,,Credit Card Payment,628.35,0.00,3088291.69
6666,2022-09-07,2022-09-07,,Transfer Received,0.00,1388.28,3089679.97
6667,2022-09-07,2022-09-07,,Cash Deposit,0.00,926.17,3090606.14
6668,2022-09-07,2022-09-07,,Utility Payment,134.21,0.00,3090471.93
6669,2022-09-09,2022-09-08,,Interest Credited,0.00,28.72,3090500.65
6670,2022-09-07,2022-09-08,,Groceries - Supermarket,82.64,0.00,3090418.01
6671,2022-09-08,2022-09-08,,ATM Withdrawal,312.40,0.00,3090105.61
6672,2022-09-07,2022-09-08,,Utility Payment,245.37,0.00,3089860.24
6673,2022-09-08,2022-09-08,,Transfer Received,0.00,1876.19,3091736.43
6674,2022-09-08,2022-09-08,,ATM Withdrawal,424.46,0.00,3091311.97
6675,2022-09-09,2022-09-09,,ATM Withdrawal,414.97,0.00,3090897.00
6676,2022-09-09,2022-09-09,,Salary Credit,0.00,3685.17,3094582.17
6677,2022-09-09,2022-09-09,,Groceries - Supermarket,100.57,0.00,3094481.60
6678,2022-09-09,2022-09-09,,Online Transfer,866.64,0.00,3093614.96
6679,2022-09-08,2022-09-09,,Transfer Received,0.00,2433.95,3096048.91
6680,2022-09-09,2022-09-09,,Salary Credit,0.00,2337.08,3098385.99
6681,2022-09-09,2022-09-09,,Takeout,28.46,0.00,3098357.53
6682,2022-09-10,2022-09-09,,Salary Credit,0.00,3323.55,3101681.08
6683,2022-09-09,2022-09-09,,Salary Credit,0.00,3332.85,3105013.93
6684,2022-09-08,2022-09-09,,Dividend Received,0.00,148.15,3105162.08
6685,2022-09-08,2022-09-09,,Online Transfer,1878.14,0.00,3103283.94
6686,2022-09-10,2022-09-09,,Utility Payment,60.60,0.00,3103223.34
6687,2022-09-09,2022-09-09,,Online Transfer,1139.98,0.00,3102083.36
6688,2022-09-09,2022-09-10,,Investment - Mutual Funds,2295.84,0.00,3099787.52
6689,2022-09-10,2022-09-10,,Utility Payment,129.57,0.00,3099657.95
6690,2022-09-10,2022-09-10,,Transfer Received,0.00,2345.44,3102003.39
6691,2022-09-10,2022-09-10,,Online Transfer,733.38,0.00,3101270.01
6692,2022-09-10,2022-09-10,,Salary Credit,0.00,4575.28,3105845.29
6693,2022-09-10,2022-09-10,,ATM Withdrawal,459.43,0.00,3105385.86
6694,2022-09-11,2022-09-10,,Dividend Received,0.00,189.16,3105575.02
6695,2022-09-12,2022-09-11,,Coffee Shop,19.93,0.00,3105555.09
6696,2022-09-11,2022-09-11,,Groceries - Online Delivery,104.43,0.00,3105450.66
6697,2022-09-11,2022-09-11,,Groceries - Supermarket,153.98,0.00,3105296.68
6698,2022-09-11,2022-09-11,,Transfer Received,0.00,1122.14,3106418.82
6699,2022-09-12,2022-09-11,,Salary Credit,0.00,4796.70,3111215.52
6700,2022-09-11,2022-09-11,,Investment Returns,0.00,851.91,3112067.43
6701,2022-09-13,2022-09-12,,ATM Withdrawal,490.16,0.00,3111577.27
6702,2022-09-11,2022-09-12,,Salary Credit,0.00,3449.90,3115027.17
6703,2022-09-12,2022-09-12,,Online Transfer,1271.47,0.00,3113755.70
6704,2022-09-12,2022-09-12,,Online Transfer,1215.13,0.00,3112540.57
6705,2022-09-11,2022-09-12,,Transfer Received,0.00,2192.45,3114733.02
6706,2022-09-12,2022-09-12,,Salary Credit,0.00,4082.13,3118815.15
6707,2022-09-12,2022-09-13,,Credit Card Payment,840.33,0.00,3117974.82
6708,2022-09-13,2022-09-13,,Groceries - Supermarket,172.69,0.00,3117802.13
6709,2022-09-13,2022-09-13,,ATM Withdrawal,75.17,0.00,3117726.96
6710,2022-09-13,2022-09-13,,ATM Withdrawal,216.31,0.00,3117510.65
6711,2022-09-13,2022-09-13,,ATM Withdrawal,132.52,0.00,3117378.13
6712,2022-09-13,2022-09-13,,Online Transfer,299.96,0.00,3117078.17
6713,2022-09-13,2022-09-13,,ATM Withdrawal,32.63,0.00,3117045.54
6714,2022-09-14,2022-09-14,,Transfer Received,0.00,2452.83,3119498.37
6715,2022-09-14,2022-09-14,,Utility Payment,246.82,0.00,3119251.55
6716,2022-09-13,2022-09-14,,Transfer Received,0.00,2410.02,3121661.57
6717,2022-09-14,2022-09-14,,ATM Withdrawal,37.60,0.00,3121623.97
6718,2022-09-14,2022-09-14,,Investment - Mutual Funds,1240.52,0.00,3120383.45
6719,2022-09-15,2022-09-15,,Dining Out,38.42,0.00,3120345.03
6720,2022-09-16,2022-09-15,,ATM Withdrawal,147.60,0.00,3120197.43
6721,2022-09-15,2022-09-15,,ATM Withdrawal,48.90,0.00,3120148.53
6722,2022-09-15,2022-09-15,,Credit Card Payment,285.44,0.00,3119863.09
6723,2022-09-15,2022-09-15,,Salary Credit,0.00,4310.98,3124174.07
6724,2022-09-15,2022-09-15,,Transfer Received,0.00,1822.77,3125996.84
6725,2022-09-15,2022-09-15,,Transfer Received,0.00,2862.24,3128859.08
6726,2022-09-16,2022-09-16,,Transfer Received,0.00,863.75,3129722.83
6727,2022-09-16,2022-09-16,,Utility Payment,67.96,0.00,3129654.87
6728,2022-09-16,2022-09-16,,Investment - Stocks,1641.98,0.00,3128012.89
6729,2022-09-17,2022-09-16,,Credit Card Payment,842.52,0.00,3127170.37
6730,2022-09-16,2022-09-16,,Groceries - Supermarket,104.17,0.00,3127066.20
6731,2022-09-17,2022-09-17,,Investment - Stocks,786.30,0.00,3126279.90
6732,2022-09-17,2022-09-17,,Salary Credit,0.00,2160.29,3128440.19
6733,2022-09-18,2022-09-17,,Loan EMI,1950.70,0.00,3126489.49
6734,2022-09-16,2022-09-17,,Online Transfer,165.90,0.00,3126323.59
6735,2022-09-17,2022-09-17,100164,Cheque Issued,786.02,0.00,3125537.57
6736,2022-09-17,2022-09-17,,ATM Withdrawal,88.38,0.00,3125449.19
6737,2022-09-17,2022-09-17,,Utility Payment,129.90,0.00,3125319.29
6738,2022-09-18,2022-09-18,,Salary Credit,0.00,4499.58,3129818.87
6739,2022-09-18,2022-09-18,,Groceries - Supermarket,164.06,0.00,3129654.81
6740,2022-09-18,2022-09-18,,Investment - Stocks,2526.80,0.00,3127128.01
6741,2022-09-17,2022-09-18,,ATM Withdrawal,445.65,0.00,3126682.36
6742,2022-09-18,2022-09-18,,Transfer Received,0.00,1168.35,3127850.71
6743,2022-09-17,2022-09-18,,Transfer Received,0.00,2179.11,3130029.82
6744,2022-09-17,2022-09-18,,Transfer Received,0.00,1737.32,3131767.14
6745,2022-09-19,2022-09-19,,Investment - Mutual Funds,1562.66,0.00,3130204.48
6746,2022-09-18,2022-09-19,,Credit Card Payment,755.60,0.00,3129448.88
6747,2022-09-19,2022-09-19,,Online Transfer,458.47,0.00,3128990.41
6748,2022-09-19,2022-09-19,,Salary Credit,0.00,4396.46,3133386.87
6749,2022-09-19,2022-09-20,,ATM Withdrawal,236.74,0.00,3133150.13
6750,2022-09-20,2022-09-20,,Transfer Received,0.00,1311.78,3134461.91
6751,2022-09-20,2022-09-20,,Groceries - Supermarket,153.53,0.00,3134308.38
6752,2022-09-19,2022-09-20,,Groceries - Online Delivery,91.99,0.00,3134216.39
6753,2022-09-20,2022-09-20,,Investment - Mutual Funds,2113.19,0.00,3132103.20
6754,2022-09-20,2022-09-20,,Investment - SIP,262.74,0.00,3131840.46
6755,2022-09-22,2022-09-21,,Utility Payment,247.99,0.00,3131592.47
6756,2022-09-21,2022-09-21,,Credit Card Payment,429.22,0.00,3131163.25
6757,2022-09-21,2022-09-21,,Takeout,36.84,0.00,3131126.41
6758,2022-09-21,2022-09-21,,ATM Withdrawal,62.20,0.00,3131064.21
6759,2022-09-21,2022-09-21,,Online Transfer,1481.16,0.00,3129583.05
6760,2022-09-20,2022-09-21,,Transfer Received,0.00,2481.85,3132064.90
6761,2022-09-21,2022-09-21,,Credit Card Payment,430.23,0.00,3131634.67
6762,2022-09-21,2022-09-21,,Utility Payment,284.96,0.00,3131349.71
6763,2022-09-22,2022-09-22,,Investment - Stocks,648.52,0.00,3130701.19
6764,2022-09-23,2022-09-22,,ATM Withdrawal,395.75,0.00,3130305.44
6765,2022-09-22,2022-09-22,,Transfer Received,0.00,717.87,3131023.31
6766,2022-09-22,2022-09-22,,Credit Card Payment,899.92,0.00,3130123.39
6767,2022-09-22,2022-09-22,,Online Transfer,411.61,0.00,3129711.78
6768,2022-09-22,2022-09-22,,ATM Withdrawal,309.86,0.00,3129401.92
6769,2022-09-22,2022-09-22,,Transfer Received,0.00,2773.74,3132175.66
6770,2022-09-21,2022-09-22,,Dining Out,30.85,0.00,3132144.81
6771,2022-09-23,2022-09-23,,Dining Out,56.82,0.00,3132087.99
6772,2022-09-23,2022-09-23,,Utility Payment,225.82,0.00,3131862.17
6773,2022-09-23,2022-09-23,,Utility Payment,114.61,0.00,3131747.56
6774,2022-09-23,2022-09-23,,Transfer Received,0.00,2339.47,3134087.03
6775,2022-09-22,2022-09-23,,Groceries - Supermarket,32.35,0.00,3134054.68
6776,2022-09-23,2022-09-23,,Salary Credit,0.00,3244.64,3137299.32
6777,2022-09-23,2022-09-24,,Salary Credit,0.00,4246.26,3141545.58
6778,2022-09-24,2022-09-24,,Groceries - Supermarket,95.03,0.00,3141450.55
6779,2022-09-24,2022-09-24,,Cash Deposit,0.00,600.97,3142051.52
6780,2022-09-24,2022-09-24,,Transfer Received,0.00,2949.36,3145000.88
6781,2022-09-23,2022-09-24,,Groceries - Online Delivery,116.63,0.00,3144884.25
6782,2022-09-24,2022-09-24,,Online Transfer,1493.06,0.00,3143391.19
6783,2022-09-25,2022-09-24,,Daily Essentials,19.69,0.00,3143371.50
6784,2022-09-25,2022-09-25,,Online Transfer,1516.92,0.00,3141854.58
6785,2022-09-25,2022-09-25,,Transfer Received,0.00,1323.11,3143177.69
6786,2022-09-26,2022-09-25,,Transfer Received,0.00,534.13,3143711.82
6787,2022-09-26,2022-09-26,,Transfer Received,0.00,902.22,3144614.04
6788,2022-09-26,2022-09-26,,Salary Credit,0.00,3686.09,3148300.13
6789,2022-09-27,2022-09-26,,Transfer Received,0.00,2796.77,3151096.90
6790,2022-09-25,2022-09-26,,Transfer Received,0.00,1052.81,3152149.71
6791,2022-09-26,2022-09-26,,ATM Withdrawal,226.89,0.00,3151922.82
6792,2022-09-26,2022-09-26,,Transfer Received,0.00,889.26,3152812.08
6793,2022-09-26,2022-09-26,,Investment - Mutual Funds,774.42,0.00,3152037.66
6794,2022-09-27,2022-09-27,,Salary Credit,0.00,4927.86,3156965.52
6795,2022-09-26,2022-09-27,,Online Transfer,871.77,0.00,3156093.75
6796,2022-09-27,2022-09-27,,ATM Withdrawal,238.92,0.00,3155854.83
6797,2022-09-28,2022-09-27,,Groceries - Supermarket,199.01,0.00,3155655.82
6798,2022-09-28,2022-09-28,,Groceries - Supermarket,139.32,0.00,3155516.50
6799,2022-09-28,2022-09-28,,Transfer Received,0.00,1968.68,3157485.18
6800,2022-09-28,2022-09-28,100165,Cheque Issued,1083.96,0.00,3156401.22
6801,2022-09-29,2022-09-29,,Groceries - Supermarket,188.00,0.00,3156213.22
6802,2022-09-28,2022-09-29,,Online Transfer,681.19,0.00,3155532.03
6803,2022-09-29,2022-09-29,,Transfer Received,0.00,2601.50,3158133.53
6804,2022-09-29,2022-09-29,,Dining Out,30.86,0.00,3158102.67
6805,2022-09-30,2022-09-29,,Salary Credit,0.00,4237.85,3162340.52
6806,2022-09-29,2022-09-29,,Salary Credit,0.00,3071.74,3165412.26
6807,2022-10-01,2022-09-30,,Dining Out,21.22,0.00,3165391.04
6808,2022-09-29,2022-09-30,,Salary Credit,0.00,2578.75,3167969.79
6809,2022-09-30,2022-09-30,,ATM Withdrawal,364.73,0.00,3167605.06
6810,2022-09-30,2022-09-30,,Online Transfer,1070.93,0.00,3166534.13
6811,2022-09-30,2022-09-30,,Investment Returns,0.00,688.29,3167222.42
6812,2022-10-01,2022-09-30,,ATM Withdrawal,89.44,0.00,3167132.98
6813,2022-09-29,2022-09-30,,Groceries - Supermarket,190.82,0.00,3166942.16
6814,2022-10-01,2022-10-01,,Transfer Received,0.00,2919.95,3169862.11
6815,2022-10-01,2022-10-01,,Interest Credited,0.00,57.77,3169919.88
6816,2022-10-01,2022-10-01,,Coffee Shop,19.94,0.00,3169899.94
6817,2022-09-30,2022-10-01,,Salary Credit,0.00,4510.64,3174410.58
6818,2022-09-30,2022-10-01,,Groceries - Supermarket,144.18,0.00,3174266.40
6819,2022-10-01,2022-10-01,,Investment Returns,0.00,890.47,3175156.87
6820,2022-10-01,2022-10-01,,Groceries - Supermarket,160.25,0.00,3174996.62
6821,2022-10-02,2022-10-01,,Dining Out,88.76,0.00,3174907.86
6822,2022-10-02,2022-10-02,,Utility Payment,120.72,0.00,3174787.14
6823,2022-10-02,2022-10-02,,Groceries - Supermarket,157.02,0.00,3174630.12
6824,2022-10-02,2022-10-02,,Online Transfer,829.15,0.00,3173800.97
6825,2022-10-02,2022-10-02,,Dining Out,63.31,0.00,3173737.66
6826,2022-10-02,2022-10-02,,Online Transfer,666.69,0.00,3173070.97
6827,2022-10-02,2022-10-02,100166,Cheque Issued,1371.23,0.00,3171699.74
6828,2022-10-01,2022-10-02,100167,Cheque Issued,2878.64,0.00,3168821.10
6829,2022-10-02,2022-10-02,,Investment - Mutual Funds,356.46,0.00,3168464.64
6830,2022-10-02,2022-10-03,,Daily Essentials,5.69,0.00,3168458.95
6831,2022-10-02,2022-10-03,,Daily Essentials,6.54,0.00,3168452.41
6832,2022-10-04,2022-10-03,,Groceries - Supermarket,191.32,0.00,3168261.09
6833,2022-10-03,2022-10-03,,Groceries - Supermarket,77.42,0.00,3168183.67
6834,2022-10-03,2022-10-03,,Takeout,39.27,0.00,3168144.40
6835,2022-10-04,2022-10-04,,Transfer Received,0.00,2147.66,3170292.06
6836,2022-10-04,2022-10-04,,Loan EMI,1434.53,0.00,3168857.53
6837,2022-10-04,2022-10-04,,Transfer Received,0.00,1052.70,3169910.23
6838,2022-10-04,2022-10-04,,Transfer Received,0.00,2931.55,3172841.78
6839,2022-10-05,2022-10-04,,Groceries - Supermarket,118.46,0.00,3172723.32
6840,2022-10-03,2022-10-04,,Interest Credited,0.00,43.61,3172766.93
6841,2022-10-04,2022-10-05,,Groceries - Online Delivery,119.35,0.00,3172647.58
6842,2022-10-05,2022-10-05,,Salary Credit,0.00,3725.45,3176373.03
6843,2022-10-05,2022-10-05,,Dining Out,83.30,0.00,3176289.73
6844,2022-10-05,2022-10-05,,Groceries - Supermarket,75.00,0.00,3176214.73
6845,2022-10-05,2022-10-05,,Groceries - Supermarket,89.04,0.00,3176125.69
6846,2022-10-04,2022-10-05,,Rental Income,0.00,1734.77,3177860.46
6847,2022-10-05,2022-10-05,,Utility Payment,92.92,0.00,3177767.54
6848,2022-10-05,2022-10-05,,Utility Payment,149.24,0.00,3177618.30
6849,2022-10-04,2022-10-05,,ATM Withdrawal,171.60,0.00,3177446.70
6850,2022-10-05,2022-10-06,,Credit Card Payment,899.02,0.00,3176547.68
6851,2022-10-05,2022-10-06,,Groceries - Online Delivery,141.50,0.00,3176406.18
6852,2022-10-06,2022-10-06,,Dining Out,64.61,0.00,3176341.57
6853,2022-10-06,2022-10-06,,Online Transfer,1779.29,0.00,3174562.28
6854,2022-10-08,2022-10-07,,Salary Credit,0.00,3741.02,3178303.30
6855,2022-10-07,2022-10-07,,Rental Income,0.00,2663.63,3180966.93
6856,2022-10-06,2022-10-07,,Loan EMI,978.23,0.00,3179988.70
6857,2022-10-07,2022-10-07,,Transfer Received,0.00,2925.60,3182914.30
6858,2022-10-07,2022-10-07,,Groceries - Supermarket,52.38,0.00,3182861.92
6859,2022-10-07,2022-10-07,,Rental Income,0.00,1220.43,3184082.35
6860,2022-10-08,2022-10-08,,Groceries - Online Delivery,78.19,0.00,3184004.16
6861,2022-10-07,2022-10-08,,Online Transfer,1351.08,0.00,3182653.08
6862,2022-10-07,2022-10-08,,Loan EMI,1113.12,0.00,3181539.96
6863,2022-10-09,2022-10-09,,Salary Credit,0.00,3088.05,3184628.01
6864,2022-10-08,2022-10-09,,Groceries - Supermarket,103.20,0.00,3184524.81
6865,2022-10-09,2022-10-09,,Salary Credit,0.00,3776.31,3188301.12
6866,2022-10-10,2022-10-09,,Salary Credit,0.00,4589.37,3192890.49
6867,2022-10-10,2022-10-09,,Loan EMI,656.08,0.00,3192234.41
6868,2022-10-09,2022-10-09,,Groceries - Online Delivery,139.33,0.00,3192095.08
6869,2022-10-09,2022-10-09,,Transfer Received,0.00,2051.09,3194146.17
6870,2022-10-09,2022-10-09,,Credit Card Payment,652.94,0.00,3193493.23
6871,2022-10-09,2022-10-09,100168,Cheque Issued,1915.04,0.00,3191578.19
6872,2022-10-09,2022-10-09,,Groceries - Supermarket,151.60,0.00,3191426.59
6873,2022-10-09,2022-10-09,,Online Transfer,667.53,0.00,3190759.06
6874,2022-10-10,2022-10-10,,Daily Essentials,43.69,0.00,3190715.37
6875,2022-10-10,2022-10-10,,Salary Credit,0.00,2987.74,3193703.11
6876,2022-10-11,2022-10-11,,Salary Credit,0.00,3359.08,3197062.19
6877,2022-10-11,2022-10-11,,Dividend Received,0.00,394.17,3197456.36
6878,2022-10-11,2022-10-11,,Transfer Received,0.00,1917.42,3199373.78
6879,2022-10-11,2022-10-11,,ATM Withdrawal,178.26,0.00,3199195.52
6880,2022-10-11,2022-10-11,,Salary Credit,0.00,4264.63,3203460.15
6881,2022-10-12,2022-10-12,,Cash Deposit,0.00,439.96,3203900.11
6882,2022-10-12,2022-10-12,,Credit Card Payment,952.06,0.00,3202948.05
6883,2022-10-13,2022-10-12,,Salary Credit,0.00,4585.94,3207533.99
6884,2022-10-12,2022-10-12,,Investment - Mutual Funds,786.39,0.00,3206747.60
6885,2022-10-12,2022-10-12,,Dining Out,75.92,0.00,3206671.68
6886,2022-10-12,2022-10-12,,Online Transfer,880.62,0.00,3205791.06
6887,2022-10-12,2022-10-12,,Groceries - Supermarket,77.29,0.00,3205713.77
6888,2022-10-12,2022-10-12,,Rental Income,0.00,1135.74,3206849.51
6889,2022-10-12,2022-10-12,,Dividend Received,0.00,152.63,3207002.14
6890,2022-10-13,2022-10-13,,Transfer Received,0.00,1989.55,3208991.69
6891,2022-10-13,2022-10-13,,Credit Card Payment,843.61,0.00,3208148.08
6892,2022-10-13,2022-10-13,,Daily Essentials,37.22,0.00,3208110.86
6893,2022-10-12,2022-10-13,,Rental Income,0.00,1369.15,3209480.01
6894,2022-10-13,2022-10-13,,Transfer Received,0.00,1124.48,3210604.49
6895,2022-10-13,2022-10-13,,Online Transfer,418.65,0.00,3210185.84
6896,2022-10-14,2022-10-14,,Loan EMI,705.34,0.00,3209480.50
6897,2022-10-14,2022-10-14,,Loan EMI,548.56,0.00,3208931.94
6898,2022-10-13,2022-10-14,,ATM Withdrawal,240.74,0.00,3208691.20
6899,2022-10-13,2022-10-14,,Groceries - Supermarket,164.58,0.00,3208526.62
6900,2022-10-14,2022-10-14,,Salary Credit,0.00,2510.09,3211036.71
6901,2022-10-13,2022-10-14,,Groceries - Supermarket,144.06,0.00,3210892.65
6902,2022-10-14,2022-10-14,,Salary Credit,0.00,4563.78,3215456.43
6903,2022-10-14,2022-10-14,,ATM Withdrawal,442.72,0.00,3215013.71
6904,2022-10-14,2022-10-14,,ATM Withdrawal,410.44,0.00,3214603.27
6905,2022-10-14,2022-10-14,,Salary Credit,0.00,4000.03,3218603.30
6906,2022-10-14,2022-10-14,,Salary Credit,0.00,3056.00,3221659.30
6907,2022-10-15,2022-10-15,,Transfer Received,0.00,2867.98,3224527.28
6908,2022-10-15,2022-10-15,,Interest Credited,0.00,86.52,3224613.80
6909,2022-10-15,2022-10-15,,Salary Credit,0.00,3358.82,3227972.62
6910,2022-10-16,2022-10-15,,ATM Withdrawal,210.43,0.00,3227762.19
6911,2022-10-14,2022-10-15,,Transfer Received,0.00,2802.12,3230564.31
6912,2022-10-15,2022-10-15,,Online Transfer,1651.27,0.00,3228913.04
6913,2022-10-14,2022-10-15,,Online Transfer,1540.24,0.00,3227372.80
6914,2022-10-15,2022-10-15,,Online Transfer,486.89,0.00,3226885.91
6915,2022-10-15,2022-10-15,,Investment - Mutual Funds,742.33,0.00,3226143.58
6916,2022-10-16,2022-10-16,,Investment Returns,0.00,697.23,3226840.81
6917,2022-10-16,2022-10-16,,Groceries - Supermarket,40.25,0.00,3226800.56
6918,2022-10-16,2022-10-16,,Groceries - Online Delivery,52.98,0.00,3226747.58
6919,2022-10-17,2022-10-16,,Transfer Received,0.00,2212.52,3228960.10
6920,2022-10-17,2022-10-17,,ATM Withdrawal,423.23,0.00,3228536.87
6921,2022-10-17,2022-10-17,,Transfer Received,0.00,2493.50,3231030.37
6922,2022-10-17,2022-10-17,,ATM Withdrawal,81.53,0.00,3230948.84
6923,2022-10-18,2022-10-17,,Rental Income,0.00,1890.42,3232839.26
6924,2022-10-18,2022-10-18,100169,Cheque Issued,2048.78,0.00,3230790.48
6925,2022-10-18,2022-10-18,,Transfer Received,0.00,1587.11,3232377.59
6926,2022-10-19,2022-10-18,,Dividend Received,0.00,440.81,3232818.40
6927,2022-10-18,2022-10-18,,Transfer Received,0.00,593.85,3233412.25
6928,2022-10-18,2022-10-18,,Online Transfer,1802.18,0.00,3231610.07
6929,2022-10-18,2022-10-18,,Loan EMI,1494.48,0.00,3230115.59
6930,2022-10-19,2022-10-19,,Online Transfer,1997.56,0.00,3228118.03
6931,2022-10-19,2022-10-19,100170,Cheque Issued,2874.49,0.00,3225243.54
6932,2022-10-18,2022-10-19,,Salary Credit,0.00,4332.43,3229575.97
6933,2022-10-19,2022-10-19,,Investment - SIP,473.59,0.00,3229102.38
6934,2022-10-18,2022-10-19,,ATM Withdrawal,486.66,0.00,3228615.72
6935,2022-10-18,2022-10-19,,Groceries - Supermarket,182.14,0.00,3228433.58
6936,2022-10-18,2022-10-19,,ATM Withdrawal,408.65,0.00,3228024.93
6937,2022-10-19,2022-10-19,,ATM Withdrawal,169.44,0.00,3227855.49
6938,2022-10-20,2022-10-20,,Transfer Received,0.00,1303.55,3229159.04
6939,2022-10-20,2022-10-20,,Transfer Received,0.00,1444.95,3230603.99
6940,2022-10-20,2022-10-20,,Online Transfer,286.27,0.00,3230317.72
6941,2022-10-20,2022-10-20,,Transfer Received,0.00,2037.37,3232355.09
6942,2022-10-20,2022-10-20,,ATM Withdrawal,149.12,0.00,3232205.97
6943,2022-10-20,2022-10-20,,Salary Credit,0.00,3729.71,3235935.68
6944,2022-10-21,2022-10-21,,Online Transfer,415.15,0.00,3235520.53
6945,2022-10-21,2022-10-21,,Utility Payment,266.16,0.00,3235254.37
6946,2022-10-21,2022-10-21,,Groceries - Supermarket,51.21,0.00,3235203.16
6947,2022-10-22,2022-10-21,,ATM Withdrawal,287.10,0.00,3234916.06
6948,2022-10-22,2022-10-22,,Online Transfer,587.17,0.00,3234328.89
6949,2022-10-21,2022-10-22,100171,Cheque Issued,2316.62,0.00,3232012.27
6950,2022-10-22,2022-10-22,,ATM Withdrawal,164.76,0.00,3231847.51
6951,2022-10-23,2022-10-22,,Coffee Shop,8.19,0.00,3231839.32
6952,2022-10-22,2022-10-22,,Salary Credit,0.00,4816.35,3236655.67
6953,2022-10-23,2022-10-23,,Transfer Received,0.00,1289.02,3237944.69
6954,2022-10-23,2022-10-23,,Dining Out,74.88,0.00,3237869.81
6955,2022-10-23,2022-10-23,,Credit Card Payment,288.53,0.00,3237581.28
6956,2022-10-23,2022-10-23,,ATM Withdrawal,199.48,0.00,3237381.80
6957,2022-10-22,2022-10-23,,Salary Credit,0.00,4378.39,3241760.19
6958,2022-10-23,2022-10-23,,Interest Credited,0.00,35.27,3241795.46
6959,2022-10-23,2022-10-23,,Utility Payment,136.51,0.00,3241658.95
6960,2022-10-23,2022-10-23,,Groceries - Supermarket,73.20,0.00,3241585.75
6961,2022-10-23,2022-10-24,,ATM Withdrawal,326.52,0.00,3241259.23
6962,2022-10-24,2022-10-24,,Groceries - Online Delivery,84.50,0.00,3241174.73
6963,2022-10-24,2022-10-24,,ATM Withdrawal,256.90,0.00,3240917.83
6964,2022-10-24,2022-10-24,,Groceries - Supermarket,96.23,0.00,3240821.60
6965,2022-10-24,2022-10-24,,Transfer Received,0.00,1952.55,3242774.15
6966,2022-10-24,2022-10-24,,Online Transfer,1345.95,0.00,3241428.20
6967,2022-10-24,2022-10-24,,Daily Essentials,37.55,0.00,3241390.65
6968,2022-10-23,2022-10-24,,Transfer Received,0.00,753.13,3242143.78
6969,2022-10-25,2022-10-25,,Salary Credit,0.00,4080.26,3246224.04
6970,2022-10-25,2022-10-25,,Dividend Received,0.00,122.44,3246346.48
6971,2022-10-26,2022-10-25,,Transfer Received,0.00,2037.18,3248383.66
6972,2022-10-25,2022-10-25,,Online Transfer,1133.41,0.00,3247250.25
6973,2022-10-25,2022-10-25,,ATM Withdrawal,212.56,0.00,3247037.69
6974,2022-10-25,2022-10-25,,Groceries - Supermarket,47.76,0.00,3246989.93
6975,2022-10-26,2022-10-25,,Utility Payment,66.44,0.00,3246923.49
6976,2022-10-25,2022-10-25,,Dividend Received,0.00,270.79,3247194.28
6977,2022-10-26,2022-10-26,,Credit Card Payment,626.75,0.00,3246567.53
6978,2022-10-25,2022-10-26,,Daily Essentials,22.08,0.00,3246545.45
6979,2022-10-27,2022-10-26,,Interest Credited,0.00,88.77,3246634.22
6980,2022-10-26,2022-10-26,,Transfer Received,0.00,1053.39,3247687.61
6981,2022-10-27,2022-10-26,,Transfer Received,0.00,2581.58,3250269.19
6982,2022-10-25,2022-10-26,,Takeout,11.23,0.00,3250257.96
6983,2022-10-26,2022-10-27,,Investment Returns,0.00,416.19,3250674.15
6984,2022-10-27,2022-10-27,,Dining Out,22.30,0.00,3250651.85
6985,2022-10-27,2022-10-27,,Dining Out,83.28,0.00,3250568.57
6986,2022-10-28,2022-10-27,,Groceries - Supermarket,139.87,0.00,3250428.70
6987,2022-10-27,2022-10-27,,ATM Withdrawal,41.26,0.00,3250387.44
6988,2022-10-27,2022-10-27,,Groceries - Supermarket,90.31,0.00,3250297.13
6989,2022-10-27,2022-10-27,,Transfer Received,0.00,1079.68,3251376.81
6990,2022-10-28,2022-10-27,,Credit Card Payment,587.79,0.00,3250789.02
6991,2022-10-27,2022-10-28,,Credit Card Payment,427.56,0.00,3250361.46
6992,2022-10-28,2022-10-28,,Groceries - Supermarket,132.97,0.00,3250228.49
6993,2022-10-28,2022-10-28,,Investment Returns,0.00,353.97,3250582.46
6994,2022-10-29,2022-10-28,,Transfer Received,0.00,881.88,3251464.34
6995,2022-10-28,2022-10-28,,ATM Withdrawal,69.62,0.00,3251394.72
6996,2022-10-28,2022-10-28,,Cash Deposit,0.00,288.79,3251683.51
6997,2022-10-29,2022-10-28,,Salary Credit,0.00,4108.53,3255792.04
6998,2022-10-28,2022-10-28,,ATM Withdrawal,179.34,0.00,3255612.70
6999,2022-10-27,2022-10-28,,Salary Credit,0.00,3450.01,3259062.71
7000,2022-10-30,2022-10-29,,ATM Withdrawal,169.86,0.00,3258892.85
7001,2022-10-29,2022-10-29,,Transfer Received,0.00,2622.74,3261515.59
7002,2022-10-30,2022-10-29,,ATM Withdrawal,498.99,0.00,3261016.60
7003,2022-10-29,2022-10-29,,Groceries - Supermarket,25.27,0.00,3260991.33
7004,2022-10-29,2022-10-29,,Utility Payment,199.01,0.00,3260792.32
7005,2022-10-29,2022-10-29,,ATM Withdrawal,313.81,0.00,3260478.51
7006,2022-10-31,2022-10-30,,ATM Withdrawal,240.43,0.00,3260238.08
7007,2022-10-30,2022-10-30,,Salary Credit,0.00,4320.90,3264558.98
7008,2022-10-30,2022-10-30,,Loan EMI,1663.31,0.00,3262895.67
7009,2022-10-30,2022-10-30,,Groceries - Supermarket,158.20,0.00,3262737.47
7010,2022-10-30,2022-10-30,,Online Transfer,225.36,0.00,3262512.11
7011,2022-10-31,2022-10-30,,Online Transfer,837.56,0.00,3261674.55
7012,2022-10-29,2022-10-30,,Transfer Received,0.00,1576.11,3263250.66
7013,2022-10-30,2022-10-30,,Credit Card Payment,234.14,0.00,3263016.52
7014,2022-10-30,2022-10-30,,Investment - SIP,489.55,0.00,3262526.97
7015,2022-10-30,2022-10-30,,Interest Credited,0.00,50.78,3262577.75
7016,2022-10-30,2022-10-30,,Groceries - Supermarket,136.28,0.00,3262441.47
7017,2022-10-30,2022-10-30,,Transfer Received,0.00,548.93,3262990.40
7018,2022-10-31,2022-10-31,,Loan EMI,1952.69,0.00,3261037.71
7019,2022-10-31,2022-10-31,,Online Transfer,1003.68,0.00,3260034.03
7020,2022-10-30,2022-10-31,,Loan EMI,1417.89,0.00,3258616.14
7021,2022-10-30,2022-10-31,,Rental Income,0.00,2319.73,3260935.87
7022,2022-10-30,2022-10-31,,ATM Withdrawal,226.77,0.00,3260709.10
7023,2022-10-31,2022-10-31,,Rental Income,0.00,2949.62,3263658.72
7024,2022-10-30,2022-10-31,,Credit Card Payment,505.78,0.00,3263152.94
7025,2022-10-31,2022-10-31,,Salary Credit,0.00,4771.25,3267924.19
7026,2022-10-31,2022-11-01,,Investment Returns,0.00,228.06,3268152.25
7027,2022-11-02,2022-11-01,,Credit Card Payment,914.96,0.00,3267237.29
7028,2022-11-01,2022-11-01,,Rental Income,0.00,1600.38,3268837.67
7029,2022-11-01,2022-11-01,,Groceries - Supermarket,70.49,0.00,3268767.18
7030,2022-11-02,2022-11-01,,ATM Withdrawal,264.05,0.00,3268503.13
7031,2022-11-01,2022-11-01,,Online Transfer,1465.37,0.00,3267037.76
7032,2022-11-01,2022-11-01,,Investment - SIP,972.76,0.00,3266065.00
7033,2022-11-02,2022-11-01,,Interest Credited,0.00,57.14,3266122.14
7034,2022-11-01,2022-11-01,,Salary Credit,0.00,2078.21,3268200.35
7035,2022-11-02,2022-11-02,,Groceries - Supermarket,164.00,0.00,3268036.35
7036,2022-11-01,2022-11-02,,Interest Credited,0.00,99.46,3268135.81
7037,2022-11-02,2022-11-02,,Dividend Received,0.00,194.05,3268329.86
7038,2022-11-01,2022-11-02,,Credit Card Payment,450.35,0.00,3267879.51
7039,2022-11-02,2022-11-02,,Transfer Received,0.00,1786.65,3269666.16
7040,2022-11-03,2022-11-03,,Investment - Mutual Funds,1465.33,0.00,3268200.83
7041,2022-11-03,2022-11-03,,Interest Credited,0.00,44.04,3268244.87
7042,2022-11-03,2022-11-03,,Credit Card Payment,365.23,0.00,3267879.64
7043,2022-11-03,2022-11-03,,Cash Deposit,0.00,845.41,3268725.05
7044,2022-11-03,2022-11-03,,Transfer Received,0.00,1657.08,3270382.13
7045,2022-11-03,2022-11-03,,ATM Withdrawal,473.86,0.00,3269908.27
7046,2022-11-03,2022-11-03,,Transfer Received,0.00,2136.21,3272044.48
7047,2022-11-03,2022-11-03,,Investment Returns,0.00,405.25,3272449.73
7048,2022-11-03,2022-11-03,,Cash Deposit,0.00,406.85,3272856.58
7049,2022-11-04,2022-11-03,,Dining Out,86.35,0.00,3272770.23
7050,2022-11-04,2022-11-04,,Coffee Shop,8.05,0.00,3272762.18
7051,2022-11-04,2022-11-04,,Transfer Received,0.00,1788.93,3274551.11
7052,2022-11-03,2022-11-04,,Transfer Received,0.00,1958.37,3276509.48
7053,2022-11-03,2022-11-04,,ATM Withdrawal,168.35,0.00,3276341.13
7054,2022-11-04,2022-11-04,,Takeout,26.54,0.00,3276314.59
7055,2022-11-03,2022-11-04,,ATM Withdrawal,395.42,0.00,3275919.17
7056,2022-11-04,2022-11-04,,Credit Card Payment,574.17,0.00,3275345.00
7057,2022-11-04,2022-11-04,,Groceries - Supermarket,38.10,0.00,3275306.90
7058,2022-11-04,2022-11-04,,ATM Withdrawal,454.05,0.00,3274852.85
7059,2022-11-04,2022-11-05,,Dining Out,69.64,0.00,3274783.21
7060,2022-11-04,2022-11-05,,Investment - Stocks,4422.22,0.00,3270360.99
7061,2022-11-05,2022-11-05,,Credit Card Payment,946.46,0.00,3269414.53
7062,2022-11-05,2022-11-05,,Credit Card Payment,811.17,0.00,3268603.36
7063,2022-11-05,2022-11-05,,Interest Credited,0.00,37.46,3268640.82
7064,2022-11-05,2022-11-05,,Investment - Stocks,3524.66,0.00,3265116.16
7065,2022-11-06,2022-11-06,,Interest Credited,0.00,73.14,3265189.30
7066,2022-11-06,2022-11-06,,Utility Payment,169.14,0.00,3265020.16
7067,2022-11-05,2022-11-06,,Transfer Received,0.00,1022.46,3266042.62
7068,2022-11-06,2022-11-06,,Credit Card Payment,453.40,0.00,3265589.22
7069,2022-11-06,2022-11-06,,Dining Out,63.47,0.00,3265525.75
7070,2022-11-06,2022-11-06,,Transfer Received,0.00,1365.77,3266891.52
7071,2022-11-06,2022-11-06,,Salary Credit,0.00,3011.83,3269903.35
7072,2022-11-06,2022-11-06,,Transfer Received,0.00,1741.23,3271644.58
7073,2022-11-05,2022-11-06,,Daily Essentials,13.12,0.00,3271631.46
7074,2022-11-07,2022-11-07,,Loan EMI,892.29,0.00,3270739.17
7075,2022-11-07,2022-11-07,,Transfer Received,0.00,1961.67,3272700.84
7076,2022-11-07,2022-11-07,,Salary Credit,0.00,4168.77,3276869.61
7077,2022-11-07,2022-11-07,,Transfer Received,0.00,1763.84,3278633.45
7078,2022-11-08,2022-11-08,,Salary Credit,0.00,4191.68,3282825.13
7079,2022-11-09,2022-11-08,,Interest Credited,0.00,21.80,3282846.93
7080,2022-11-08,2022-11-08,,Coffee Shop,10.47,0.00,3282836.46
7081,2022-11-08,2022-11-08,,Transfer Received,0.00,679.09,3283515.55
7082,2022-11-08,2022-11-08,,Groceries - Supermarket,122.10,0.00,3283393.45
7083,2022-11-08,2022-11-08,,Salary Credit,0.00,4347.84,3287741.29
7084,2022-11-08,2022-11-08,,Dining Out,55.89,0.00,3287685.40
7085,2022-11-09,2022-11-08,,Credit Card Payment,263.99,0.00,3287421.41
7086,2022-11-08,2022-11-08,,Utility Payment,134.98,0.00,3287286.43
7087,2022-11-08,2022-11-08,,Online Transfer,324.51,0.00,3286961.92
7088,2022-11-09,2022-11-09,,Online Transfer,1675.14,0.00,3285286.78
7089,2022-11-09,2022-11-09,,Transfer Received,0.00,2331.39,3287618.17
7090,2022-11-09,2022-11-09,,ATM Withdrawal,315.97,0.00,3287302.20
7091,2022-11-09,2022-11-09,,Groceries - Supermarket,183.55,0.00,3287118.65
7092,2022-11-10,2022-11-09,,ATM Withdrawal,80.38,0.00,3287038.27
7093,2022-11-08,2022-11-09,,Interest Credited,0.00,27.17,3287065.44
7094,2022-11-09,2022-11-09,,Transfer Received,0.00,2391.11,3289456.55
7095,2022-11-09,2022-11-09,,Credit Card Payment,487.11,0.00,3288969.44
7096,2022-11-11,2022-11-10,,Dividend Received,0.00,330.66,3289300.10
7097,2022-11-10,2022-11-10,,Transfer Received,0.00,2446.36,3291746.46
7098,2022-11-10,2022-11-10,,ATM Withdrawal,494.13,0.00,3291252.33
7099,2022-11-10,2022-11-10,,Transfer Received,0.00,755.41,3292007.74
7100,2022-11-10,2022-11-10,,ATM Withdrawal,338.36,0.00,3291669.38
7101,2022-11-09,2022-11-10,,Credit Card Payment,256.24,0.00,3291413.14
7102,2022-11-11,2022-11-11,,Transfer Received,0.00,2291.57,3293704.71
7103,2022-11-12,2022-11-11,,Online Transfer,129.94,0.00,3293574.77
7104,2022-11-11,2022-11-11,,Utility Payment,229.49,0.00,3293345.28
7105,2022-11-10,2022-11-11,,Transfer Received,0.00,1531.29,3294876.57
7106,2022-11-12,2022-11-12,,Online Transfer,1619.42,0.00,3293257.15
7107,2022-11-13,2022-11-12,,Utility Payment,239.50,0.00,3293017.65
7108,2022-11-13,2022-11-12,,Transfer Received,0.00,2969.54,3295987.19
7109,2022-11-12,2022-11-12,,Takeout,27.16,0.00,3295960.03
7110,2022-11-11,2022-11-12,,ATM Withdrawal,129.12,0.00,3295830.91
7111,2022-11-12,2022-11-12,,Groceries - Supermarket,91.16,0.00,3295739.75
7112,2022-11-12,2022-11-12,,Credit Card Payment,707.16,0.00,3295032.59
7113,2022-11-11,2022-11-12,,Investment - SIP,732.48,0.00,3294300.11
7114,2022-11-12,2022-11-12,,Salary Credit,0.00,4252.18,3298552.29
7115,2022-11-12,2022-11-12,,ATM Withdrawal,143.21,0.00,3298409.08
7116,2022-11-12,2022-11-12,,Transfer Received,0.00,1330.90,3299739.98
7117,2022-11-11,2022-11-12,,Credit Card Payment,524.94,0.00,3299215.04
7118,2022-11-12,2022-11-12,,Groceries - Supermarket,120.49,0.00,3299094.55
7119,2022-11-12,2022-11-12,,Loan EMI,1096.37,0.00,3297998.18
7120,2022-11-12,2022-11-12,,Transfer Received,0.00,1020.03,3299018.21
7121,2022-11-12,2022-11-12,,Groceries - Supermarket,38.96,0.00,3298979.25
7122,2022-11-13,2022-11-12,,Investment - Mutual Funds,681.18,0.00,3298298.07
7123,2022-11-12,2022-11-12,,Groceries - Supermarket,142.48,0.00,3298155.59
7124,2022-11-13,2022-11-13,,Salary Credit,0.00,4994.18,3303149.77
7125,2022-11-13,2022-11-13,,Salary Credit,0.00,3163.84,3306313.61
7126,2022-11-13,2022-11-13,,Cash Deposit,0.00,945.45,3307259.06
7127,2022-11-13,2022-11-13,,Transfer Received,0.00,2871.47,3310130.53
7128,2022-11-13,2022-11-13,,Investment - Mutual Funds,382.01,0.00,3309748.52
7129,2022-11-13,2022-11-13,,Transfer Received,0.00,521.35,3310269.87
7130,2022-11-13,2022-11-13,,ATM Withdrawal,488.49,0.00,3309781.38
7131,2022-11-12,2022-11-13,,Salary Credit,0.00,3669.06,3313450.44
7132,2022-11-14,2022-11-14,100172,Cheque Issued,2793.48,0.00,3310656.96
7133,2022-11-14,2022-11-14,,Online Transfer,1498.02,0.00,3309158.94
7134,2022-11-14,2022-11-14,,Rental Income,0.00,1657.19,3310816.13
7135,2022-11-14,2022-11-14,,Utility Payment,53.94,0.00,3310762.19
7136,2022-11-14,2022-11-14,,Dining Out,48.39,0.00,3310713.80
7137,2022-11-14,2022-11-14,,Transfer Received,0.00,2468.73,3313182.53
7138,2022-11-13,2022-11-14,,Online Transfer,428.07,0.00,3312754.46
7139,2022-11-13,2022-11-14,,ATM Withdrawal,349.54,0.00,3312404.92
7140,2022-11-14,2022-11-14,,Loan EMI,577.53,0.00,3311827.39
7141,2022-11-14,2022-11-14,,Credit Card Payment,465.63,0.00,3311361.76
7142,2022-11-14,2022-11-14,,Daily Essentials,6.93,0.00,3311354.83
7143,2022-11-14,2022-11-14,,Groceries - Online Delivery,139.94,0.00,3311214.89
7144,2022-11-15,2022-11-15,100173,Cheque Issued,2108.25,0.00,3309106.64
7145,2022-11-15,2022-11-15,,Utility Payment,160.91,0.00,3308945.73
7146,2022-11-15,2022-11-15,,Investment Returns,0.00,631.88,3309577.61
7147,2022-11-15,2022-11-15,,Investment - Mutual Funds,2360.41,0.00,3307217.20
7148,2022-11-15,2022-11-15,,Groceries - Supermarket,62.29,0.00,3307154.91
7149,2022-11-15,2022-11-15,100174,Cheque Issued,2424.81,0.00,3304730.10
7150,2022-11-15,2022-11-15,,Investment - SIP,651.88,0.00,3304078.22
7151,2022-11-16,2022-11-16,,Takeout,14.40,0.00,3304063.82
7152,2022-11-15,2022-11-16,,Salary Credit,0.00,2941.01,3307004.83
7153,2022-11-16,2022-11-16,,Online Transfer,974.27,0.00,3306030.56
7154,2022-11-16,2022-11-16,,Transfer Received,0.00,2684.13,3308714.69
7155,2022-11-16,2022-11-16,100175,Cheque Issued,1201.86,0.00,3307512.83
7156,2022-11-15,2022-11-16,,Salary Credit,0.00,4902.43,3312415.26
7157,2022-11-17,2022-11-17,,Transfer Received,0.00,2193.32,3314608.58
7158,2022-11-17,2022-11-17,,Transfer Received,0.00,597.08,3315205.66
7159,2022-11-17,2022-11-17,,Salary Credit,0.00,2726.20,3317931.86
7160,2022-11-18,2022-11-17,,Transfer Received,0.00,1140.46,3319072.32
7161,2022-11-17,2022-11-17,,Investment Returns,0.00,502.83,3319575.15
7162,2022-11-17,2022-11-17,,Salary Credit,0.00,3999.67,3323574.82
7163,2022-11-17,2022-11-17,100176,Cheque Issued,2289.30,0.00,3321285.52
7164,2022-11-16,2022-11-17,,Online Transfer,406.35,0.00,3320879.17
7165,2022-11-18,2022-11-18,,Credit Card Payment,418.93,0.00,3320460.24
7166,2022-11-18,2022-11-18,,Groceries - Supermarket,105.71,0.00,3320354.53
7167,2022-11-18,2022-11-18,,Groceries - Supermarket,120.18,0.00,3320234.35
7168,2022-11-17,2022-11-18,,Transfer Received,0.00,2491.23,3322725.58
7169,2022-11-18,2022-11-18,,ATM Withdrawal,199.38,0.00,3322526.20
7170,2022-11-18,2022-11-18,,Transfer Received,0.00,1046.03,3323572.23
7171,2022-11-18,2022-11-19,,Groceries - Supermarket,76.34,0.00,3323495.89
7172,2022-11-19,2022-11-19,,Transfer Received,0.00,2001.39,3325497.28
7173,2022-11-18,2022-11-19,,Online Transfer,1954.15,0.00,3323543.13
7174,2022-11-19,2022-11-19,,Cash Deposit,0.00,326.34,3323869.47
7175,2022-11-19,2022-11-19,,Dining Out,21.52,0.00,3323847.95
7176,2022-11-19,2022-11-19,,Online Transfer,637.30,0.00,3323210.65
7177,2022-11-19,2022-11-19,,Investment Returns,0.00,947.02,3324157.67
7178,2022-11-18,2022-11-19,,Transfer Received,0.00,1395.55,3325553.22
7179,2022-11-19,2022-11-19,,Groceries - Supermarket,67.59,0.00,3325485.63
7180,2022-11-19,2022-11-19,,ATM Withdrawal,127.79,0.00,3325357.84
7181,2022-11-19,2022-11-19,,ATM Withdrawal,68.53,0.00,3325289.31
7182,2022-11-19,2022-11-20,,Transfer Received,0.00,2620.52,3327909.83
7183,2022-11-20,2022-11-20,,Transfer Received,0.00,1559.54,3329469.37
7184,2022-11-20,2022-11-20,,Credit Card Payment,220.10,0.00,3329249.27
7185,2022-11-21,2022-11-20,,Transfer Received,0.00,2431.96,3331681.23
7186,2022-11-19,2022-11-20,,Rental Income,0.00,1716.86,3333398.09
7187,2022-11-20,2022-11-20,,Dividend Received,0.00,436.32,3333834.41
7188,2022-11-20,2022-11-20,,Transfer Received,0.00,1684.75,3335519.16
7189,2022-11-20,2022-11-20,,Transfer Received,0.00,2660.82,3338179.98
7190,2022-11-20,2022-11-20,100177,Cheque Issued,2676.21,0.00,3335503.77
7191,2022-11-21,2022-11-21,,Utility Payment,177.70,0.00,3335326.07
7192,2022-11-21,2022-11-21,,Salary Credit,0.00,3718.36,3339044.43
7193,2022-11-21,2022-11-21,,Coffee Shop,17.00,0.00,3339027.43
7194,2022-11-20,2022-11-21,,Investment - Mutual Funds,1545.68,0.00,3337481.75
7195,2022-11-21,2022-11-21,,Transfer Received,0.00,961.65,3338443.40
7196,2022-11-21,2022-11-22,,Groceries - Supermarket,29.84,0.00,3338413.56
7197,2022-11-22,2022-11-22,,Online Transfer,266.73,0.00,3338146.83
7198,2022-11-22,2022-11-22,,Salary Credit,0.00,4162.92,3342309.75
7199,2022-11-22,2022-11-22,,Takeout,36.15,0.00,3342273.60
7200,2022-11-22,2022-11-22,,Credit Card Payment,866.17,0.00,3341407.43
7201,2022-11-21,2022-11-22,,Groceries - Online Delivery,81.24,0.00,3341326.19
7202,2022-11-21,2022-11-22,,Rental Income,0.00,1003.93,3342330.12
7203,2022-11-23,2022-11-23,,Salary Credit,0.00,4716.98,3347047.10
7204,2022-11-24,2022-11-23,,Groceries - Supermarket,120.14,0.00,3346926.96
7205,2022-11-23,2022-11-23,,Utility Payment,130.44,0.00,3346796.52
7206,2022-11-22,2022-11-23,,Cash Deposit,0.00,531.59,3347328.11
7207,2022-11-22,2022-11-23,,Salary Credit,0.00,2903.05,3350231.16
7208,2022-11-24,2022-11-24,,ATM Withdrawal,436.45,0.00,3349794.71
7209,2022-11-24,2022-11-24,,Utility Payment,127.81,0.00,3349666.90
7210,2022-11-23,2022-11-24,,Investment - Stocks,2574.36,0.00,3347092.54
7211,2022-11-25,2022-11-24,,Salary Credit,0.00,4681.62,3351774.16
7212,2022-11-25,2022-11-24,,ATM Withdrawal,425.41,0.00,3351348.75
7213,2022-11-23,2022-11-24,,Transfer Received,0.00,1070.37,3352419.12
7214,2022-11-24,2022-11-24,,Dining Out,11.58,0.00,3352407.54
7215,2022-11-24,2022-11-24,,ATM Withdrawal,132.74,0.00,3352274.80
7216,2022-11-25,2022-11-24,,Salary Credit,0.00,4599.95,3356874.75
7217,2022-11-26,2022-11-25,,ATM Withdrawal,172.71,0.00,3356702.04
7218,2022-11-24,2022-11-25,,ATM Withdrawal,414.24,0.00,3356287.80
7219,2022-11-25,2022-11-25,,Investment - SIP,841.22,0.00,3355446.58
7220,2022-11-26,2022-11-26,,Rental Income,0.00,2272.49,3357719.07
7221,2022-11-27,2022-11-26,,Loan EMI,1206.86,0.00,3356512.21
7222,2022-11-26,2022-11-26,,ATM Withdrawal,408.95,0.00,3356103.26
7223,2022-11-27,2022-11-26,,Transfer Received,0.00,2602.60,3358705.86
7224,2022-11-26,2022-11-26,,Loan EMI,832.90,0.00,3357872.96
7225,2022-11-26,2022-11-26,,Investment Returns,0.00,193.84,3358066.80
7226,2022-11-27,2022-11-27,,Credit Card Payment,548.37,0.00,3357518.43
7227,2022-11-27,2022-11-27,,Utility Payment,189.83,0.00,3357328.60
7228,2022-11-27,2022-11-27,,Salary Credit,0.00,3405.80,3360734.40
7229,2022-11-27,2022-11-27,,Transfer Received,0.00,1398.80,3362133.20
7230,2022-11-28,2022-11-27,,Transfer Received,0.00,1085.83,3363219.03
7231,2022-11-28,2022-11-28,,Groceries - Supermarket,85.89,0.00,3363133.14
7232,2022-11-28,2022-11-28,,ATM Withdrawal,355.81,0.00,3362777.33
7233,2022-11-27,2022-11-28,,ATM Withdrawal,147.70,0.00,3362629.63
7234,2022-11-28,2022-11-28,,Dining Out,38.87,0.00,3362590.76
7235,2022-11-28,2022-11-28,,Investment - SIP,393.38,0.00,3362197.38
7236,2022-11-28,2022-11-28,,Groceries - Supermarket,37.95,0.00,3362159.43
7237,2022-11-29,2022-11-29,100178,Cheque Issued,1255.06,0.00,3360904.37
7238,2022-11-29,2022-11-29,,Salary Credit,0.00,2999.38,3363903.75
7239,2022-11-28,2022-11-29,,Groceries - Supermarket,20.94,0.00,3363882.81
7240,2022-11-29,2022-11-29,,Investment - Mutual Funds,1813.36,0.00,3362069.45
7241,2022-11-29,2022-11-29,,ATM Withdrawal,173.28,0.00,3361896.17
7242,2022-11-29,2022-11-29,,Dividend Received,0.00,282.05,3362178.22
7243,2022-11-29,2022-11-29,,Dining Out,76.49,0.00,3362101.73
7244,2022-11-30,2022-11-30,,Transfer Received,0.00,2088.81,3364190.54
7245,2022-11-30,2022-11-30,,Daily Essentials,36.64,0.00,3364153.90
7246,2022-12-01,2022-11-30,,Credit Card Payment,656.91,0.00,3363496.99
7247,2022-11-30,2022-11-30,,Transfer Received,0.00,2328.86,3365825.85
7248,2022-12-01,2022-11-30,,Online Transfer,1983.53,0.00,3363842.32
7249,2022-11-30,2022-11-30,,ATM Withdrawal,118.20,0.00,3363724.12
7250,2022-11-30,2022-11-30,,Rental Income,0.00,1448.20,3365172.32
7251,2022-11-30,2022-11-30,100179,Cheque Issued,1847.53,0.00,3363324.79
7252,2022-12-01,2022-12-01,,Utility Payment,257.00,0.00,3363067.79
7253,2022-12-02,2022-12-01,,Dining Out,53.60,0.00,3363014.19
7254,2022-12-01,2022-12-01,,Utility Payment,55.16,0.00,3362959.03
7255,2022-12-01,2022-12-01,,Transfer Received,0.00,1122.33,3364081.36
7256,2022-12-01,2022-12-01,,Credit Card Payment,962.60,0.00,3363118.76
7257,2022-11-30,2022-12-01,,ATM Withdrawal,252.04,0.00,3362866.72
7258,2022-12-02,2022-12-02,,Salary Credit,0.00,2535.82,3365402.54
7259,2022-12-02,2022-12-02,,Utility Payment,121.52,0.00,3365281.02
7260,2022-12-02,2022-12-02,,ATM Withdrawal,197.01,0.00,3365084.01
7261,2022-12-01,2022-12-02,,Daily Essentials,39.68,0.00,3365044.33
7262,2022-12-02,2022-12-02,,Loan EMI,1583.86,0.00,3363460.47
7263,2022-12-01,2022-12-02,,ATM Withdrawal,265.11,0.00,3363195.36
7264,2022-12-02,2022-12-02,,Groceries - Supermarket,100.26,0.00,3363095.10
7265,2022-12-02,2022-12-02,,Loan EMI,900.39,0.00,3362194.71
7266,2022-12-01,2022-12-02,,Transfer Received,0.00,1518.10,3363712.81
7267,2022-12-02,2022-12-02,,Investment - Stocks,2170.21,0.00,3361542.60
7268,2022-12-02,2022-12-02,,ATM Withdrawal,247.38,0.00,3361295.22
7269,2022-12-03,2022-12-03,,Salary Credit,0.00,4836.78,3366132.00
7270,2022-12-03,2022-12-03,,Takeout,41.45,0.00,3366090.55
7271,2022-12-03,2022-12-03,,Salary Credit,0.00,3511.36,3369601.91
7272,2022-12-03,2022-12-03,,Groceries - Supermarket,33.69,0.00,3369568.22
7273,2022-12-03,2022-12-03,,Investment Returns,0.00,265.73,3369833.95
7274,2022-12-03,2022-12-03,,Online Transfer,281.33,0.00,3369552.62
7275,2022-12-03,2022-12-03,,Credit Card Payment,872.52,0.00,3368680.10
7276,2022-12-05,2022-12-04,,Utility Payment,220.85,0.00,3368459.25
7277,2022-12-04,2022-12-04,,Investment - Mutual Funds,1344.85,0.00,3367114.40
7278,2022-12-03,2022-12-04,,Transfer Received,0.00,2428.40,3369542.80
7279,2022-12-04,2022-12-04,,ATM Withdrawal,437.26,0.00,3369105.54
7280,2022-12-04,2022-12-04,,Salary Credit,0.00,4471.53,3373577.07
7281,2022-12-06,2022-12-05,,Daily Essentials,38.59,0.00,3373538.48
7282,2022-12-05,2022-12-05,,Salary Credit,0.00,4706.87,3378245.35
7283,2022-12-05,2022-12-05,,Transfer Received,0.00,2621.67,3380867.02
7284,2022-12-05,2022-12-05,,Transfer Received,0.00,2504.01,3383371.03
7285,2022-12-05,2022-12-05,,Groceries - Online Delivery,83.25,0.00,3383287.78
7286,2022-12-05,2022-12-05,,Credit Card Payment,392.47,0.00,3382895.31
7287,2022-12-06,2022-12-06,,ATM Withdrawal,201.88,0.00,3382693.43
7288,2022-12-06,2022-12-06,,Groceries - Supermarket,64.18,0.00,3382629.25
7289,2022-12-06,2022-12-06,,Online Transfer,468.61,0.00,3382160.64
7290,2022-12-06,2022-12-06,,ATM Withdrawal,173.51,0.00,3381987.13
7291,2022-12-06,2022-12-06,,ATM Withdrawal,411.35,0.00,3381575.78
7292,2022-12-06,2022-12-06,,Salary Credit,0.00,2255.52,3383831.30
7293,2022-12-06,2022-12-06,,ATM Withdrawal,257.90,0.00,3383573.40
7294,2022-12-06,2022-12-06,,Transfer Received,0.00,1301.30,3384874.70
7295,2022-12-07,2022-12-06,,ATM Withdrawal,329.39,0.00,3384545.31
7296,2022-12-06,2022-12-06,,Salary Credit,0.00,3732.35,3388277.66
7297,2022-12-06,2022-12-06,,Loan EMI,675.52,0.00,3387602.14
7298,2022-12-06,2022-12-06,,Salary Credit,0.00,3497.41,3391099.55
7299,2022-12-06,2022-12-06,,Daily Essentials,29.62,0.00,3391069.93
7300,2022-12-07,2022-12-06,,Online Transfer,505.22,0.00,3390564.71
7301,2022-12-07,2022-12-06,,Transfer Received,0.00,820.94,3391385.65
7302,2022-12-07,2022-12-07,,Transfer Received,0.00,1663.22,3393048.87
7303,2022-12-07,2022-12-07,,Salary Credit,0.00,3809.87,3396858.74
7304,2022-12-07,2022-12-07,,Daily Essentials,36.60,0.00,3396822.14
7305,2022-12-08,2022-12-08,,Utility Payment,146.73,0.00,3396675.41
7306,2022-12-08,2022-12-08,,Daily Essentials,37.02,0.00,3396638.39
7307,2022-12-08,2022-12-08,,Salary Credit,0.00,2666.78,3399305.17
7308,2022-12-08,2022-12-08,,Online Transfer,1560.51,0.00,3397744.66
7309,2022-12-08,2022-12-08,,Transfer Received,0.00,2329.60,3400074.26
7310,2022-12-08,2022-12-08,,Salary Credit,0.00,2262.12,3402336.38
7311,2022-12-09,2022-12-09,,Groceries - Supermarket,169.69,0.00,3402166.69
7312,2022-12-10,2022-12-09,,Rental Income,0.00,1147.07,3403313.76
7313,2022-12-10,2022-12-09,,Dividend Received,0.00,280.84,3403594.60
7314,2022-12-10,2022-12-09,,Groceries - Supermarket,100.57,0.00,3403494.03
7315,2022-12-09,2022-12-09,,Interest Credited,0.00,37.75,3403531.78
7316,2022-12-08,2022-12-09,,Groceries - Supermarket,97.38,0.00,3403434.40
7317,2022-12-09,2022-12-09,,ATM Withdrawal,40.62,0.00,3403393.78
7318,2022-12-09,2022-12-09,,ATM Withdrawal,208.88,0.00,3403184.90
7319,2022-12-09,2022-12-09,,Takeout,39.62,0.00,3403145.28
7320,2022-12-09,2022-12-09,,Groceries - Supermarket,171.78,0.00,3402973.50
7321,2022-12-09,2022-12-10,,Salary Credit,0.00,2453.96,3405427.46
7322,2022-12-10,2022-12-10,,Transfer Received,0.00,2148.92,3407576.38
7323,2022-12-10,2022-12-10,,Online Transfer,933.78,0.00,3406642.60
7324,2022-12-10,2022-12-10,,Online Transfer,917.67,0.00,3405724.93
7325,2022-12-10,2022-12-10,,Loan EMI,639.16,0.00,3405085.77
7326,2022-12-11,2022-12-11,,Transfer Received,0.00,2856.64,3407942.41
7327,2022-12-10,2022-12-11,,Salary Credit,0.00,4591.44,3412533.85
7328,2022-12-12,2022-12-12,,ATM Withdrawal,461.31,0.00,3412072.54
7329,2022-12-12,2022-12-12,,ATM Withdrawal,444.89,0.00,3411627.65
7330,2022-12-12,2022-12-12,,Utility Payment,283.08,0.00,3411344.57
7331,2022-12-14,2022-12-13,,Transfer Received,0.00,2518.75,3413863.32
7332,2022-12-13,2022-12-13,,Transfer Received,0.00,1291.49,3415154.81
7333,2022-12-13,2022-12-13,,Utility Payment,106.62,0.00,3415048.19
7334,2022-12-13,2022-12-13,,Transfer Received,0.00,1080.45,3416128.64
7335,2022-12-13,2022-12-13,,Transfer Received,0.00,2935.85,3419064.49
7336,2022-12-13,2022-12-13,,Investment Returns,0.00,145.14,3419209.63
7337,2022-12-14,2022-12-14,,Interest Credited,0.00,32.90,3419242.53
7338,2022-12-14,2022-12-14,,Salary Credit,0.00,3428.33,3422670.86
7339,2022-12-14,2022-12-14,,Salary Credit,0.00,3212.24,3425883.10
7340,2022-12-15,2022-12-14,,Transfer Received,0.00,1256.37,3427139.47
7341,2022-12-14,2022-12-14,,ATM Withdrawal,289.46,0.00,3426850.01
7342,2022-12-14,2022-12-14,,ATM Withdrawal,326.87,0.00,3426523.14
7343,2022-12-14,2022-12-14,,Cash Deposit,0.00,736.18,3427259.32
7344,2022-12-14,2022-12-14,,Transfer Received,0.00,1593.17,3428852.49
7345,2022-12-15,2022-12-14,,Online Transfer,138.58,0.00,3428713.91
7346,2022-12-14,2022-12-14,,ATM Withdrawal,80.04,0.00,3428633.87
7347,2022-12-15,2022-12-14,,Salary Credit,0.00,2237.77,3430871.64
7348,2022-12-16,2022-12-15,,Groceries - Supermarket,116.74,0.00,3430754.90
7349,2022-12-15,2022-12-15,,Salary Credit,0.00,3274.91,3434029.81
7350,2022-12-15,2022-12-15,,Online Transfer,1977.49,0.00,3432052.32
7351,2022-12-15,2022-12-15,,Credit Card Payment,863.14,0.00,3431189.18
7352,2022-12-15,2022-12-15,,Salary Credit,0.00,3805.19,3434994.37
7353,2022-12-15,2022-12-15,,ATM Withdrawal,376.20,0.00,3434618.17
7354,2022-12-15,2022-12-15,,Transfer Received,0.00,1068.10,3435686.27
7355,2022-12-15,2022-12-15,,Interest Credited,0.00,94.97,3435781.24
7356,2022-12-15,2022-12-15,,ATM Withdrawal,180.59,0.00,3435600.65
7357,2022-12-15,2022-12-16,,Online Transfer,1407.39,0.00,3434193.26
7358,2022-12-16,2022-12-16,,Coffee Shop,5.08,0.00,3434188.18
7359,2022-12-16,2022-12-16,,ATM Withdrawal,224.10,0.00,3433964.08
7360,2022-12-16,2022-12-16,,Transfer Received,0.00,1697.45,3435661.53
7361,2022-12-16,2022-12-16,,Salary Credit,0.00,4005.73,3439667.26
7362,2022-12-15,2022-12-16,,Salary Credit,0.00,3128.93,3442796.19
7363,2022-12-17,2022-12-17,100180,Cheque Issued,1658.22,0.00,3441137.97
7364,2022-12-16,2022-12-17,,Utility Payment,165.96,0.00,3440972.01
7365,2022-12-17,2022-12-17,,Online Transfer,321.50,0.00,3440650.51
7366,2022-12-17,2022-12-17,,Groceries - Supermarket,98.30,0.00,3440552.21
7367,2022-12-17,2022-12-17,,ATM Withdrawal,366.43,0.00,3440185.78
7368,2022-12-18,2022-12-17,,Online Transfer,706.46,0.00,3439479.32
7369,2022-12-17,2022-12-17,,Utility Payment,187.07,0.00,3439292.25
7370,2022-12-16,2022-12-17,,Dining Out,44.11,0.00,3439248.14
7371,2022-12-16,2022-12-17,,Dining Out,53.77,0.00,3439194.37
7372,2022-12-17,2022-12-17,,Transfer Received,0.00,2596.26,3441790.63
7373,2022-12-18,2022-12-17,,Groceries - Supermarket,58.72,0.00,3441731.91
7374,2022-12-16,2022-12-17,,Utility Payment,90.80,0.00,3441641.11
7375,2022-12-18,2022-12-18,,Salary Credit,0.00,2631.43,3444272.54
7376,2022-12-18,2022-12-18,,Online Transfer,1115.12,0.00,3443157.42
7377,2022-12-18,2022-12-18,,Loan EMI,1838.40,0.00,3441319.02
7378,2022-12-17,2022-12-18,,Transfer Received,0.00,649.41,3441968.43
7379,2022-12-17,2022-12-18,,Transfer Received,0.00,1590.48,3443558.91
7380,2022-12-19,2022-12-19,,Dividend Received,0.00,102.21,3443661.12
7381,2022-12-19,2022-12-19,,ATM Withdrawal,456.62,0.00,3443204.50
7382,2022-12-18,2022-12-19,,Salary Credit,0.00,2548.80,3445753.30
7383,2022-12-20,2022-12-19,,Salary Credit,0.00,2134.28,3447887.58
7384,2022-12-19,2022-12-19,,ATM Withdrawal,300.39,0.00,3447587.19
7385,2022-12-18,2022-12-19,,Credit Card Payment,822.33,0.00,3446764.86
7386,2022-12-19,2022-12-19,,ATM Withdrawal,261.30,0.00,3446503.56
7387,2022-12-19,2022-12-19,,Groceries - Supermarket,80.41,0.00,3446423.15
7388,2022-12-19,2022-12-19,,Online Transfer,1903.17,0.00,3444519.98
7389,2022-12-19,2022-12-20,,Rental Income,0.00,1509.09,3446029.07
7390,2022-12-20,2022-12-20,,Interest Credited,0.00,67.07,3446096.14
7391,2022-12-20,2022-12-20,,Groceries - Supermarket,167.12,0.00,3445929.02
7392,2022-12-20,2022-12-20,,Takeout,31.68,0.00,3445897.34
7393,2022-12-21,2022-12-20,,Transfer Received,0.00,751.53,3446648.87
7394,2022-12-21,2022-12-21,,ATM Withdrawal,284.69,0.00,3446364.18
7395,2022-12-21,2022-12-21,,Transfer Received,0.00,2573.25,3448937.43
7396,2022-12-22,2022-12-21,,Interest Credited,0.00,52.18,3448989.61
7397,2022-12-21,2022-12-21,,Online Transfer,1858.35,0.00,3447131.26
7398,2022-12-21,2022-12-21,,Transfer Received,0.00,1465.65,3448596.91
7399,2022-12-21,2022-12-21,,Utility Payment,141.50,0.00,3448455.41
7400,2022-12-21,2022-12-21,,Utility Payment,264.82,0.00,3448190.59
7401,2022-12-21,2022-12-21,,Transfer Received,0.00,685.79,3448876.38
7402,2022-12-22,2022-12-22,,Transfer Received,0.00,2012.89,3450889.27
7403,2022-12-23,2022-12-22,100181,Cheque Issued,1095.85,0.00,3449793.42
7404,2022-12-22,2022-12-22,,Dividend Received,0.00,328.33,3450121.75
7405,2022-12-22,2022-12-22,,ATM Withdrawal,372.18,0.00,3449749.57
7406,2022-12-21,2022-12-22,,ATM Withdrawal,176.43,0.00,3449573.14
7407,2022-12-22,2022-12-22,,ATM Withdrawal,435.38,0.00,3449137.76
7408,2022-12-22,2022-12-22,,Utility Payment,291.86,0.00,3448845.90
7409,2022-12-23,2022-12-23,,ATM Withdrawal,357.41,0.00,3448488.49
7410,2022-12-23,2022-12-23,,ATM Withdrawal,23.55,0.00,3448464.94
7411,2022-12-23,2022-12-23,,Investment - Stocks,1184.44,0.00,3447280.50
7412,2022-12-24,2022-12-23,,Transfer Received,0.00,2706.10,3449986.60
7413,2022-12-25,2022-12-24,,Salary Credit,0.00,4069.83,3454056.43
7414,2022-12-24,2022-12-24,,Transfer Received,0.00,2150.29,3456206.72
7415,2022-12-25,2022-12-24,,Investment - SIP,814.37,0.00,3455392.35
7416,2022-12-25,2022-12-24,,Cash Deposit,0.00,813.54,3456205.89
7417,2022-12-24,2022-12-24,,Loan EMI,1767.88,0.00,3454438.01
7418,2022-12-24,2022-12-24,,Takeout,32.63,0.00,3454405.38
7419,2022-12-24,2022-12-24,,Transfer Received,0.00,1306.56,3455711.94
7420,2022-12-24,2022-12-24,,Transfer Received,0.00,2169.50,3457881.44
7421,2022-12-24,2022-12-24,,Transfer Received,0.00,546.88,3458428.32
7422,2022-12-25,2022-12-24,,Interest Credited,0.00,73.90,3458502.22
7423,2022-12-25,2022-12-25,,Investment Returns,0.00,291.02,3458793.24
7424,2022-12-24,2022-12-25,,Loan EMI,1071.06,0.00,3457722.18
7425,2022-12-25,2022-12-25,,Groceries - Supermarket,33.28,0.00,3457688.90
7426,2022-12-24,2022-12-25,,Groceries - Supermarket,187.05,0.00,3457501.85
7427,2022-12-24,2022-12-25,,Groceries - Supermarket,157.01,0.00,3457344.84
7428,2022-12-26,2022-12-25,,Cash Deposit,0.00,177.92,3457522.76
7429,2022-12-25,2022-12-25,100182,Cheque Issued,617.84,0.00,3456904.92
7430,2022-12-26,2022-12-25,,Salary Credit,0.00,4443.54,3461348.46
7431,2022-12-25,2022-12-25,,Transfer Received,0.00,881.16,3462229.62
7432,2022-12-26,2022-12-26,,Transfer Received,0.00,1733.50,3463963.12
7433,2022-12-25,2022-12-26,,Dining Out,99.65,0.00,3463863.47
7434,2022-12-27,2022-12-26,,Dining Out,18.84,0.00,3463844.63
7435,2022-12-27,2022-12-27,,Dividend Received,0.00,327.40,3464172.03
7436,2022-12-26,2022-12-27,,Dividend Received,0.00,430.73,3464602.76
7437,2022-12-28,2022-12-27,,Dining Out,19.48,0.00,3464583.28
7438,2022-12-27,2022-12-27,,Loan EMI,1881.07,0.00,3462702.21
7439,2022-12-28,2022-12-28,,Takeout,10.53,0.00,3462691.68
7440,2022-12-29,2022-12-28,,Utility Payment,266.52,0.00,3462425.16
7441,2022-12-28,2022-12-28,,Online Transfer,1584.43,0.00,3460840.73
7442,2022-12-28,2022-12-28,,Transfer Received,0.00,1737.14,3462577.87
7443,2022-12-28,2022-12-28,,Credit Card Payment,230.31,0.00,3462347.56
7444,2022-12-28,2022-12-28,,Transfer Received,0.00,2432.07,3464779.63
7445,2022-12-28,2022-12-28,,ATM Withdrawal,384.41,0.00,3464395.22
7446,2022-12-28,2022-12-28,,Takeout,18.65,0.00,3464376.57
7447,2022-12-28,2022-12-28,,ATM Withdrawal,263.32,0.00,3464113.25
7448,2022-12-29,2022-12-29,,Cash Deposit,0.00,203.33,3464316.58
7449,2022-12-29,2022-12-29,,ATM Withdrawal,434.96,0.00,3463881.62
7450,2022-12-29,2022-12-29,,ATM Withdrawal,160.84,0.00,3463720.78
7451,2022-12-29,2022-12-29,,Utility Payment,223.79,0.00,3463496.99
7452,2022-12-30,2022-12-30,,Dining Out,65.13,0.00,3463431.86
7453,2022-12-30,2022-12-30,,ATM Withdrawal,227.94,0.00,3463203.92
7454,2022-12-30,2022-12-30,,Transfer Received,0.00,1805.70,3465009.62
7455,2022-12-31,2022-12-31,,Credit Card Payment,690.19,0.00,3464319.43
7456,2022-12-31,2022-12-31,,ATM Withdrawal,66.10,0.00,3464253.33
7457,2022-12-31,2023-01-01,,Investment - Mutual Funds,351.75,0.00,3463901.58
7458,2023-01-01,2023-01-01,,Salary Credit,0.00,4937.46,3468839.04
7459,2023-01-02,2023-01-01,,Online Transfer,1002.52,0.00,3467836.52
7460,2023-01-01,2023-01-01,,Investment - SIP,390.78,0.00,3467445.74
7461,2023-01-01,2023-01-01,,Groceries - Supermarket,166.29,0.00,3467279.45
7462,2023-01-01,2023-01-01,,Online Transfer,603.97,0.00,3466675.48
7463,2023-01-03,2023-01-02,,Salary Credit,0.00,4029.33,3470704.81
7464,2023-01-02,2023-01-02,,ATM Withdrawal,275.02,0.00,3470429.79
7465,2023-01-03,2023-01-02,,Groceries - Supermarket,160.67,0.00,3470269.12
7466,2023-01-02,2023-01-02,,ATM Withdrawal,245.66,0.00,3470023.46
7467,2023-01-02,2023-01-02,,ATM Withdrawal,24.36,0.00,3469999.10
7468,2023-01-02,2023-01-02,,Credit Card Payment,564.64,0.00,3469434.46
7469,2023-01-02,2023-01-02,,Salary Credit,0.00,4092.60,3473527.06
7470,2023-01-02,2023-01-02,,Groceries - Online Delivery,136.36,0.00,3473390.70
7471,2023-01-02,2023-01-02,,Groceries - Online Delivery,91.40,0.00,3473299.30
7472,2023-01-02,2023-01-02,,Transfer Received,0.00,2332.58,3475631.88
7473,2023-01-02,2023-01-02,,Utility Payment,122.06,0.00,3475509.82
7474,2023-01-03,2023-01-03,,Daily Essentials,12.32,0.00,3475497.50
7475,2023-01-03,2023-01-03,,Online Transfer,1005.80,0.00,3474491.70
7476,2023-01-03,2023-01-03,,Utility Payment,243.01,0.00,3474248.69
7477,2023-01-03,2023-01-03,,ATM Withdrawal,381.40,0.00,3473867.29
7478,2023-01-04,2023-01-04,,Loan EMI,728.49,0.00,3473138.80
7479,2023-01-04,2023-01-04,,Utility Payment,104.48,0.00,3473034.32
7480,2023-01-04,2023-01-04,,Online Transfer,1575.25,0.00,3471459.07
7481,2023-01-05,2023-01-04,,Rental Income,0.00,2455.14,3473914.21
7482,2023-01-05,2023-01-05,,Transfer Received,0.00,1625.67,3475539.88
7483,2023-01-05,2023-01-05,,Cash Deposit,0.00,183.44,3475723.32
7484,2023-01-05,2023-01-05,100183,Cheque Issued,528.81,0.00,3475194.51
7485,2023-01-05,2023-01-05,,ATM Withdrawal,138.01,0.00,3475056.50
7486,2023-01-04,2023-01-05,,ATM Withdrawal,228.55,0.00,3474827.95
7487,2023-01-06,2023-01-05,,Online Transfer,252.82,0.00,3474575.13
7488,2023-01-05,2023-01-05,,Transfer Received,0.00,1006.46,3475581.59
7489,2023-01-06,2023-01-06,,Utility Payment,238.68,0.00,3475342.91
7490,2023-01-07,2023-01-06,,Dining Out,52.36,0.00,3475290.55
7491,2023-01-07,2023-01-06,,Credit Card Payment,983.69,0.00,3474306.86
7492,2023-01-06,2023-01-06,,Investment Returns,0.00,605.43,3474912.29
7493,2023-01-06,2023-01-06,,Transfer Received,0.00,1167.76,3476080.05
7494,2023-01-06,2023-01-06,,ATM Withdrawal,108.82,0.00,3475971.23
7495,2023-01-06,2023-01-06,,Credit Card Payment,527.44,0.00,3475443.79
7496,2023-01-07,2023-01-06,,Transfer Received,0.00,1905.83,3477349.62
7497,2023-01-06,2023-01-06,,Utility Payment,205.23,0.00,3477144.39
7498,2023-01-07,2023-01-06,,Interest Credited,0.00,63.45,3477207.84
7499,2023-01-07,2023-01-07,,Utility Payment,141.73,0.00,3477066.11
7500,2023-01-07,2023-01-07,,Utility Payment,124.30,0.00,3476941.81
7501,2023-01-08,2023-01-07,,Groceries - Supermarket,159.65,0.00,3476782.16
7502,2023-01-07,2023-01-07,,Groceries - Online Delivery,107.54,0.00,3476674.62
7503,2023-01-07,2023-01-07,,Groceries - Supermarket,99.08,0.00,3476575.54
7504,2023-01-07,2023-01-07,,ATM Withdrawal,197.21,0.00,3476378.33
7505,2023-01-06,2023-01-07,,Salary Credit,0.00,2838.68,3479217.01
7506,2023-01-07,2023-01-07,,Online Transfer,1076.92,0.00,3478140.09
7507,2023-01-07,2023-01-07,100184,Cheque Issued,2090.95,0.00,3476049.14
7508,2023-01-07,2023-01-07,,Dining Out,46.28,0.00,3476002.86
7509,2023-01-07,2023-01-08,,Online Transfer,1812.87,0.00,3474189.99
7510,2023-01-08,2023-01-08,,Investment - SIP,146.98,0.00,3474043.01
7511,2023-01-08,2023-01-08,,Interest Credited,0.00,99.93,3474142.94
7512,2023-01-08,2023-01-08,,Credit Card Payment,795.90,0.00,3473347.04
7513,2023-01-08,2023-01-08,,Utility Payment,296.94,0.00,3473050.10
7514,2023-01-08,2023-01-08,,Interest Credited,0.00,67.18,3473117.28
7515,2023-01-08,2023-01-08,,Salary Credit,0.00,2174.76,3475292.04
7516,2023-01-09,2023-01-08,,Salary Credit,0.00,3688.82,3478980.86
7517,2023-01-07,2023-01-08,,Investment - SIP,246.14,0.00,3478734.72
7518,2023-01-09,2023-01-09,,Groceries - Supermarket,78.56,0.00,3478656.16
7519,2023-01-09,2023-01-09,,Loan EMI,1696.03,0.00,3476960.13
7520,2023-01-09,2023-01-09,,Online Transfer,416.12,0.00,3476544.01
7521,2023-01-09,2023-01-09,,Transfer Received,0.00,2847.37,3479391.38
7522,2023-01-09,2023-01-09,,Online Transfer,293.01,0.00,3479098.37
7523,2023-01-08,2023-01-09,,Investment - Mutual Funds,1495.00,0.00,3477603.37
7524,2023-01-09,2023-01-09,,Transfer Received,0.00,963.55,3478566.92
7525,2023-01-10,2023-01-10,,ATM Withdrawal,104.98,0.00,3478461.94
7526,2023-01-10,2023-01-10,,Transfer Received,0.00,2467.47,3480929.41
7527,2023-01-10,2023-01-10,,Transfer Received,0.00,1234.37,3482163.78
7528,2023-01-10,2023-01-10,,Credit Card Payment,339.08,0.00,3481824.70
7529,2023-01-10,2023-01-10,,Transfer Received,0.00,1438.14,3483262.84
7530,2023-01-10,2023-01-10,,Transfer Received,0.00,861.34,3484124.18
7531,2023-01-11,2023-01-11,,Salary Credit,0.00,4850.63,3488974.81
7532,2023-01-11,2023-01-11,,Groceries - Supermarket,80.22,0.00,3488894.59
7533,2023-01-11,2023-01-11,,ATM Withdrawal,20.80,0.00,3488873.79
7534,2023-01-11,2023-01-11,,Transfer Received,0.00,2047.62,3490921.41
7535,2023-01-10,2023-01-11,,Credit Card Payment,524.63,0.00,3490396.78
7536,2023-01-11,2023-01-11,,Rental Income,0.00,2350.19,3492746.97
7537,2023-01-12,2023-01-11,,ATM Withdrawal,442.94,0.00,3492304.03
7538,2023-01-12,2023-01-12,,Takeout,23.07,0.00,3492280.96
7539,2023-01-12,2023-01-12,,Online Transfer,1527.28,0.00,3490753.68
7540,2023-01-13,2023-01-12,,Credit Card Payment,401.97,0.00,3490351.71
7541,2023-01-12,2023-01-12,,Online Transfer,521.17,0.00,3489830.54
7542,2023-01-12,2023-01-12,,Interest Credited,0.00,31.43,3489861.97
7543,2023-01-12,2023-01-12,,Takeout,48.40,0.00,3489813.57
7544,2023-01-12,2023-01-12,,Interest Credited,0.00,98.58,3489912.15
7545,2023-01-13,2023-01-13,,Salary Credit,0.00,3854.41,3493766.56
7546,2023-01-12,2023-01-13,,Online Transfer,884.74,0.00,3492881.82
7547,2023-01-13,2023-01-13,,Dining Out,22.70,0.00,3492859.12
7548,2023-01-13,2023-01-13,,Cash Deposit,0.00,277.63,3493136.75
7549,2023-01-13,2023-01-13,,ATM Withdrawal,176.30,0.00,3492960.45
7550,2023-01-14,2023-01-13,,Investment Returns,0.00,698.69,3493659.14
7551,2023-01-12,2023-01-13,,Dividend Received,0.00,150.95,3493810.09
7552,2023-01-12,2023-01-13,,Salary Credit,0.00,4652.94,3498463.03
7553,2023-01-14,2023-01-13,,Credit Card Payment,642.49,0.00,3497820.54
7554,2023-01-12,2023-01-13,,Online Transfer,1588.16,0.00,3496232.38
7555,2023-01-13,2023-01-13,,ATM Withdrawal,79.26,0.00,3496153.12
7556,2023-01-14,2023-01-14,,Investment - SIP,444.54,0.00,3495708.58
7557,2023-01-14,2023-01-14,,Investment - Mutual Funds,2492.61,0.00,3493215.97
7558,2023-01-14,2023-01-14,,ATM Withdrawal,106.04,0.00,3493109.93
7559,2023-01-14,2023-01-14,,Salary Credit,0.00,4231.66,3497341.59
7560,2023-01-14,2023-01-14,,Investment - SIP,277.59,0.00,3497064.00
7561,2023-01-14,2023-01-14,,Transfer Received,0.00,1305.94,3498369.94
7562,2023-01-14,2023-01-14,,Salary Credit,0.00,2158.83,3500528.77
7563,2023-01-14,2023-01-14,,Utility Payment,151.94,0.00,3500376.83
7564,2023-01-13,2023-01-14,,Dining Out,25.17,0.00,3500351.66
7565,2023-01-14,2023-01-14,,Transfer Received,0.00,2326.32,3502677.98
7566,2023-01-15,2023-01-15,,Cash Deposit,0.00,480.44,3503158.42
7567,2023-01-15,2023-01-15,,ATM Withdrawal,82.58,0.00,3503075.84
7568,2023-01-16,2023-01-15,,Online Transfer,1624.58,0.00,3501451.26
7569,2023-01-15,2023-01-15,,Daily Essentials,38.21,0.00,3501413.05
7570,2023-01-16,2023-01-16,,Investment - SIP,205.73,0.00,3501207.32
7571,2023-01-16,2023-01-16,,Credit Card Payment,904.18,0.00,3500303.14
7572,2023-01-16,2023-01-16,,Online Transfer,1506.59,0.00,3498796.55
7573,2023-01-16,2023-01-16,,ATM Withdrawal,119.28,0.00,3498677.27
7574,2023-01-16,2023-01-16,,Online Transfer,818.44,0.00,3497858.83
7575,2023-01-15,2023-01-16,,Salary Credit,0.00,3651.44,3501510.27
7576,2023-01-16,2023-01-16,,Dining Out,58.66,0.00,3501451.61
7577,2023-01-16,2023-01-16,,ATM Withdrawal,132.98,0.00,3501318.63
7578,2023-01-17,2023-01-16,,Dining Out,97.05,0.00,3501221.58
7579,2023-01-16,2023-01-16,,Transfer Received,0.00,1063.02,3502284.60
7580,2023-01-17,2023-01-16,100185,Cheque Issued,2864.54,0.00,3499420.06
7581,2023-01-15,2023-01-16,,Investment - Mutual Funds,2674.42,0.00,3496745.64
7582,2023-01-16,2023-01-16,,Salary Credit,0.00,2340.36,3499086.00
7583,2023-01-16,2023-01-16,,Daily Essentials,23.97,0.00,3499062.03
7584,2023-01-17,2023-01-17,,Online Transfer,1253.48,0.00,3497808.55
7585,2023-01-17,2023-01-17,,Groceries - Supermarket,81.62,0.00,3497726.93
7586,2023-01-17,2023-01-17,,ATM Withdrawal,248.33,0.00,3497478.60
7587,2023-01-18,2023-01-17,,ATM Withdrawal,218.06,0.00,3497260.54
7588,2023-01-17,2023-01-17,,Cash Deposit,0.00,561.41,3497821.95
7589,2023-01-17,2023-01-17,,Dividend Received,0.00,193.55,3498015.50
7590,2023-01-18,2023-01-18,,Salary Credit,0.00,3116.66,3501132.16
7591,2023-01-17,2023-01-18,,Investment Returns,0.00,621.36,3501753.52
7592,2023-01-18,2023-01-18,,Transfer Received,0.00,2875.46,3504628.98
7593,2023-01-18,2023-01-18,,Groceries - Supermarket,183.28,0.00,3504445.70
7594,2023-01-18,2023-01-18,,ATM Withdrawal,186.74,0.00,3504258.96
7595,2023-01-18,2023-01-19,,Loan EMI,1015.15,0.00,3503243.81
7596,2023-01-19,2023-01-19,,Credit Card Payment,532.90,0.00,3502710.91
7597,2023-01-18,2023-01-19,,Investment - SIP,134.50,0.00,3502576.41
7598,2023-01-19,2023-01-19,100186,Cheque Issued,607.65,0.00,3501968.76
7599,2023-01-20,2023-01-20,,Transfer Received,0.00,1806.35,3503775.11
7600,2023-01-20,2023-01-20,,Interest Credited,0.00,20.80,3503795.91
7601,2023-01-20,2023-01-20,,Salary Credit,0.00,2847.02,3506642.93
7602,2023-01-20,2023-01-20,,Credit Card Payment,980.33,0.00,3505662.60
7603,2023-01-19,2023-01-20,,Investment Returns,0.00,462.18,3506124.78
7604,2023-01-20,2023-01-20,,Credit Card Payment,693.91,0.00,3505430.87
7605,2023-01-20,2023-01-20,,Investment - SIP,314.93,0.00,3505115.94
7606,2023-01-20,2023-01-20,,ATM Withdrawal,477.31,0.00,3504638.63
7607,2023-01-22,2023-01-21,,Credit Card Payment,826.32,0.00,3503812.31
7608,2023-01-21,2023-01-21,,Transfer Received,0.00,1811.48,3505623.79
7609,2023-01-21,2023-01-21,,ATM Withdrawal,287.97,0.00,3505335.82
7610,2023-01-22,2023-01-22,,Utility Payment,137.85,0.00,3505197.97
7611,2023-01-22,2023-01-22,,Coffee Shop,18.93,0.00,3505179.04
7612,2023-01-23,2023-01-22,,Utility Payment,261.95,0.00,3504917.09
7613,2023-01-22,2023-01-22,,Investment Returns,0.00,536.04,3505453.13
7614,2023-01-22,2023-01-22,,Groceries - Online Delivery,115.51,0.00,3505337.62
7615,2023-01-21,2023-01-22,,ATM Withdrawal,297.62,0.00,3505040.00
7616,2023-01-22,2023-01-22,,ATM Withdrawal,448.80,0.00,3504591.20
7617,2023-01-22,2023-01-22,,Investment - Stocks,1943.39,0.00,3502647.81
7618,2023-01-23,2023-01-23,,Salary Credit,0.00,2086.13,3504733.94
7619,2023-01-23,2023-01-23,,Credit Card Payment,340.24,0.00,3504393.70
7620,2023-01-23,2023-01-23,,Investment Returns,0.00,931.98,3505325.68
7621,2023-01-23,2023-01-23,,Groceries - Supermarket,140.03,0.00,3505185.65
7622,2023-01-23,2023-01-23,,Credit Card Payment,497.94,0.00,3504687.71
7623,2023-01-23,2023-01-23,,Interest Credited,0.00,39.19,3504726.90
7624,2023-01-23,2023-01-23,,Online Transfer,1720.81,0.00,3503006.09
7625,2023-01-22,2023-01-23,,Transfer Received,0.00,2121.83,3505127.92
7626,2023-01-24,2023-01-24,,Online Transfer,1267.79,0.00,3503860.13
7627,2023-01-23,2023-01-24,,Salary Credit,0.00,3378.88,3507239.01
7628,2023-01-24,2023-01-24,,ATM Withdrawal,193.36,0.00,3507045.65
7629,2023-01-25,2023-01-24,,ATM Withdrawal,181.23,0.00,3506864.42
7630,2023-01-25,2023-01-25,,Transfer Received,0.00,2629.00,3509493.42
7631,2023-01-24,2023-01-25,,Online Transfer,1834.48,0.00,3507658.94
7632,2023-01-25,2023-01-25,,Credit Card Payment,934.27,0.00,3506724.67
7633,2023-01-25,2023-01-25,100187,Cheque Issued,2677.59,0.00,3504047.08
7634,2023-01-25,2023-01-25,,Groceries - Supermarket,161.32,0.00,3503885.76
7635,2023-01-24,2023-01-25,,ATM Withdrawal,293.65,0.00,3503592.11
7636,2023-01-25,2023-01-25,,ATM Withdrawal,407.79,0.00,3503184.32
7637,2023-01-25,2023-01-25,,Salary Credit,0.00,3172.63,3506356.95
7638,2023-01-27,2023-01-26,,Investment - SIP,479.03,0.00,3505877.92
7639,2023-01-27,2023-01-26,,Salary Credit,0.00,2947.98,3508825.90
7640,2023-01-26,2023-01-26,,Groceries - Supermarket,179.09,0.00,3508646.81
7641,2023-01-26,2023-01-26,,Credit Card Payment,291.62,0.00,3508355.19
7642,2023-01-26,2023-01-26,,Cash Deposit,0.00,282.88,3508638.07
7643,2023-01-27,2023-01-26,,ATM Withdrawal,218.78,0.00,3508419.29
7644,2023-01-26,2023-01-26,,Investment - Mutual Funds,2123.02,0.00,3506296.27
7645,2023-01-26,2023-01-27,,Salary Credit,0.00,3299.70,3509595.97
7646,2023-01-27,2023-01-27,,Salary Credit,0.00,2597.16,3512193.13
7647,2023-01-27,2023-01-27,,Dividend Received,0.00,424.35,3512617.48
7648,2023-01-27,2023-01-27,,Online Transfer,1962.04,0.00,3510655.44
7649,2023-01-27,2023-01-27,,ATM Withdrawal,475.86,0.00,3510179.58
7650,2023-01-27,2023-01-27,,Salary Credit,0.00,2186.61,3512366.19
7651,2023-01-27,2023-01-27,,Takeout,40.02,0.00,3512326.17
7652,2023-01-28,2023-01-28,,ATM Withdrawal,319.48,0.00,3512006.69
7653,2023-01-29,2023-01-28,,Transfer Received,0.00,2485.15,3514491.84
7654,2023-01-29,2023-01-28,,Transfer Received,0.00,2097.12,3516588.96
7655,2023-01-29,2023-01-29,,ATM Withdrawal,111.44,0.00,3516477.52
7656,2023-01-30,2023-01-29,,Investment - Stocks,649.79,0.00,3515827.73
7657,2023-01-29,2023-01-29,,Credit Card Payment,504.24,0.00,3515323.49
7658,2023-01-29,2023-01-29,,Dining Out,93.26,0.00,3515230.23
7659,2023-01-29,2023-01-29,,ATM Withdrawal,303.92,0.00,3514926.31
7660,2023-01-29,2023-01-29,,Utility Payment,254.75,0.00,3514671.56
7661,2023-01-28,2023-01-29,,Interest Credited,0.00,64.15,3514735.71
7662,2023-01-29,2023-01-29,,Interest Credited,0.00,71.53,3514807.24
7663,2023-01-30,2023-01-29,,Groceries - Supermarket,130.47,0.00,3514676.77
7664,2023-01-31,2023-01-30,,Credit Card Payment,245.36,0.00,3514431.41
7665,2023-01-30,2023-01-30,,Transfer Received,0.00,2681.78,3517113.19
7666,2023-01-30,2023-01-30,,Credit Card Payment,502.46,0.00,3516610.73
7667,2023-01-30,2023-01-30,,Interest Credited,0.00,40.56,3516651.29
7668,2023-01-29,2023-01-30,,Salary Credit,0.00,3002.29,3519653.58
7669,2023-01-29,2023-01-30,,Online Transfer,683.29,0.00,3518970.29
7670,2023-01-30,2023-01-30,,Dining Out,23.60,0.00,3518946.69
7671,2023-01-30,2023-01-30,,ATM Withdrawal,450.90,0.00,3518495.79
7672,2023-01-31,2023-01-31,,Salary Credit,0.00,2596.27,3521092.06
7673,2023-01-31,2023-01-31,,Rental Income,0.00,2550.63,3523642.69
7674,2023-01-31,2023-01-31,,ATM Withdrawal,74.93,0.00,3523567.76
7675,2023-01-30,2023-01-31,,Credit Card Payment,806.44,0.00,3522761.32
7676,2023-01-31,2023-01-31,,ATM Withdrawal,27.84,0.00,3522733.48
7677,2023-01-31,2023-01-31,,Loan EMI,1186.75,0.00,3521546.73
7678,2023-01-31,2023-01-31,,Groceries - Online Delivery,52.19,0.00,3521494.54
7679,2023-02-01,2023-01-31,,Groceries - Online Delivery,79.87,0.00,3521414.67
7680,2023-02-01,2023-02-01,,Loan EMI,1047.21,0.00,3520367.46
7681,2023-02-01,2023-02-01,,ATM Withdrawal,192.04,0.00,3520175.42
7682,2023-02-01,2023-02-01,,Salary Credit,0.00,4864.39,3525039.81
7683,2023-02-01,2023-02-01,,Credit Card Payment,946.93,0.00,3524092.88
7684,2023-02-01,2023-02-01,,Groceries - Online Delivery,133.07,0.00,3523959.81
7685,2023-02-01,2023-02-01,,ATM Withdrawal,304.06,0.00,3523655.75
7686,2023-02-02,2023-02-01,,Credit Card Payment,819.62,0.00,3522836.13
7687,2023-02-01,2023-02-01,,Salary Credit,0.00,3010.55,3525846.68
7688,2023-02-01,2023-02-01,,ATM Withdrawal,167.60,0.00,3525679.08
7689,2023-02-02,2023-02-02,,Utility Payment,230.30,0.00,3525448.78
7690,2023-02-02,2023-02-02,,Utility Payment,128.01,0.00,3525320.77
7691,2023-02-02,2023-02-02,,Groceries - Supermarket,156.17,0.00,3525164.60
7692,2023-02-02,2023-02-02,,Transfer Received,0.00,1812.98,3526977.58
7693,2023-02-02,2023-02-02,,Transfer Received,0.00,945.62,3527923.20
7694,2023-02-02,2023-02-02,,ATM Withdrawal,344.69,0.00,3527578.51
7695,2023-02-02,2023-02-02,,Loan EMI,1895.66,0.00,3525682.85
7696,2023-02-03,2023-02-03,,Dining Out,60.03,0.00,3525622.82
7697,2023-02-03,2023-02-03,,Online Transfer,270.26,0.00,3525352.56
7698,2023-02-03,2023-02-03,,Utility Payment,228.02,0.00,3525124.54
7699,2023-02-04,2023-02-03,100188,Cheque Issued,2247.84,0.00,3522876.70
7700,2023-02-03,2023-02-03,,Investment - Mutual Funds,839.63,0.00,3522037.07
7701,2023-02-03,2023-02-03,,Investment - Mutual Funds,1868.92,0.00,3520168.15
7702,2023-02-03,2023-02-03,,Salary Credit,0.00,3009.15,3523177.30
7703,2023-02-03,2023-02-03,,Credit Card Payment,608.73,0.00,3522568.57
7704,2023-02-04,2023-02-03,,Salary Credit,0.00,2522.96,3525091.53
7705,2023-02-03,2023-02-03,,Salary Credit,0.00,4491.04,3529582.57
7706,2023-02-04,2023-02-03,,ATM Withdrawal,108.71,0.00,3529473.86
7707,2023-02-04,2023-02-04,,ATM Withdrawal,305.50,0.00,3529168.36
7708,2023-02-04,2023-02-04,,Rental Income,0.00,2700.20,3531868.56
7709,2023-02-04,2023-02-04,,ATM Withdrawal,327.68,0.00,3531540.88
7710,2023-02-03,2023-02-04,,Transfer Received,0.00,2757.18,3534298.06
7711,2023-02-04,2023-02-05,,ATM Withdrawal,97.65,0.00,3534200.41
7712,2023-02-05,2023-02-05,,ATM Withdrawal,463.08,0.00,3533737.33
7713,2023-02-05,2023-02-05,,Loan EMI,659.45,0.00,3533077.88
7714,2023-02-05,2023-02-05,,Transfer Received,0.00,2897.24,3535975.12
7715,2023-02-05,2023-02-05,,Online Transfer,1022.78,0.00,3534952.34
7716,2023-02-05,2023-02-05,,Investment - Mutual Funds,2463.67,0.00,3532488.67
7717,2023-02-05,2023-02-05,,Utility Payment,213.61,0.00,3532275.06
7718,2023-02-04,2023-02-05,,Groceries - Supermarket,157.96,0.00,3532117.10
7719,2023-02-04,2023-02-05,,Salary Credit,0.00,2154.80,3534271.90
7720,2023-02-04,2023-02-05,100189,Cheque Issued,1767.37,0.00,3532504.53
7721,2023-02-04,2023-02-05,,Groceries - Supermarket,124.60,0.00,3532379.93
7722,2023-02-05,2023-02-05,,Transfer Received,0.00,2926.77,3535306.70
7723,2023-02-06,2023-02-06,,Credit Card Payment,953.05,0.00,3534353.65
7724,2023-02-06,2023-02-06,,Transfer Received,0.00,931.55,3535285.20
7725,2023-02-06,2023-02-06,,Takeout,47.21,0.00,3535237.99
7726,2023-02-07,2023-02-06,,Transfer Received,0.00,781.18,3536019.17
7727,2023-02-06,2023-02-06,,Groceries - Supermarket,112.45,0.00,3535906.72
7728,2023-02-06,2023-02-06,,ATM Withdrawal,351.00,0.00,3535555.72
7729,2023-02-06,2023-02-06,,Dividend Received,0.00,490.37,3536046.09
7730,2023-02-05,2023-02-06,,ATM Withdrawal,387.37,0.00,3535658.72
7731,2023-02-06,2023-02-07,,Transfer Received,0.00,1316.10,3536974.82
7732,2023-02-07,2023-02-07,,Online Transfer,1317.38,0.00,3535657.44
7733,2023-02-06,2023-02-07,,Investment - Stocks,3512.08,0.00,3532145.36
7734,2023-02-07,2023-02-07,,Loan EMI,1021.13,0.00,3531124.23
7735,2023-02-07,2023-02-07,,Investment - SIP,602.34,0.00,3530521.89
7736,2023-02-09,2023-02-08,,Utility Payment,171.49,0.00,3530350.40
7737,2023-02-07,2023-02-08,,Investment - Mutual Funds,1559.42,0.00,3528790.98
7738,2023-02-07,2023-02-08,,Salary Credit,0.00,4989.29,3533780.27
7739,2023-02-08,2023-02-08,,ATM Withdrawal,427.83,0.00,3533352.44
7740,2023-02-09,2023-02-08,,Takeout,38.61,0.00,3533313.83
7741,2023-02-08,2023-02-08,,Groceries - Supermarket,179.96,0.00,3533133.87
7742,2023-02-08,2023-02-08,,Groceries - Online Delivery,88.78,0.00,3533045.09
7743,2023-02-09,2023-02-08,,Credit Card Payment,260.84,0.00,3532784.25
7744,2023-02-09,2023-02-08,,Online Transfer,335.86,0.00,3532448.39
7745,2023-02-09,2023-02-09,,Loan EMI,1219.75,0.00,3531228.64
7746,2023-02-09,2023-02-09,,Transfer Received,0.00,1254.11,3532482.75
7747,2023-02-08,2023-02-09,,Salary Credit,0.00,4566.49,3537049.24
7748,2023-02-09,2023-02-09,,Credit Card Payment,755.59,0.00,3536293.65
7749,2023-02-10,2023-02-10,,Salary Credit,0.00,2212.75,3538506.40
7750,2023-02-10,2023-02-10,,Rental Income,0.00,2731.35,3541237.75
7751,2023-02-10,2023-02-10,,ATM Withdrawal,316.21,0.00,3540921.54
7752,2023-02-10,2023-02-10,,ATM Withdrawal,297.80,0.00,3540623.74
7753,2023-02-09,2023-02-10,,Online Transfer,907.67,0.00,3539716.07
7754,2023-02-10,2023-02-10,,Investment - Mutual Funds,292.72,0.00,3539423.35
7755,2023-02-11,2023-02-11,,Utility Payment,52.26,0.00,3539371.09
7756,2023-02-11,2023-02-11,,Online Transfer,625.92,0.00,3538745.17
7757,2023-02-11,2023-02-11,,Investment - Stocks,4624.26,0.00,3534120.91
7758,2023-02-11,2023-02-11,,Cash Deposit,0.00,686.16,3534807.07
7759,2023-02-11,2023-02-11,,ATM Withdrawal,109.05,0.00,3534698.02
7760,2023-02-12,2023-02-12,,ATM Withdrawal,123.03,0.00,3534574.99
7761,2023-02-12,2023-02-12,,Interest Credited,0.00,34.17,3534609.16
7762,2023-02-12,2023-02-12,,Interest Credited,0.00,12.33,3534621.49
7763,2023-02-12,2023-02-12,,Groceries - Supermarket,126.66,0.00,3534494.83
7764,2023-02-12,2023-02-12,,Daily Essentials,46.77,0.00,3534448.06
7765,2023-02-11,2023-02-12,,Takeout,21.46,0.00,3534426.60
7766,2023-02-12,2023-02-12,,Online Transfer,848.81,0.00,3533577.79
7767,2023-02-12,2023-02-12,,ATM Withdrawal,169.33,0.00,3533408.46
7768,2023-02-13,2023-02-13,,Salary Credit,0.00,3160.72,3536569.18
7769,2023-02-13,2023-02-13,,Coffee Shop,8.74,0.00,3536560.44
7770,2023-02-13,2023-02-13,,Investment - Mutual Funds,2997.85,0.00,3533562.59
7771,2023-02-13,2023-02-13,,Transfer Received,0.00,1313.99,3534876.58
7772,2023-02-13,2023-02-14,,Transfer Received,0.00,2451.62,3537328.20
7773,2023-02-14,2023-02-14,,ATM Withdrawal,395.16,0.00,3536933.04
7774,2023-02-14,2023-02-14,,Salary Credit,0.00,3299.26,3540232.30
7775,2023-02-14,2023-02-14,,Online Transfer,1618.25,0.00,3538614.05
7776,2023-02-14,2023-02-14,,Transfer Received,0.00,1131.98,3539746.03
7777,2023-02-14,2023-02-14,,Utility Payment,226.64,0.00,3539519.39
7778,2023-02-14,2023-02-14,,Groceries - Supermarket,22.98,0.00,3539496.41
7779,2023-02-13,2023-02-14,,Coffee Shop,18.68,0.00,3539477.73
7780,2023-02-14,2023-02-14,,ATM Withdrawal,149.99,0.00,3539327.74
7781,2023-02-14,2023-02-14,,ATM Withdrawal,497.61,0.00,3538830.13
7782,2023-02-15,2023-02-15,,Loan EMI,1091.27,0.00,3537738.86
7783,2023-02-14,2023-02-15,,Transfer Received,0.00,1347.04,3539085.90
7784,2023-02-15,2023-02-15,,Salary Credit,0.00,2028.45,3541114.35
7785,2023-02-15,2023-02-15,,Transfer Received,0.00,2467.21,3543581.56
7786,2023-02-15,2023-02-15,,Groceries - Online Delivery,79.61,0.00,3543501.95
7787,2023-02-17,2023-02-16,,Credit Card Payment,387.91,0.00,3543114.04
7788,2023-02-15,2023-02-16,,Salary Credit,0.00,3883.01,3546997.05
7789,2023-02-17,2023-02-16,,Salary Credit,0.00,3854.96,3550852.01
7790,2023-02-17,2023-02-16,,Credit Card Payment,494.39,0.00,3550357.62
7791,2023-02-17,2023-02-16,,Groceries - Supermarket,48.27,0.00,3550309.35
7792,2023-02-15,2023-02-16,,Groceries - Online Delivery,61.48,0.00,3550247.87
7793,2023-02-17,2023-02-16,,Utility Payment,222.17,0.00,3550025.70
7794,2023-02-16,2023-02-16,,ATM Withdrawal,130.27,0.00,3549895.43
7795,2023-02-17,2023-02-16,,Credit Card Payment,505.64,0.00,3549389.79
7796,2023-02-17,2023-02-17,,Salary Credit,0.00,2426.69,3551816.48
7797,2023-02-17,2023-02-17,,Online Transfer,1700.41,0.00,3550116.07
7798,2023-02-17,2023-02-17,,Groceries - Online Delivery,91.89,0.00,3550024.18
7799,2023-02-17,2023-02-17,,Credit Card Payment,310.66,0.00,3549713.52
7800,2023-02-17,2023-02-17,,Coffee Shop,5.86,0.00,3549707.66
7801,2023-02-18,2023-02-17,,Salary Credit,0.00,2244.11,3551951.77
7802,2023-02-16,2023-02-17,,Utility Payment,111.67,0.00,3551840.10
7803,2023-02-17,2023-02-17,,Online Transfer,1429.90,0.00,3550410.20
7804,2023-02-18,2023-02-18,,Salary Credit,0.00,3829.56,3554239.76
7805,2023-02-18,2023-02-18,,Transfer Received,0.00,1289.31,3555529.07
7806,2023-02-17,2023-02-18,,Utility Payment,194.00,0.00,3555335.07
7807,2023-02-18,2023-02-18,,Coffee Shop,11.83,0.00,3555323.24
7808,2023-02-18,2023-02-18,,Loan EMI,872.63,0.00,3554450.61
7809,2023-02-18,2023-02-18,,Interest Credited,0.00,25.44,3554476.05
7810,2023-02-19,2023-02-18,,Credit Card Payment,699.92,0.00,3553776.13
7811,2023-02-18,2023-02-18,,Cash Deposit,0.00,329.10,3554105.23
7812,2023-02-18,2023-02-18,,Online Transfer,1423.62,0.00,3552681.61
7813,2023-02-18,2023-02-18,,Utility Payment,225.27,0.00,3552456.34
7814,2023-02-18,2023-02-19,,Groceries - Supermarket,83.23,0.00,3552373.11
7815,2023-02-19,2023-02-19,,Transfer Received,0.00,2015.47,3554388.58
7816,2023-02-19,2023-02-19,,Loan EMI,1218.81,0.00,3553169.77
7817,2023-02-19,2023-02-19,,Credit Card Payment,342.62,0.00,3552827.15
7818,2023-02-20,2023-02-20,,Online Transfer,168.52,0.00,3552658.63
7819,2023-02-21,2023-02-20,,Credit Card Payment,979.72,0.00,3551678.91
7820,2023-02-20,2023-02-20,,Investment - Mutual Funds,2967.96,0.00,3548710.95
7821,2023-02-20,2023-02-20,,Dining Out,11.76,0.00,3548699.19
7822,2023-02-21,2023-02-20,,Online Transfer,1714.12,0.00,3546985.07
7823,2023-02-20,2023-02-20,,Investment - Stocks,1569.49,0.00,3545415.58
7824,2023-02-20,2023-02-20,,Transfer Received,0.00,1895.76,3547311.34
7825,2023-02-20,2023-02-20,100190,Cheque Issued,2141.99,0.00,3545169.35
7826,2023-02-21,2023-02-21,,Credit Card Payment,562.27,0.00,3544607.08
7827,2023-02-21,2023-02-21,,Interest Credited,0.00,14.30,3544621.38
7828,2023-02-21,2023-02-21,,Credit Card Payment,274.55,0.00,3544346.83
7829,2023-02-20,2023-02-21,,Investment - Mutual Funds,561.20,0.00,3543785.63
7830,2023-02-22,2023-02-21,,ATM Withdrawal,295.28,0.00,3543490.35
7831,2023-02-22,2023-02-22,,Groceries - Supermarket,158.59,0.00,3543331.76
7832,2023-02-23,2023-02-22,,Dining Out,60.98,0.00,3543270.78
7833,2023-02-23,2023-02-22,,Salary Credit,0.00,4022.50,3547293.28
7834,2023-02-22,2023-02-22,,Investment - SIP,898.42,0.00,3546394.86
7835,2023-02-22,2023-02-22,,Transfer Received,0.00,2625.22,3549020.08
7836,2023-02-23,2023-02-23,100191,Cheque Issued,1418.49,0.00,3547601.59
7837,2023-02-22,2023-02-23,,Dividend Received,0.00,93.12,3547694.71
7838,2023-02-23,2023-02-23,,Transfer Received,0.00,2329.08,3550023.79
7839,2023-02-23,2023-02-24,,Interest Credited,0.00,71.35,3550095.14
7840,2023-02-24,2023-02-24,,Investment - Stocks,1762.07,0.00,3548333.07
7841,2023-02-25,2023-02-24,,ATM Withdrawal,334.75,0.00,3547998.32
7842,2023-02-26,2023-02-25,,Salary Credit,0.00,3357.04,3551355.36
7843,2023-02-26,2023-02-25,,Online Transfer,360.05,0.00,3550995.31
7844,2023-02-25,2023-02-25,,Transfer Received,0.00,812.65,3551807.96
7845,2023-02-25,2023-02-25,,Dividend Received,0.00,317.87,3552125.83
7846,2023-02-25,2023-02-25,,Rental Income,0.00,2820.10,3554945.93
7847,2023-02-26,2023-02-26,,Investment - Mutual Funds,1052.47,0.00,3553893.46
7848,2023-02-26,2023-02-26,,Investment - Stocks,1289.88,0.00,3552603.58
7849,2023-02-27,2023-02-26,,Transfer Received,0.00,2445.82,3555049.40
7850,2023-02-27,2023-02-26,,Salary Credit,0.00,4859.27,3559908.67
7851,2023-02-27,2023-02-26,,Online Transfer,635.30,0.00,3559273.37
7852,2023-02-26,2023-02-26,,Interest Credited,0.00,68.42,3559341.79
7853,2023-02-26,2023-02-26,,Transfer Received,0.00,2090.62,3561432.41
7854,2023-02-25,2023-02-26,,Online Transfer,1862.96,0.00,3559569.45
7855,2023-02-27,2023-02-26,,Salary Credit,0.00,2031.18,3561600.63
7856,2023-02-26,2023-02-26,,Groceries - Online Delivery,85.87,0.00,3561514.76
7857,2023-02-26,2023-02-26,,Transfer Received,0.00,1731.32,3563246.08
7858,2023-02-26,2023-02-26,,Dining Out,57.74,0.00,3563188.34
7859,2023-02-27,2023-02-26,,Credit Card Payment,801.43,0.00,3562386.91
7860,2023-02-26,2023-02-27,,Online Transfer,845.87,0.00,3561541.04
7861,2023-02-27,2023-02-27,100192,Cheque Issued,1692.74,0.00,3559848.30
7862,2023-02-26,2023-02-27,,Utility Payment,293.35,0.00,3559554.95
7863,2023-02-27,2023-02-27,,Groceries - Supermarket,75.23,0.00,3559479.72
7864,2023-02-27,2023-02-27,,Groceries - Supermarket,188.87,0.00,3559290.85
7865,2023-02-28,2023-02-27,,Transfer Received,0.00,1687.19,3560978.04
7866,2023-03-01,2023-02-28,,ATM Withdrawal,88.03,0.00,3560890.01
7867,2023-02-28,2023-02-28,,Transfer Received,0.00,2196.08,3563086.09
7868,2023-03-01,2023-02-28,,Utility Payment,259.06,0.00,3562827.03
7869,2023-03-01,2023-02-28,,Groceries - Supermarket,147.61,0.00,3562679.42
7870,2023-02-28,2023-02-28,,ATM Withdrawal,328.59,0.00,3562350.83
7871,2023-03-01,2023-02-28,,Online Transfer,945.83,0.00,3561405.00
7872,2023-02-28,2023-02-28,,Transfer Received,0.00,2358.10,3563763.10
7873,2023-03-01,2023-02-28,,Dining Out,93.92,0.00,3563669.18
7874,2023-02-28,2023-02-28,,ATM Withdrawal,108.52,0.00,3563560.66
7875,2023-03-01,2023-02-28,,Loan EMI,1565.62,0.00,3561995.04
7876,2023-03-01,2023-02-28,,Credit Card Payment,375.54,0.00,3561619.50
7877,2023-02-28,2023-02-28,,Transfer Received,0.00,1863.19,3563482.69
7878,2023-02-28,2023-02-28,,Investment - Mutual Funds,2348.08,0.00,3561134.61
7879,2023-03-02,2023-03-01,,Transfer Received,0.00,2865.06,3563999.67
7880,2023-02-28,2023-03-01,,Groceries - Supermarket,67.88,0.00,3563931.79
7881,2023-03-01,2023-03-01,,Transfer Received,0.00,1329.59,3565261.38
7882,2023-03-01,2023-03-01,,Dining Out,33.69,0.00,3565227.69
7883,2023-03-01,2023-03-01,,Rental Income,0.00,1471.60,3566699.29
7884,2023-03-01,2023-03-01,,Transfer Received,0.00,1572.27,3568271.56
7885,2023-03-03,2023-03-02,,ATM Withdrawal,272.45,0.00,3567999.11
7886,2023-03-01,2023-03-02,,Salary Credit,0.00,4450.32,3572449.43
7887,2023-03-02,2023-03-02,,Groceries - Supermarket,91.81,0.00,3572357.62
7888,2023-03-01,2023-03-02,,Credit Card Payment,594.02,0.00,3571763.60
7889,2023-03-02,2023-03-02,,Takeout,45.68,0.00,3571717.92
7890,2023-03-02,2023-03-02,,Loan EMI,861.43,0.00,3570856.49
7891,2023-03-03,2023-03-03,,Groceries - Supermarket,89.59,0.00,3570766.90
7892,2023-03-03,2023-03-03,,Salary Credit,0.00,2177.59,3572944.49
7893,2023-03-03,2023-03-03,,Credit Card Payment,858.05,0.00,3572086.44
7894,2023-03-03,2023-03-03,,Groceries - Supermarket,96.83,0.00,3571989.61
7895,2023-03-03,2023-03-03,,Transfer Received,0.00,1106.42,3573096.03
7896,2023-03-03,2023-03-03,,Transfer Received,0.00,1635.91,3574731.94
7897,2023-03-04,2023-03-04,,Dividend Received,0.00,137.88,3574869.82
7898,2023-03-04,2023-03-04,,Online Transfer,1520.07,0.00,3573349.75
7899,2023-03-04,2023-03-04,,ATM Withdrawal,170.81,0.00,3573178.94
7900,2023-03-04,2023-03-04,,ATM Withdrawal,279.89,0.00,3572899.05
7901,2023-03-04,2023-03-04,,Dividend Received,0.00,391.55,3573290.60
7902,2023-03-04,2023-03-04,,Transfer Received,0.00,1763.88,3575054.48
7903,2023-03-04,2023-03-04,,ATM Withdrawal,40.36,0.00,3575014.12
7904,2023-03-04,2023-03-04,,ATM Withdrawal,128.75,0.00,3574885.37
7905,2023-03-04,2023-03-04,,Salary Credit,0.00,4131.94,3579017.31
7906,2023-03-05,2023-03-05,,ATM Withdrawal,233.34,0.00,3578783.97
7907,2023-03-05,2023-03-05,,Credit Card Payment,707.63,0.00,3578076.34
7908,2023-03-05,2023-03-05,,Dining Out,42.96,0.00,3578033.38
7909,2023-03-04,2023-03-05,,ATM Withdrawal,161.88,0.00,3577871.50
7910,2023-03-04,2023-03-05,,Groceries - Supermarket,183.28,0.00,3577688.22
7911,2023-03-06,2023-03-06,,Credit Card Payment,222.58,0.00,3577465.64
7912,2023-03-05,2023-03-06,,Transfer Received,0.00,1386.68,3578852.32
7913,2023-03-07,2023-03-06,,Salary Credit,0.00,3263.79,3582116.11
7914,2023-03-06,2023-03-06,,ATM Withdrawal,355.15,0.00,3581760.96
7915,2023-03-06,2023-03-06,,Interest Credited,0.00,42.03,3581802.99
7916,2023-03-07,2023-03-06,,Daily Essentials,14.04,0.00,3581788.95
7917,2023-03-06,2023-03-06,,Groceries - Supermarket,64.21,0.00,3581724.74
7918,2023-03-07,2023-03-06,,Transfer Received,0.00,1479.55,3583204.29
7919,2023-03-05,2023-03-06,,Online Transfer,1740.74,0.00,3581463.55
7920,2023-03-06,2023-03-06,,ATM Withdrawal,20.67,0.00,3581442.88
7921,2023-03-07,2023-03-07,,ATM Withdrawal,217.78,0.00,3581225.10
7922,2023-03-07,2023-03-07,,Transfer Received,0.00,2452.76,3583677.86
7923,2023-03-07,2023-03-07,,Credit Card Payment,434.40,0.00,3583243.46
7924,2023-03-07,2023-03-07,,Cash Deposit,0.00,641.63,3583885.09
7925,2023-03-07,2023-03-07,,Loan EMI,575.31,0.00,3583309.78
7926,2023-03-07,2023-03-07,,Loan EMI,619.90,0.00,3582689.88
7927,2023-03-08,2023-03-08,,Utility Payment,76.42,0.00,3582613.46
7928,2023-03-08,2023-03-08,,Online Transfer,371.43,0.00,3582242.03
7929,2023-03-08,2023-03-08,,Utility Payment,70.01,0.00,3582172.02
7930,2023-03-08,2023-03-08,,Credit Card Payment,372.02,0.00,3581800.00
7931,2023-03-09,2023-03-09,,Utility Payment,190.06,0.00,3581609.94
7932,2023-03-10,2023-03-09,,Groceries - Supermarket,190.67,0.00,3581419.27
7933,2023-03-09,2023-03-09,,Groceries - Supermarket,50.24,0.00,3581369.03
7934,2023-03-08,2023-03-09,,Online Transfer,1986.07,0.00,3579382.96
7935,2023-03-11,2023-03-10,,Online Transfer,666.51,0.00,3578716.45
7936,2023-03-10,2023-03-10,100193,Cheque Issued,2094.09,0.00,3576622.36
7937,2023-03-11,2023-03-10,,Dining Out,71.46,0.00,3576550.90
7938,2023-03-10,2023-03-10,,Online Transfer,1245.37,0.00,3575305.53
7939,2023-03-10,2023-03-10,,Interest Credited,0.00,90.24,3575395.77
7940,2023-03-11,2023-03-10,,Groceries - Online Delivery,53.32,0.00,3575342.45
7941,2023-03-09,2023-03-10,,Investment - Stocks,4603.87,0.00,3570738.58
7942,2023-03-09,2023-03-10,,Rental Income,0.00,2498.65,3573237.23
7943,2023-03-11,2023-03-10,,ATM Withdrawal,234.12,0.00,3573003.11
7944,2023-03-11,2023-03-11,,ATM Withdrawal,492.41,0.00,3572510.70
7945,2023-03-10,2023-03-11,,Cash Deposit,0.00,154.35,3572665.05
7946,2023-03-11,2023-03-11,,ATM Withdrawal,365.44,0.00,3572299.61
7947,2023-03-10,2023-03-11,,Groceries - Supermarket,165.29,0.00,3572134.32
7948,2023-03-10,2023-03-11,,Credit Card Payment,246.16,0.00,3571888.16
7949,2023-03-11,2023-03-11,,Utility Payment,188.01,0.00,3571700.15
7950,2023-03-11,2023-03-11,,Salary Credit,0.00,3172.77,3574872.92
7951,2023-03-12,2023-03-11,,Daily Essentials,41.91,0.00,3574831.01
7952,2023-03-11,2023-03-11,,ATM Withdrawal,405.11,0.00,3574425.90
7953,2023-03-11,2023-03-11,,Groceries - Supermarket,73.73,0.00,3574352.17
7954,2023-03-13,2023-03-12,,Investment - Stocks,2588.57,0.00,3571763.60
7955,2023-03-13,2023-03-12,,Transfer Received,0.00,1170.59,3572934.19
7956,2023-03-13,2023-03-12,,Utility Payment,73.26,0.00,3572860.93
7957,2023-03-13,2023-03-12,100194,Cheque Issued,737.61,0.00,3572123.32
7958,2023-03-13,2023-03-12,,Salary Credit,0.00,3159.32,3575282.64
7959,2023-03-12,2023-03-12,,Groceries - Online Delivery,57.92,0.00,3575224.72
7960,2023-03-14,2023-03-13,,Interest Credited,0.00,17.40,3575242.12
7961,2023-03-13,2023-03-13,,Salary Credit,0.00,2700.36,3577942.48
7962,2023-03-13,2023-03-13,,Salary Credit,0.00,3002.09,3580944.57
7963,2023-03-12,2023-03-13,,Transfer Received,0.00,1823.42,3582767.99
7964,2023-03-12,2023-03-13,,Investment - SIP,560.01,0.00,3582207.98
7965,2023-03-13,2023-03-13,,Investment Returns,0.00,398.37,3582606.35
7966,2023-03-13,2023-03-13,100195,Cheque Issued,2835.35,0.00,3579771.00
7967,2023-03-13,2023-03-13,,Groceries - Supermarket,45.53,0.00,3579725.47
7968,2023-03-14,2023-03-14,,Transfer Received,0.00,2728.36,3582453.83
7969,2023-03-14,2023-03-14,,Transfer Received,0.00,2340.96,3584794.79
7970,2023-03-14,2023-03-14,,Online Transfer,283.12,0.00,3584511.67
7971,2023-03-14,2023-03-14,,Dining Out,40.65,0.00,3584471.02
7972,2023-03-15,2023-03-15,,Groceries - Supermarket,157.15,0.00,3584313.87
7973,2023-03-16,2023-03-15,,Utility Payment,233.15,0.00,3584080.72
7974,2023-03-14,2023-03-15,,ATM Withdrawal,381.43,0.00,3583699.29
7975,2023-03-15,2023-03-15,,Daily Essentials,35.30,0.00,3583663.99
7976,2023-03-15,2023-03-15,,Takeout,35.61,0.00,3583628.38
7977,2023-03-16,2023-03-15,,Rental Income,0.00,2216.72,3585845.10
7978,2023-03-16,2023-03-15,,Salary Credit,0.00,2933.50,3588778.60
7979,2023-03-14,2023-03-15,,Transfer Received,0.00,2715.55,3591494.15
7980,2023-03-14,2023-03-15,,Utility Payment,67.37,0.00,3591426.78
7981,2023-03-16,2023-03-15,,ATM Withdrawal,291.78,0.00,3591135.00
7982,2023-03-15,2023-03-16,,Groceries - Supermarket,53.97,0.00,3591081.03
7983,2023-03-16,2023-03-16,,Interest Credited,0.00,61.49,3591142.52
7984,2023-03-16,2023-03-16,,Salary Credit,0.00,3234.04,3594376.56
7985,2023-03-17,2023-03-16,,Online Transfer,1881.01,0.00,3592495.55
7986,2023-03-17,2023-03-16,,Transfer Received,0.00,1393.97,3593889.52
7987,2023-03-17,2023-03-16,,Rental Income,0.00,2137.19,3596026.71
7988,2023-03-17,2023-03-17,100196,Cheque Issued,936.75,0.00,3595089.96
7989,2023-03-17,2023-03-17,,Groceries - Online Delivery,83.55,0.00,3595006.41
7990,2023-03-17,2023-03-17,,Credit Card Payment,752.07,0.00,3594254.34
7991,2023-03-17,2023-03-17,,Takeout,32.92,0.00,3594221.42
7992,2023-03-17,2023-03-17,,Transfer Received,0.00,1634.36,3595855.78
7993,2023-03-17,2023-03-17,,Transfer Received,0.00,2593.82,3598449.60
7994,2023-03-18,2023-03-18,,Salary Credit,0.00,3437.14,3601886.74
7995,2023-03-18,2023-03-18,,Transfer Received,0.00,1559.94,3603446.68
7996,2023-03-18,2023-03-18,,Transfer Received,0.00,1807.70,3605254.38
7997,2023-03-19,2023-03-19,,ATM Withdrawal,391.82,0.00,3604862.56
7998,2023-03-19,2023-03-19,,Salary Credit,0.00,4806.65,3609669.21
7999,2023-03-19,2023-03-19,,Groceries - Supermarket,50.97,0.00,3609618.24
8000,2023-03-20,2023-03-19,,Transfer Received,0.00,1662.60,3611280.84
8001,2023-03-19,2023-03-19,,Interest Credited,0.00,47.78,3611328.62
8002,2023-03-19,2023-03-19,,Groceries - Supermarket,191.31,0.00,3611137.31
8003,2023-03-19,2023-03-19,,Utility Payment,85.38,0.00,3611051.93
8004,2023-03-20,2023-03-20,,Loan EMI,1012.73,0.00,3610039.20
8005,2023-03-21,2023-03-20,,ATM Withdrawal,261.25,0.00,3609777.95
8006,2023-03-19,2023-03-20,,Salary Credit,0.00,4569.15,3614347.10
8007,2023-03-20,2023-03-20,,Dining Out,80.47,0.00,3614266.63
8008,2023-03-20,2023-03-20,,Takeout,39.68,0.00,3614226.95
8009,2023-03-20,2023-03-20,,Loan EMI,726.12,0.00,3613500.83
8010,2023-03-21,2023-03-20,,Cash Deposit,0.00,856.16,3614356.99
8011,2023-03-20,2023-03-20,,Salary Credit,0.00,4267.17,3618624.16
8012,2023-03-20,2023-03-20,,Transfer Received,0.00,649.40,3619273.56
8013,2023-03-21,2023-03-20,,Investment - Mutual Funds,1509.77,0.00,3617763.79
8014,2023-03-20,2023-03-21,,Investment Returns,0.00,553.84,3618317.63
8015,2023-03-21,2023-03-21,,Credit Card Payment,952.63,0.00,3617365.00
8016,2023-03-22,2023-03-21,,Coffee Shop,10.12,0.00,3617354.88
8017,2023-03-20,2023-03-21,,Online Transfer,339.64,0.00,3617015.24
8018,2023-03-22,2023-03-21,,Groceries - Supermarket,41.25,0.00,3616973.99
8019,2023-03-22,2023-03-21,,Groceries - Supermarket,151.55,0.00,3616822.44
8020,2023-03-21,2023-03-21,,Groceries - Online Delivery,62.05,0.00,3616760.39
8021,2023-03-22,2023-03-21,,Takeout,34.70,0.00,3616725.69
8022,2023-03-22,2023-03-22,,Salary Credit,0.00,3469.85,3620195.54
8023,2023-03-22,2023-03-22,,Transfer Received,0.00,1152.24,3621347.78
8024,2023-03-22,2023-03-22,,ATM Withdrawal,108.76,0.00,3621239.02
8025,2023-03-23,2023-03-22,,Loan EMI,1219.55,0.00,3620019.47
8026,2023-03-22,2023-03-22,,ATM Withdrawal,194.69,0.00,3619824.78
8027,2023-03-21,2023-03-22,,Interest Credited,0.00,12.90,3619837.68
8028,2023-03-23,2023-03-23,,Salary Credit,0.00,2900.95,3622738.63
8029,2023-03-23,2023-03-23,,Groceries - Online Delivery,138.03,0.00,3622600.60
8030,2023-03-24,2023-03-24,,Loan EMI,1805.16,0.00,3620795.44
8031,2023-03-24,2023-03-24,,Takeout,43.86,0.00,3620751.58
8032,2023-03-24,2023-03-24,,Groceries - Supermarket,199.68,0.00,3620551.90
8033,2023-03-25,2023-03-24,,Salary Credit,0.00,4944.55,3625496.45
8034,2023-03-25,2023-03-24,,Online Transfer,272.80,0.00,3625223.65
8035,2023-03-24,2023-03-24,,Salary Credit,0.00,3697.17,3628920.82
8036,2023-03-24,2023-03-24,,ATM Withdrawal,104.33,0.00,3628816.49
8037,2023-03-24,2023-03-24,,Groceries - Supermarket,166.39,0.00,3628650.10
8038,2023-03-25,2023-03-25,,Utility Payment,168.39,0.00,3628481.71
8039,2023-03-25,2023-03-25,,Coffee Shop,6.33,0.00,3628475.38
8040,2023-03-25,2023-03-25,,Dining Out,16.70,0.00,3628458.68
8041,2023-03-24,2023-03-25,,Transfer Received,0.00,1467.75,3629926.43
8042,2023-03-25,2023-03-25,,Interest Credited,0.00,62.29,3629988.72
8043,2023-03-26,2023-03-26,,Rental Income,0.00,2913.36,3632902.08
8044,2023-03-26,2023-03-26,100197,Cheque Issued,612.73,0.00,3632289.35
8045,2023-03-26,2023-03-26,,Transfer Received,0.00,2994.63,3635283.98
8046,2023-03-26,2023-03-26,,Online Transfer,1293.71,0.00,3633990.27
8047,2023-03-26,2023-03-26,,ATM Withdrawal,240.22,0.00,3633750.05
8048,2023-03-25,2023-03-26,,Dividend Received,0.00,296.72,3634046.77
8049,2023-03-25,2023-03-26,,Dining Out,66.45,0.00,3633980.32
8050,2023-03-27,2023-03-27,,Credit Card Payment,725.96,0.00,3633254.36
8051,2023-03-26,2023-03-27,,Daily Essentials,47.80,0.00,3633206.56
8052,2023-03-27,2023-03-27,,Online Transfer,1328.31,0.00,3631878.25
8053,2023-03-27,2023-03-27,,Salary Credit,0.00,3591.99,3635470.24
8054,2023-03-27,2023-03-27,,Transfer Received,0.00,1224.22,3636694.46
8055,2023-03-27,2023-03-27,,Online Transfer,1929.17,0.00,3634765.29
8056,2023-03-26,2023-03-27,,ATM Withdrawal,376.13,0.00,3634389.16
8057,2023-03-27,2023-03-27,,Rental Income,0.00,1240.19,3635629.35
8058,2023-03-29,2023-03-28,,Utility Payment,122.15,0.00,3635507.20
8059,2023-03-29,2023-03-28,,ATM Withdrawal,355.82,0.00,3635151.38
8060,2023-03-28,2023-03-28,,Groceries - Online Delivery,141.50,0.00,3635009.88
8061,2023-03-28,2023-03-28,,Groceries - Supermarket,192.28,0.00,3634817.60
8062,2023-03-28,2023-03-28,,Online Transfer,1668.73,0.00,3633148.87
8063,2023-03-29,2023-03-29,,Investment - Mutual Funds,2805.02,0.00,3630343.85
8064,2023-03-30,2023-03-29,,Transfer Received,0.00,2837.82,3633181.67
8065,2023-03-29,2023-03-29,,Transfer Received,0.00,2151.71,3635333.38
8066,2023-03-29,2023-03-29,,Dining Out,97.37,0.00,3635236.01
8067,2023-03-29,2023-03-29,,Utility Payment,104.26,0.00,3635131.75
8068,2023-03-29,2023-03-29,,Rental Income,0.00,1338.12,3636469.87
8069,2023-03-29,2023-03-29,,Dividend Received,0.00,137.83,3636607.70
8070,2023-03-29,2023-03-29,,Salary Credit,0.00,4881.03,3641488.73
8071,2023-03-29,2023-03-29,,Transfer Received,0.00,2952.15,3644440.88
8072,2023-03-28,2023-03-29,,ATM Withdrawal,197.43,0.00,3644243.45
8073,2023-03-30,2023-03-29,,Online Transfer,318.15,0.00,3643925.30
8074,2023-03-30,2023-03-30,,Transfer Received,0.00,2578.27,3646503.57
8075,2023-03-31,2023-03-30,,Investment - Mutual Funds,741.99,0.00,3645761.58
8076,2023-03-30,2023-03-30,,Online Transfer,1199.44,0.00,3644562.14
8077,2023-03-30,2023-03-30,100198,Cheque Issued,2721.25,0.00,3641840.89
8078,2023-03-30,2023-03-30,,Investment Returns,0.00,695.99,3642536.88
8079,2023-04-01,2023-03-31,100199,Cheque Issued,2056.57,0.00,3640480.31
8080,2023-03-31,2023-03-31,,Transfer Received,0.00,719.17,3641199.48
8081,2023-03-31,2023-03-31,,Dividend Received,0.00,447.54,3641647.02
8082,2023-03-31,2023-03-31,,Transfer Received,0.00,1613.73,3643260.75
8083,2023-03-31,2023-03-31,,Transfer Received,0.00,1584.68,3644845.43
8084,2023-03-31,2023-03-31,,Credit Card Payment,986.64,0.00,3643858.79
8085,2023-03-31,2023-03-31,,Daily Essentials,23.65,0.00,3643835.14
8086,2023-03-31,2023-03-31,,Coffee Shop,6.20,0.00,3643828.94
8087,2023-03-31,2023-03-31,,Salary Credit,0.00,4478.87,3648307.81
8088,2023-04-01,2023-04-01,,Utility Payment,228.82,0.00,3648078.99
8089,2023-04-01,2023-04-01,,Online Transfer,1168.26,0.00,3646910.73
8090,2023-04-01,2023-04-01,,ATM Withdrawal,211.56,0.00,3646699.17
8091,2023-04-02,2023-04-01,,ATM Withdrawal,148.51,0.00,3646550.66
8092,2023-04-02,2023-04-01,,ATM Withdrawal,188.72,0.00,3646361.94
8093,2023-04-02,2023-04-02,,Credit Card Payment,745.15,0.00,3645616.79
8094,2023-04-01,2023-04-02,,Online Transfer,1272.96,0.00,3644343.83
8095,2023-04-02,2023-04-02,,ATM Withdrawal,351.20,0.00,3643992.63
8096,2023-04-02,2023-04-02,100200,Cheque Issued,2494.13,0.00,3641498.50
8097,2023-04-02,2023-04-02,,Groceries - Online Delivery,68.88,0.00,3641429.62
8098,2023-04-03,2023-04-02,,Interest Credited,0.00,85.07,3641514.69
8099,2023-04-03,2023-04-02,,Groceries - Supermarket,102.65,0.00,3641412.04
8100,2023-04-03,2023-04-03,,ATM Withdrawal,246.13,0.00,3641165.91
8101,2023-04-03,2023-04-03,,Salary Credit,0.00,4703.10,3645869.01
8102,2023-04-03,2023-04-03,,Interest Credited,0.00,85.74,3645954.75
8103,2023-04-04,2023-04-03,,Transfer Received,0.00,1900.66,3647855.41
8104,2023-04-03,2023-04-03,,Groceries - Supermarket,47.49,0.00,3647807.92
8105,2023-04-03,2023-04-03,,Utility Payment,130.74,0.00,3647677.18
8106,2023-04-04,2023-04-04,,Groceries - Supermarket,130.98,0.00,3647546.20
8107,2023-04-04,2023-04-04,,Salary Credit,0.00,4408.54,3651954.74
8108,2023-04-03,2023-04-04,,Salary Credit,0.00,3574.54,3655529.28
8109,2023-04-04,2023-04-04,,Dining Out,48.30,0.00,3655480.98
8110,2023-04-05,2023-04-04,,ATM Withdrawal,241.81,0.00,3655239.17
8111,2023-04-06,2023-04-05,,Loan EMI,1489.71,0.00,3653749.46
8112,2023-04-06,2023-04-05,,Salary Credit,0.00,3941.10,3657690.56
8113,2023-04-05,2023-04-05,,ATM Withdrawal,221.62,0.00,3657468.94
8114,2023-04-04,2023-04-05,,Transfer Received,0.00,2538.38,3660007.32
8115,2023-04-04,2023-04-05,,Utility Payment,259.37,0.00,3659747.95
8116,2023-04-04,2023-04-05,,ATM Withdrawal,172.97,0.00,3659574.98
8117,2023-04-06,2023-04-06,,Groceries - Online Delivery,116.30,0.00,3659458.68
8118,2023-04-05,2023-04-06,,Salary Credit,0.00,3188.25,3662646.93
8119,2023-04-06,2023-04-06,,ATM Withdrawal,184.70,0.00,3662462.23
8120,2023-04-07,2023-04-06,,Transfer Received,0.00,2558.82,3665021.05
8121,2023-04-06,2023-04-06,,Transfer Received,0.00,1514.13,3666535.18
8122,2023-04-06,2023-04-06,,Investment Returns,0.00,987.95,3667523.13
8123,2023-04-05,2023-04-06,,Salary Credit,0.00,2915.47,3670438.60
8124,2023-04-06,2023-04-06,,Groceries - Supermarket,196.83,0.00,3670241.77
8125,2023-04-06,2023-04-06,,Transfer Received,0.00,1830.42,3672072.19
8126,2023-04-07,2023-04-07,,Credit Card Payment,782.51,0.00,3671289.68
8127,2023-04-07,2023-04-08,,ATM Withdrawal,247.35,0.00,3671042.33
8128,2023-04-08,2023-04-08,,Online Transfer,756.91,0.00,3670285.42
8129,2023-04-07,2023-04-08,,Transfer Received,0.00,2121.89,3672407.31
8130,2023-04-09,2023-04-09,,Groceries - Supermarket,35.70,0.00,3672371.61
8131,2023-04-10,2023-04-09,,Salary Credit,0.00,4657.60,3677029.21
8132,2023-04-09,2023-04-09,,Groceries - Supermarket,187.78,0.00,3676841.43
8133,2023-04-09,2023-04-09,,Online Transfer,245.38,0.00,3676596.05
8134,2023-04-09,2023-04-09,,Credit Card Payment,626.20,0.00,3675969.85
8135,2023-04-09,2023-04-09,,Credit Card Payment,832.82,0.00,3675137.03
8136,2023-04-09,2023-04-09,,Loan EMI,900.33,0.00,3674236.70
8137,2023-04-10,2023-04-10,,Online Transfer,304.01,0.00,3673932.69
8138,2023-04-10,2023-04-10,,Groceries - Supermarket,80.68,0.00,3673852.01
8139,2023-04-11,2023-04-10,,Utility Payment,142.03,0.00,3673709.98
8140,2023-04-10,2023-04-10,,Credit Card Payment,682.54,0.00,3673027.44
8141,2023-04-10,2023-04-10,,Salary Credit,0.00,3476.90,3676504.34
8142,2023-04-11,2023-04-11,,Credit Card Payment,378.61,0.00,3676125.73
8143,2023-04-11,2023-04-11,,Takeout,45.93,0.00,3676079.80
8144,2023-04-11,2023-04-11,,Transfer Received,0.00,1580.47,3677660.27
8145,2023-04-10,2023-04-11,,Transfer Received,0.00,2745.82,3680406.09
8146,2023-04-10,2023-04-11,,Credit Card Payment,494.01,0.00,3679912.08
8147,2023-04-11,2023-04-11,,Salary Credit,0.00,2529.80,3682441.88
8148,2023-04-11,2023-04-11,,ATM Withdrawal,292.95,0.00,3682148.93
8149,2023-04-11,2023-04-11,,Investment - Stocks,1083.65,0.00,3681065.28
8150,2023-04-13,2023-04-12,,Transfer Received,0.00,2554.73,3683620.01
8151,2023-04-13,2023-04-12,,Dining Out,27.22,0.00,3683592.79
8152,2023-04-13,2023-04-12,,ATM Withdrawal,261.69,0.00,3683331.10
8153,2023-04-12,2023-04-12,,ATM Withdrawal,82.92,0.00,3683248.18
8154,2023-04-12,2023-04-12,,Utility Payment,86.11,0.00,3683162.07
8155,2023-04-12,2023-04-12,,Investment Returns,0.00,486.23,3683648.30
8156,2023-04-12,2023-04-13,,Online Transfer,1139.13,0.00,3682509.17
8157,2023-04-14,2023-04-13,,Groceries - Online Delivery,108.67,0.00,3682400.50
8158,2023-04-13,2023-04-13,,Transfer Received,0.00,2447.80,3684848.30
8159,2023-04-14,2023-04-13,,Salary Credit,0.00,4030.58,3688878.88
8160,2023-04-14,2023-04-14,,Investment - Stocks,1120.74,0.00,3687758.14
8161,2023-04-14,2023-04-14,,Dining Out,90.00,0.00,3687668.14
8162,2023-04-14,2023-04-14,,Transfer Received,0.00,1081.44,3688749.58
8163,2023-04-13,2023-04-14,,Takeout,34.51,0.00,3688715.07
8164,2023-04-14,2023-04-14,,Salary Credit,0.00,2351.85,3691066.92
8165,2023-04-14,2023-04-14,,Investment - SIP,302.89,0.00,3690764.03
8166,2023-04-14,2023-04-14,,Takeout,15.44,0.00,3690748.59
8167,2023-04-14,2023-04-14,,Transfer Received,0.00,694.34,3691442.93
8168,2023-04-13,2023-04-14,,Online Transfer,1434.99,0.00,3690007.94
8169,2023-04-14,2023-04-14,,Groceries - Online Delivery,131.75,0.00,3689876.19
8170,2023-04-13,2023-04-14,,Transfer Received,0.00,2394.65,3692270.84
8171,2023-04-15,2023-04-15,,Groceries - Online Delivery,113.23,0.00,3692157.61
8172,2023-04-15,2023-04-15,,Salary Credit,0.00,3115.17,3695272.78
8173,2023-04-14,2023-04-15,,Takeout,11.68,0.00,3695261.10
8174,2023-04-14,2023-04-15,,ATM Withdrawal,161.09,0.00,3695100.01
8175,2023-04-15,2023-04-15,,Salary Credit,0.00,3514.85,3698614.86
8176,2023-04-15,2023-04-15,,ATM Withdrawal,97.95,0.00,3698516.91
8177,2023-04-15,2023-04-16,,Utility Payment,264.25,0.00,3698252.66
8178,2023-04-16,2023-04-16,,Dining Out,59.87,0.00,3698192.79
8179,2023-04-16,2023-04-16,,Salary Credit,0.00,3937.68,3702130.47
8180,2023-04-16,2023-04-16,,Transfer Received,0.00,1501.20,3703631.67
8181,2023-04-16,2023-04-16,,Interest Credited,0.00,44.55,3703676.22
8182,2023-04-17,2023-04-17,,Investment - Stocks,3777.77,0.00,3699898.45
8183,2023-04-17,2023-04-17,,Investment - Mutual Funds,2956.09,0.00,3696942.36
8184,2023-04-17,2023-04-17,,Salary Credit,0.00,3882.63,3700824.99
8185,2023-04-17,2023-04-17,,Daily Essentials,11.32,0.00,3700813.67
8186,2023-04-17,2023-04-17,,Groceries - Online Delivery,125.84,0.00,3700687.83
8187,2023-04-17,2023-04-17,,Utility Payment,59.63,0.00,3700628.20
8188,2023-04-17,2023-04-17,,Salary Credit,0.00,3341.69,3703969.89
8189,2023-04-18,2023-04-18,,Salary Credit,0.00,4750.16,3708720.05
8190,2023-04-18,2023-04-18,,Groceries - Online Delivery,93.16,0.00,3708626.89
8191,2023-04-18,2023-04-18,,Rental Income,0.00,1227.36,3709854.25
8192,2023-04-17,2023-04-18,,Loan EMI,536.22,0.00,3709318.03
8193,2023-04-19,2023-04-18,,Transfer Received,0.00,1577.81,3710895.84
8194,2023-04-18,2023-04-18,,Loan EMI,1588.47,0.00,3709307.37
8195,2023-04-17,2023-04-18,,Transfer Received,0.00,2030.11,3711337.48
8196,2023-04-17,2023-04-18,,Transfer Received,0.00,2025.38,3713362.86
8197,2023-04-18,2023-04-18,,Utility Payment,225.79,0.00,3713137.07
8198,2023-04-17,2023-04-18,,Transfer Received,0.00,2544.48,3715681.55
8199,2023-04-20,2023-04-19,,Interest Credited,0.00,67.57,3715749.12
8200,2023-04-19,2023-04-19,100201,Cheque Issued,1719.14,0.00,3714029.98
8201,2023-04-19,2023-04-19,,Dividend Received,0.00,236.75,3714266.73
8202,2023-04-18,2023-04-19,,Rental Income,0.00,2444.94,3716711.67
8203,2023-04-20,2023-04-19,100202,Cheque Issued,1780.86,0.00,3714930.81
8204,2023-04-19,2023-04-19,,Online Transfer,1384.14,0.00,3713546.67
8205,2023-04-19,2023-04-19,,Utility Payment,216.32,0.00,3713330.35
8206,2023-04-18,2023-04-19,,Salary Credit,0.00,4837.16,3718167.51
8207,2023-04-19,2023-04-20,,Salary Credit,0.00,2840.30,3721007.81
8208,2023-04-21,2023-04-20,,Groceries - Supermarket,80.46,0.00,3720927.35
8209,2023-04-20,2023-04-20,,Transfer Received,0.00,564.33,3721491.68
8210,2023-04-20,2023-04-20,,Transfer Received,0.00,2235.78,3723727.46
8211,2023-04-19,2023-04-20,,Investment Returns,0.00,948.55,3724676.01
8212,2023-04-21,2023-04-20,100203,Cheque Issued,1892.83,0.00,3722783.18
8213,2023-04-20,2023-04-20,,Salary Credit,0.00,3552.79,3726335.97
8214,2023-04-22,2023-04-21,,Salary Credit,0.00,3539.18,3729875.15
8215,2023-04-21,2023-04-21,,Interest Credited,0.00,43.20,3729918.35
8216,2023-04-21,2023-04-21,,Credit Card Payment,968.16,0.00,3728950.19
8217,2023-04-21,2023-04-21,,Investment - Mutual Funds,1454.81,0.00,3727495.38
8218,2023-04-21,2023-04-21,,Groceries - Supermarket,137.67,0.00,3727357.71
8219,2023-04-21,2023-04-21,100204,Cheque Issued,1547.35,0.00,3725810.36
8220,2023-04-21,2023-04-21,,Investment - Stocks,1640.28,0.00,3724170.08
8221,2023-04-22,2023-04-21,,Groceries - Supermarket,187.51,0.00,3723982.57
8222,2023-04-21,2023-04-21,,Investment Returns,0.00,732.47,3724715.04
8223,2023-04-21,2023-04-21,,Interest Credited,0.00,46.57,3724761.61
8224,2023-04-22,2023-04-21,,Cash Deposit,0.00,970.36,3725731.97
8225,2023-04-21,2023-04-21,,Online Transfer,415.37,0.00,3725316.60
8226,2023-04-20,2023-04-21,,Utility Payment,106.95,0.00,3725209.65
8227,2023-04-23,2023-04-22,,Groceries - Supermarket,185.18,0.00,3725024.47
8228,2023-04-22,2023-04-22,,Transfer Received,0.00,891.73,3725916.20
8229,2023-04-21,2023-04-22,,Salary Credit,0.00,2323.69,3728239.89
8230,2023-04-22,2023-04-22,,Interest Credited,0.00,84.17,3728324.06
8231,2023-04-23,2023-04-23,,Salary Credit,0.00,4457.82,3732781.88
8232,2023-04-23,2023-04-23,,ATM Withdrawal,470.23,0.00,3732311.65
8233,2023-04-24,2023-04-23,,ATM Withdrawal,454.05,0.00,3731857.60
8234,2023-04-23,2023-04-23,,Online Transfer,1066.46,0.00,3730791.14
8235,2023-04-24,2023-04-23,,ATM Withdrawal,116.75,0.00,3730674.39
8236,2023-04-23,2023-04-23,,Takeout,14.96,0.00,3730659.43
8237,2023-04-23,2023-04-23,,Credit Card Payment,269.34,0.00,3730390.09
8238,2023-04-23,2023-04-23,,Transfer Received,0.00,2600.53,3732990.62
8239,2023-04-24,2023-04-24,100205,Cheque Issued,1197.03,0.00,3731793.59
8240,2023-04-23,2023-04-24,,Interest Credited,0.00,14.75,3731808.34
8241,2023-04-23,2023-04-24,,Online Transfer,1936.75,0.00,3729871.59
8242,2023-04-24,2023-04-24,,Interest Credited,0.00,69.12,3729940.71
8243,2023-04-24,2023-04-24,,ATM Withdrawal,482.39,0.00,3729458.32
8244,2023-04-24,2023-04-24,,Loan EMI,1580.30,0.00,3727878.02
8245,2023-04-23,2023-04-24,,Credit Card Payment,815.60,0.00,3727062.42
8246,2023-04-24,2023-04-24,,Interest Credited,0.00,92.62,3727155.04
8247,2023-04-25,2023-04-25,,Transfer Received,0.00,2094.87,3729249.91
8248,2023-04-26,2023-04-25,,Investment - Stocks,975.52,0.00,3728274.39
8249,2023-04-25,2023-04-25,,ATM Withdrawal,255.54,0.00,3728018.85
8250,2023-04-25,2023-04-25,,Salary Credit,0.00,2062.57,3730081.42
8251,2023-04-25,2023-04-25,,Transfer Received,0.00,1670.06,3731751.48
8252,2023-04-25,2023-04-25,,Credit Card Payment,642.07,0.00,3731109.41
8253,2023-04-26,2023-04-25,,Groceries - Supermarket,89.97,0.00,3731019.44
8254,2023-04-26,2023-04-26,,Groceries - Supermarket,172.16,0.00,3730847.28
8255,2023-04-26,2023-04-26,,Investment - Stocks,2925.28,0.00,3727922.00
8256,2023-04-26,2023-04-26,,Salary Credit,0.00,4583.02,3732505.02
8257,2023-04-27,2023-04-26,,Salary Credit,0.00,2729.82,3735234.84
8258,2023-04-25,2023-04-26,,Transfer Received,0.00,1764.21,3736999.05
8259,2023-04-27,2023-04-26,,Salary Credit,0.00,2435.91,3739434.96
8260,2023-04-27,2023-04-26,,Credit Card Payment,837.19,0.00,3738597.77
8261,2023-04-25,2023-04-26,,Utility Payment,131.27,0.00,3738466.50
8262,2023-04-26,2023-04-26,,Loan EMI,1051.36,0.00,3737415.14
8263,2023-04-26,2023-04-26,,Groceries - Online Delivery,87.29,0.00,3737327.85
8264,2023-04-25,2023-04-26,,Salary Credit,0.00,4000.06,3741327.91
8265,2023-04-27,2023-04-27,,Interest Credited,0.00,60.70,3741388.61
8266,2023-04-27,2023-04-27,,Online Transfer,912.94,0.00,3740475.67
8267,2023-04-27,2023-04-27,,Salary Credit,0.00,3436.71,3743912.38
8268,2023-04-27,2023-04-27,,Loan EMI,565.64,0.00,3743346.74
8269,2023-04-27,2023-04-27,,Interest Credited,0.00,52.26,3743399.00
8270,2023-04-27,2023-04-27,,ATM Withdrawal,209.55,0.00,3743189.45
8271,2023-04-28,2023-04-27,,Online Transfer,541.31,0.00,3742648.14
8272,2023-04-27,2023-04-27,,Online Transfer,1035.27,0.00,3741612.87
8273,2023-04-27,2023-04-27,,Dividend Received,0.00,163.35,3741776.22
8274,2023-04-27,2023-04-27,,Salary Credit,0.00,3649.53,3745425.75
8275,2023-04-28,2023-04-27,,Investment - Stocks,575.31,0.00,3744850.44
8276,2023-04-27,2023-04-28,,Salary Credit,0.00,4632.14,3749482.58
8277,2023-04-28,2023-04-28,,Salary Credit,0.00,3432.12,3752914.70
8278,2023-04-28,2023-04-28,,Daily Essentials,32.69,0.00,3752882.01
8279,2023-04-28,2023-04-28,,Transfer Received,0.00,1550.57,3754432.58
8280,2023-04-28,2023-04-28,,Salary Credit,0.00,4881.22,3759313.80
8281,2023-04-29,2023-04-29,,Online Transfer,366.65,0.00,3758947.15
8282,2023-04-29,2023-04-29,,Salary Credit,0.00,2243.74,3761190.89
8283,2023-04-29,2023-04-29,,Credit Card Payment,556.04,0.00,3760634.85
8284,2023-04-29,2023-04-29,,Salary Credit,0.00,3624.48,3764259.33
8285,2023-04-28,2023-04-29,,Groceries - Supermarket,121.31,0.00,3764138.02
8286,2023-04-30,2023-04-29,,Groceries - Supermarket,149.71,0.00,3763988.31
8287,2023-04-30,2023-04-30,,Takeout,17.64,0.00,3763970.67
8288,2023-05-01,2023-04-30,,Interest Credited,0.00,98.50,3764069.17
8289,2023-05-01,2023-05-01,,Transfer Received,0.00,1941.70,3766010.87
8290,2023-05-02,2023-05-01,,Groceries - Supermarket,130.46,0.00,3765880.41
8291,2023-04-30,2023-05-01,,Groceries - Supermarket,193.25,0.00,3765687.16
8292,2023-05-02,2023-05-01,,ATM Withdrawal,271.86,0.00,3765415.30
8293,2023-04-30,2023-05-01,,Investment Returns,0.00,475.58,3765890.88
8294,2023-04-30,2023-05-01,,Transfer Received,0.00,1754.07,3767644.95
8295,2023-05-01,2023-05-01,,Salary Credit,0.00,4177.19,3771822.14
8296,2023-05-01,2023-05-01,,Credit Card Payment,312.04,0.00,3771510.10
8297,2023-05-01,2023-05-01,,Credit Card Payment,908.04,0.00,3770602.06
8298,2023-05-02,2023-05-02,,Interest Credited,0.00,93.85,3770695.91
8299,2023-05-02,2023-05-02,,Investment - Stocks,4676.02,0.00,3766019.89
8300,2023-05-02,2023-05-02,,ATM Withdrawal,52.73,0.00,3765967.16
8301,2023-05-02,2023-05-02,,Salary Credit,0.00,4117.27,3770084.43
8302,2023-05-03,2023-05-03,,Online Transfer,124.12,0.00,3769960.31
8303,2023-05-03,2023-05-03,,ATM Withdrawal,410.17,0.00,3769550.14
8304,2023-05-03,2023-05-03,,Groceries - Supermarket,44.56,0.00,3769505.58
8305,2023-05-02,2023-05-03,,ATM Withdrawal,246.95,0.00,3769258.63
8306,2023-05-03,2023-05-03,,Groceries - Supermarket,148.02,0.00,3769110.61
8307,2023-05-04,2023-05-03,,Salary Credit,0.00,2761.87,3771872.48
8308,2023-05-03,2023-05-03,,Investment - Stocks,706.76,0.00,3771165.72
8309,2023-05-03,2023-05-03,,Salary Credit,0.00,2295.27,3773460.99
8310,2023-05-03,2023-05-03,,Credit Card Payment,835.20,0.00,3772625.79
8311,2023-05-03,2023-05-03,,Rental Income,0.00,2596.01,3775221.80
8312,2023-05-03,2023-05-03,,Dividend Received,0.00,92.72,3775314.52
8313,2023-05-04,2023-05-04,,Credit Card Payment,943.85,0.00,3774370.67
8314,2023-05-04,2023-05-04,,Dining Out,29.14,0.00,3774341.53
8315,2023-05-03,2023-05-04,,Utility Payment,53.79,0.00,3774287.74
8316,2023-05-04,2023-05-04,,Groceries - Supermarket,30.55,0.00,3774257.19
8317,2023-05-03,2023-05-04,,Dividend Received,0.00,273.63,3774530.82
8318,2023-05-04,2023-05-04,,Online Transfer,1829.49,0.00,3772701.33
8319,2023-05-03,2023-05-04,,Groceries - Supermarket,118.21,0.00,3772583.12
8320,2023-05-04,2023-05-04,,Utility Payment,64.96,0.00,3772518.16
8321,2023-05-04,2023-05-04,,Online Transfer,937.99,0.00,3771580.17
8322,2023-05-04,2023-05-04,,Salary Credit,0.00,4664.45,3776244.62
8323,2023-05-05,2023-05-05,,Transfer Received,0.00,2822.54,3779067.16
8324,2023-05-05,2023-05-05,,Daily Essentials,24.03,0.00,3779043.13
8325,2023-05-05,2023-05-05,,Cash Deposit,0.00,249.67,3779292.80
8326,2023-05-05,2023-05-05,,Investment - SIP,238.50,0.00,3779054.30
8327,2023-05-04,2023-05-05,,Online Transfer,1684.83,0.00,3777369.47
8328,2023-05-04,2023-05-05,,Transfer Received,0.00,1096.99,3778466.46
8329,2023-05-06,2023-05-06,,ATM Withdrawal,116.82,0.00,3778349.64
8330,2023-05-05,2023-05-06,,Investment Returns,0.00,987.55,3779337.19
8331,2023-05-07,2023-05-06,,Cash Deposit,0.00,141.21,3779478.40
8332,2023-05-06,2023-05-06,,Dining Out,37.01,0.00,3779441.39
8333,2023-05-06,2023-05-06,,Coffee Shop,7.26,0.00,3779434.13
8334,2023-05-06,2023-05-06,,Transfer Received,0.00,1491.54,3780925.67
8335,2023-05-07,2023-05-06,,Online Transfer,555.94,0.00,3780369.73
8336,2023-05-06,2023-05-06,,Loan EMI,1561.97,0.00,3778807.76
8337,2023-05-08,2023-05-07,,Rental Income,0.00,1742.94,3780550.70
8338,2023-05-07,2023-05-07,,Transfer Received,0.00,1839.49,3782390.19
8339,2023-05-06,2023-05-07,,ATM Withdrawal,209.47,0.00,3782180.72
8340,2023-05-07,2023-05-07,,ATM Withdrawal,413.88,0.00,3781766.84
8341,2023-05-07,2023-05-07,,Transfer Received,0.00,1477.43,3783244.27
8342,2023-05-07,2023-05-07,,Transfer Received,0.00,509.17,3783753.44
8343,2023-05-07,2023-05-07,,ATM Withdrawal,296.75,0.00,3783456.69
8344,2023-05-08,2023-05-08,,Salary Credit,0.00,4514.62,3787971.31
8345,2023-05-08,2023-05-08,,Investment Returns,0.00,164.09,3788135.40
8346,2023-05-08,2023-05-08,,Salary Credit,0.00,2114.06,3790249.46
8347,2023-05-07,2023-05-08,,ATM Withdrawal,68.03,0.00,3790181.43
8348,2023-05-08,2023-05-08,,Loan EMI,909.70,0.00,3789271.73
8349,2023-05-08,2023-05-08,,Dining Out,68.47,0.00,3789203.26
8350,2023-05-09,2023-05-08,,ATM Withdrawal,50.99,0.00,3789152.27
8351,2023-05-09,2023-05-08,,ATM Withdrawal,379.48,0.00,3788772.79
8352,2023-05-08,2023-05-09,,Online Transfer,1970.41,0.00,3786802.38
8353,2023-05-10,2023-05-09,,Investment Returns,0.00,835.05,3787637.43
8354,2023-05-08,2023-05-09,,Groceries - Supermarket,128.97,0.00,3787508.46
8355,2023-05-09,2023-05-09,,Salary Credit,0.00,2289.53,3789797.99
8356,2023-05-09,2023-05-09,,Salary Credit,0.00,3347.57,3793145.56
8357,2023-05-10,2023-05-09,,ATM Withdrawal,76.01,0.00,3793069.55
8358,2023-05-09,2023-05-10,,Salary Credit,0.00,4863.52,3797933.07
8359,2023-05-10,2023-05-10,,Groceries - Supermarket,104.57,0.00,3797828.50
8360,2023-05-10,2023-05-10,,Cash Deposit,0.00,574.98,3798403.48
8361,2023-05-11,2023-05-11,,Salary Credit,0.00,4029.95,3802433.43
8362,2023-05-11,2023-05-11,,Online Transfer,1016.55,0.00,3801416.88
8363,2023-05-11,2023-05-11,,Rental Income,0.00,2495.08,3803911.96
8364,2023-05-11,2023-05-11,,ATM Withdrawal,82.84,0.00,3803829.12
8365,2023-05-11,2023-05-11,,Coffee Shop,10.61,0.00,3803818.51
8366,2023-05-11,2023-05-11,,Transfer Received,0.00,889.78,3804708.29
8367,2023-05-11,2023-05-11,,Transfer Received,0.00,1364.97,3806073.26
8368,2023-05-12,2023-05-12,,Groceries - Supermarket,55.88,0.00,3806017.38
8369,2023-05-13,2023-05-13,,Interest Credited,0.00,11.91,3806029.29
8370,2023-05-13,2023-05-13,,Online Transfer,1651.62,0.00,3804377.67
8371,2023-05-13,2023-05-13,,Credit Card Payment,225.62,0.00,3804152.05
8372,2023-05-14,2023-05-14,,ATM Withdrawal,437.54,0.00,3803714.51
8373,2023-05-14,2023-05-14,,Groceries - Online Delivery,113.96,0.00,3803600.55
8374,2023-05-15,2023-05-14,,Daily Essentials,27.29,0.00,3803573.26
8375,2023-05-15,2023-05-14,,Dividend Received,0.00,124.11,3803697.37
8376,2023-05-14,2023-05-14,,Groceries - Online Delivery,63.68,0.00,3803633.69
8377,2023-05-15,2023-05-15,,Groceries - Supermarket,61.62,0.00,3803572.07
8378,2023-05-16,2023-05-15,,Transfer Received,0.00,2759.94,3806332.01
8379,2023-05-15,2023-05-15,,Salary Credit,0.00,2457.95,3808789.96
8380,2023-05-15,2023-05-16,,Daily Essentials,13.00,0.00,3808776.96
8381,2023-05-16,2023-05-16,,Online Transfer,1110.86,0.00,3807666.10
8382,2023-05-16,2023-05-16,,Investment - Stocks,1010.44,0.00,3806655.66
8383,2023-05-17,2023-05-16,,Transfer Received,0.00,2889.10,3809544.76
8384,2023-05-16,2023-05-16,,Transfer Received,0.00,913.26,3810458.02
8385,2023-05-16,2023-05-16,,Credit Card Payment,979.64,0.00,3809478.38
8386,2023-05-16,2023-05-16,,Groceries - Supermarket,106.94,0.00,3809371.44
8387,2023-05-16,2023-05-16,,Investment - Mutual Funds,530.48,0.00,3808840.96
8388,2023-05-17,2023-05-17,,Transfer Received,0.00,842.24,3809683.20
8389,2023-05-17,2023-05-17,,Groceries - Supermarket,152.96,0.00,3809530.24
8390,2023-05-17,2023-05-17,,Credit Card Payment,281.80,0.00,3809248.44
8391,2023-05-17,2023-05-17,,Utility Payment,73.27,0.00,3809175.17
8392,2023-05-17,2023-05-17,,Cash Deposit,0.00,498.05,3809673.22
8393,2023-05-17,2023-05-17,,Cash Deposit,0.00,711.39,3810384.61
8394,2023-05-17,2023-05-17,,Loan EMI,1585.72,0.00,3808798.89
8395,2023-05-17,2023-05-17,,Salary Credit,0.00,2456.27,3811255.16
8396,2023-05-18,2023-05-17,,ATM Withdrawal,266.04,0.00,3810989.12
8397,2023-05-18,2023-05-18,,Investment - Mutual Funds,840.02,0.00,3810149.10
8398,2023-05-18,2023-05-18,,Transfer Received,0.00,1403.06,3811552.16
8399,2023-05-18,2023-05-18,,ATM Withdrawal,274.24,0.00,3811277.92
8400,2023-05-18,2023-05-18,,Loan EMI,1803.46,0.00,3809474.46
8401,2023-05-18,2023-05-18,,Dining Out,20.65,0.00,3809453.81
8402,2023-05-18,2023-05-19,,Groceries - Supermarket,152.48,0.00,3809301.33
8403,2023-05-20,2023-05-19,,ATM Withdrawal,20.41,0.00,3809280.92
8404,2023-05-18,2023-05-19,,Transfer Received,0.00,2106.42,3811387.34
8405,2023-05-19,2023-05-19,,Interest Credited,0.00,99.89,3811487.23
8406,2023-05-18,2023-05-19,,Groceries - Supermarket,165.94,0.00,3811321.29
8407,2023-05-19,2023-05-19,,Investment Returns,0.00,60.56,3811381.85
8408,2023-05-19,2023-05-19,,Groceries - Supermarket,61.15,0.00,3811320.70
8409,2023-05-18,2023-05-19,,ATM Withdrawal,94.35,0.00,3811226.35
8410,2023-05-20,2023-05-19,,Rental Income,0.00,2970.92,3814197.27
8411,2023-05-20,2023-05-20,,Salary Credit,0.00,4475.43,3818672.70
8412,2023-05-20,2023-05-20,,Transfer Received,0.00,1996.38,3820669.08
8413,2023-05-21,2023-05-20,100206,Cheque Issued,2210.60,0.00,3818458.48
8414,2023-05-20,2023-05-20,,Interest Credited,0.00,46.48,3818504.96
8415,2023-05-20,2023-05-20,,Loan EMI,1484.36,0.00,3817020.60
8416,2023-05-20,2023-05-20,,ATM Withdrawal,467.64,0.00,3816552.96
8417,2023-05-19,2023-05-20,,Groceries - Online Delivery,119.44,0.00,3816433.52
8418,2023-05-20,2023-05-20,,ATM Withdrawal,111.79,0.00,3816321.73
8419,2023-05-20,2023-05-20,,Credit Card Payment,381.97,0.00,3815939.76
8420,2023-05-21,2023-05-21,,ATM Withdrawal,377.46,0.00,3815562.30
8421,2023-05-21,2023-05-21,,ATM Withdrawal,53.43,0.00,3815508.87
8422,2023-05-20,2023-05-21,,Groceries - Supermarket,90.05,0.00,3815418.82
8423,2023-05-21,2023-05-21,,Online Transfer,1950.56,0.00,3813468.26
8424,2023-05-21,2023-05-21,,Coffee Shop,15.30,0.00,3813452.96
8425,2023-05-21,2023-05-21,,Groceries - Supermarket,167.21,0.00,3813285.75
8426,2023-05-22,2023-05-22,,Investment - SIP,714.66,0.00,3812571.09
8427,2023-05-22,2023-05-22,,Utility Payment,82.28,0.00,3812488.81
8428,2023-05-22,2023-05-22,,Salary Credit,0.00,2636.65,3815125.46
8429,2023-05-22,2023-05-22,,Credit Card Payment,835.44,0.00,3814290.02
8430,2023-05-22,2023-05-22,,Dividend Received,0.00,258.06,3814548.08
8431,2023-05-22,2023-05-22,,Credit Card Payment,293.87,0.00,3814254.21
8432,2023-05-22,2023-05-22,,Cash Deposit,0.00,351.08,3814605.29
8433,2023-05-22,2023-05-22,,Investment - SIP,790.91,0.00,3813814.38
8434,2023-05-22,2023-05-22,,Salary Credit,0.00,3962.99,3817777.37
8435,2023-05-22,2023-05-22,,Online Transfer,1574.39,0.00,3816202.98
8436,2023-05-24,2023-05-23,,ATM Withdrawal,250.03,0.00,3815952.95
8437,2023-05-23,2023-05-23,,Groceries - Supermarket,60.23,0.00,3815892.72
8438,2023-05-22,2023-05-23,,ATM Withdrawal,28.80,0.00,3815863.92
8439,2023-05-23,2023-05-23,,Groceries - Supermarket,101.24,0.00,3815762.68
8440,2023-05-23,2023-05-23,,Transfer Received,0.00,1734.77,3817497.45
8441,2023-05-23,2023-05-23,,Salary Credit,0.00,4976.32,3822473.77
8442,2023-05-22,2023-05-23,,Interest Credited,0.00,54.79,3822528.56
8443,2023-05-24,2023-05-24,,Cash Deposit,0.00,145.75,3822674.31
8444,2023-05-24,2023-05-24,,Transfer Received,0.00,584.56,3823258.87
8445,2023-05-24,2023-05-24,,Credit Card Payment,331.19,0.00,3822927.68
8446,2023-05-25,2023-05-24,,Transfer Received,0.00,2350.47,3825278.15
8447,2023-05-24,2023-05-24,,Credit Card Payment,406.44,0.00,3824871.71
8448,2023-05-24,2023-05-24,,Salary Credit,0.00,2796.25,3827667.96
8449,2023-05-25,2023-05-24,,Salary Credit,0.00,2436.51,3830104.47
8450,2023-05-24,2023-05-24,,Online Transfer,335.80,0.00,3829768.67
8451,2023-05-24,2023-05-24,,Credit Card Payment,536.27,0.00,3829232.40
8452,2023-05-25,2023-05-25,,Cash Deposit,0.00,904.83,3830137.23
8453,2023-05-25,2023-05-25,,Investment Returns,0.00,64.72,3830201.95
8454,2023-05-25,2023-05-25,,Investment - SIP,188.44,0.00,3830013.51
8455,2023-05-25,2023-05-25,,Transfer Received,0.00,2631.23,3832644.74
8456,2023-05-25,2023-05-25,,Online Transfer,599.83,0.00,3832044.91
8457,2023-05-25,2023-05-25,,Utility Payment,52.91,0.00,3831992.00
8458,2023-05-24,2023-05-25,,Transfer Received,0.00,900.97,3832892.97
8459,2023-05-25,2023-05-25,,Salary Credit,0.00,4627.70,3837520.67
8460,2023-05-25,2023-05-25,,Salary Credit,0.00,3113.99,3840634.66
8461,2023-05-25,2023-05-25,,Salary Credit,0.00,4522.19,3845156.85
8462,2023-05-24,2023-05-25,,Online Transfer,1954.58,0.00,3843202.27
8463,2023-05-25,2023-05-25,,Investment - Stocks,3776.84,0.00,3839425.43
8464,2023-05-26,2023-05-26,,Loan EMI,1947.34,0.00,3837478.09
8465,2023-05-26,2023-05-26,,Credit Card Payment,235.95,0.00,3837242.14
8466,2023-05-25,2023-05-26,,Transfer Received,0.00,1175.83,3838417.97
8467,2023-05-26,2023-05-26,,Groceries - Supermarket,113.49,0.00,3838304.48
8468,2023-05-26,2023-05-26,,Salary Credit,0.00,2759.26,3841063.74
8469,2023-05-26,2023-05-26,,ATM Withdrawal,450.77,0.00,3840612.97
8470,2023-05-27,2023-05-26,,Transfer Received,0.00,963.11,3841576.08
8471,2023-05-27,2023-05-27,,Transfer Received,0.00,2849.03,3844425.11
8472,2023-05-28,2023-05-27,,Online Transfer,1714.60,0.00,3842710.51
8473,2023-05-26,2023-05-27,,Groceries - Supermarket,165.81,0.00,3842544.70
8474,2023-05-27,2023-05-27,100207,Cheque Issued,1579.75,0.00,3840964.95
8475,2023-05-27,2023-05-27,,ATM Withdrawal,116.79,0.00,3840848.16
8476,2023-05-28,2023-05-28,,Online Transfer,948.92,0.00,3839899.24
8477,2023-05-28,2023-05-28,,ATM Withdrawal,201.62,0.00,3839697.62
8478,2023-05-28,2023-05-28,,Groceries - Online Delivery,55.26,0.00,3839642.36
8479,2023-05-28,2023-05-28,,Interest Credited,0.00,86.10,3839728.46
8480,2023-05-28,2023-05-28,,Transfer Received,0.00,1766.87,3841495.33
8481,2023-05-27,2023-05-28,,Rental Income,0.00,1357.89,3842853.22
8482,2023-05-29,2023-05-29,,Salary Credit,0.00,3117.44,3845970.66
8483,2023-05-29,2023-05-29,,ATM Withdrawal,43.30,0.00,3845927.36
8484,2023-05-29,2023-05-29,,Transfer Received,0.00,2609.60,3848536.96
8485,2023-05-29,2023-05-29,,ATM Withdrawal,349.31,0.00,3848187.65
8486,2023-05-29,2023-05-29,,Transfer Received,0.00,1899.44,3850087.09
8487,2023-05-30,2023-05-29,,Cash Deposit,0.00,263.42,3850350.51
8488,2023-05-28,2023-05-29,,Investment - SIP,673.99,0.00,3849676.52
8489,2023-05-30,2023-05-29,,Salary Credit,0.00,4312.70,3853989.22
8490,2023-05-30,2023-05-30,,Salary Credit,0.00,2644.54,3856633.76
8491,2023-05-30,2023-05-30,,Salary Credit,0.00,2352.12,3858985.88
8492,2023-05-29,2023-05-30,,Dining Out,79.46,0.00,3858906.42
8493,2023-05-30,2023-05-30,,Cash Deposit,0.00,740.09,3859646.51
8494,2023-05-30,2023-05-30,,Salary Credit,0.00,3632.26,3863278.77
8495,2023-05-30,2023-05-30,,Online Transfer,1102.64,0.00,3862176.13
8496,2023-05-29,2023-05-30,,Salary Credit,0.00,2969.15,3865145.28
8497,2023-05-30,2023-05-30,,Online Transfer,1927.70,0.00,3863217.58
8498,2023-05-30,2023-05-30,,Credit Card Payment,388.26,0.00,3862829.32
8499,2023-05-31,2023-05-31,,Rental Income,0.00,1424.76,3864254.08
8500,2023-05-31,2023-05-31,,Groceries - Supermarket,32.17,0.00,3864221.91
8501,2023-05-31,2023-05-31,,ATM Withdrawal,142.19,0.00,3864079.72
8502,2023-06-01,2023-06-01,,Utility Payment,269.75,0.00,3863809.97
8503,2023-06-01,2023-06-01,,Online Transfer,1887.99,0.00,3861921.98
8504,2023-06-01,2023-06-01,,Rental Income,0.00,1303.43,3863225.41
8505,2023-06-01,2023-06-01,,Salary Credit,0.00,3363.63,3866589.04
8506,2023-06-02,2023-06-01,,Utility Payment,284.07,0.00,3866304.97
8507,2023-05-31,2023-06-01,,Groceries - Supermarket,155.73,0.00,3866149.24
8508,2023-06-01,2023-06-01,,ATM Withdrawal,478.45,0.00,3865670.79
8509,2023-06-02,2023-06-01,,Online Transfer,1240.61,0.00,3864430.18
8510,2023-06-01,2023-06-01,,Transfer Received,0.00,1923.32,3866353.50
8511,2023-06-01,2023-06-01,,Online Transfer,651.62,0.00,3865701.88
8512,2023-06-01,2023-06-01,,Dividend Received,0.00,361.29,3866063.17
8513,2023-06-01,2023-06-01,,ATM Withdrawal,431.48,0.00,3865631.69
8514,2023-06-02,2023-06-01,,Salary Credit,0.00,3761.01,3869392.70
8515,2023-06-01,2023-06-01,,Utility Payment,128.38,0.00,3869264.32
8516,2023-06-02,2023-06-02,,Transfer Received,0.00,596.09,3869860.41
8517,2023-06-03,2023-06-02,,Loan EMI,1755.17,0.00,3868105.24
8518,2023-06-03,2023-06-02,,Interest Credited,0.00,93.15,3868198.39
8519,2023-06-02,2023-06-02,,ATM Withdrawal,40.67,0.00,3868157.72
8520,2023-06-03,2023-06-02,,Takeout,25.57,0.00,3868132.15
8521,2023-06-01,2023-06-02,,Credit Card Payment,599.04,0.00,3867533.11
8522,2023-06-03,2023-06-02,,Salary Credit,0.00,4194.99,3871728.10
8523,2023-06-03,2023-06-02,,ATM Withdrawal,225.66,0.00,3871502.44
8524,2023-06-02,2023-06-03,,Rental Income,0.00,1050.94,3872553.38
8525,2023-06-03,2023-06-03,100208,Cheque Issued,2648.30,0.00,3869905.08
8526,2023-06-03,2023-06-03,,Credit Card Payment,218.72,0.00,3869686.36
8527,2023-06-04,2023-06-03,,Interest Credited,0.00,50.96,3869737.32
8528,2023-06-03,2023-06-03,,Transfer Received,0.00,2281.42,3872018.74
8529,2023-06-04,2023-06-04,,Transfer Received,0.00,807.84,3872826.58
8530,2023-06-05,2023-06-04,,Credit Card Payment,275.99,0.00,3872550.59
8531,2023-06-03,2023-06-04,,Salary Credit,0.00,2316.06,3874866.65
8532,2023-06-04,2023-06-04,,Groceries - Supermarket,143.41,0.00,3874723.24
8533,2023-06-04,2023-06-05,,ATM Withdrawal,366.13,0.00,3874357.11
8534,2023-06-05,2023-06-05,,Credit Card Payment,203.67,0.00,3874153.44
8535,2023-06-04,2023-06-05,,Salary Credit,0.00,2023.28,3876176.72
8536,2023-06-05,2023-06-05,,Interest Credited,0.00,47.46,3876224.18
8537,2023-06-05,2023-06-05,,Salary Credit,0.00,2447.75,3878671.93
8538,2023-06-05,2023-06-05,,Groceries - Supermarket,33.27,0.00,3878638.66
8539,2023-06-04,2023-06-05,,Cash Deposit,0.00,627.59,3879266.25
8540,2023-06-06,2023-06-05,,Takeout,16.10,0.00,3879250.15
8541,2023-06-05,2023-06-05,,Transfer Received,0.00,669.82,3879919.97
8542,2023-06-05,2023-06-05,,Dining Out,70.78,0.00,3879849.19
8543,2023-06-05,2023-06-05,,Salary Credit,0.00,3649.16,3883498.35
8544,2023-06-05,2023-06-05,,Interest Credited,0.00,31.52,3883529.87
8545,2023-06-06,2023-06-06,,Credit Card Payment,536.76,0.00,3882993.11
8546,2023-06-06,2023-06-06,,ATM Withdrawal,253.56,0.00,3882739.55
8547,2023-06-05,2023-06-06,,Interest Credited,0.00,66.22,3882805.77
8548,2023-06-06,2023-06-06,,Online Transfer,360.02,0.00,3882445.75
8549,2023-06-06,2023-06-06,,Groceries - Supermarket,94.59,0.00,3882351.16
8550,2023-06-06,2023-06-06,,Groceries - Supermarket,66.72,0.00,3882284.44
8551,2023-06-06,2023-06-06,,Cash Deposit,0.00,362.29,3882646.73
8552,2023-06-05,2023-06-06,,Transfer Received,0.00,1836.95,3884483.68
8553,2023-06-06,2023-06-06,,Salary Credit,0.00,4060.86,3888544.54
8554,2023-06-06,2023-06-06,,Interest Credited,0.00,35.92,3888580.46
8555,2023-06-06,2023-06-06,,Loan EMI,1563.32,0.00,3887017.14
8556,2023-06-06,2023-06-06,,Salary Credit,0.00,3478.81,3890495.95
8557,2023-06-07,2023-06-06,,Groceries - Online Delivery,62.37,0.00,3890433.58
8558,2023-06-06,2023-06-06,,Interest Credited,0.00,86.70,3890520.28
8559,2023-06-07,2023-06-07,,ATM Withdrawal,271.88,0.00,3890248.40
8560,2023-06-08,2023-06-07,,Interest Credited,0.00,55.36,3890303.76
8561,2023-06-07,2023-06-07,,Investment Returns,0.00,564.17,3890867.93
8562,2023-06-07,2023-06-07,,ATM Withdrawal,140.13,0.00,3890727.80
8563,2023-06-07,2023-06-07,,Salary Credit,0.00,3210.97,3893938.77
8564,2023-06-07,2023-06-07,,Online Transfer,374.59,0.00,3893564.18
8565,2023-06-07,2023-06-08,,Groceries - Supermarket,92.61,0.00,3893471.57
8566,2023-06-07,2023-06-08,,Utility Payment,267.02,0.00,3893204.55
8567,2023-06-07,2023-06-08,,Utility Payment,158.79,0.00,3893045.76
8568,2023-06-08,2023-06-08,,ATM Withdrawal,67.80,0.00,3892977.96
8569,2023-06-09,2023-06-08,,Salary Credit,0.00,4596.87,3897574.83
8570,2023-06-08,2023-06-08,,Investment Returns,0.00,213.78,3897788.61
8571,2023-06-09,2023-06-08,,Online Transfer,587.00,0.00,3897201.61
8572,2023-06-08,2023-06-08,,Salary Credit,0.00,3447.41,3900649.02
8573,2023-06-08,2023-06-09,,Dividend Received,0.00,248.01,3900897.03
8574,2023-06-09,2023-06-09,,Investment Returns,0.00,524.63,3901421.66
8575,2023-06-09,2023-06-09,,Credit Card Payment,980.59,0.00,3900441.07
8576,2023-06-08,2023-06-09,,Groceries - Supermarket,61.31,0.00,3900379.76
8577,2023-06-10,2023-06-09,,Transfer Received,0.00,568.55,3900948.31
8578,2023-06-09,2023-06-09,,Online Transfer,148.66,0.00,3900799.65
8579,2023-06-09,2023-06-09,,Salary Credit,0.00,2575.61,3903375.26
8580,2023-06-10,2023-06-10,,Transfer Received,0.00,2294.26,3905669.52
8581,2023-06-10,2023-06-10,,Interest Credited,0.00,15.22,3905684.74
8582,2023-06-10,2023-06-10,,Transfer Received,0.00,2979.65,3908664.39
8583,2023-06-10,2023-06-10,,Salary Credit,0.00,3934.35,3912598.74
8584,2023-06-10,2023-06-10,,Dividend Received,0.00,446.72,3913045.46
8585,2023-06-10,2023-06-10,,Transfer Received,0.00,2067.16,3915112.62
8586,2023-06-11,2023-06-11,,Daily Essentials,30.54,0.00,3915082.08
8587,2023-06-10,2023-06-11,,Groceries - Supermarket,124.50,0.00,3914957.58
8588,2023-06-12,2023-06-11,,Loan EMI,914.05,0.00,3914043.53
8589,2023-06-10,2023-06-11,,Online Transfer,1161.26,0.00,3912882.27
8590,2023-06-11,2023-06-11,,Utility Payment,91.02,0.00,3912791.25
8591,2023-06-12,2023-06-11,,Transfer Received,0.00,822.41,3913613.66
8592,2023-06-12,2023-06-11,,Salary Credit,0.00,4436.05,3918049.71
8593,2023-06-11,2023-06-11,,Groceries - Supermarket,157.86,0.00,3917891.85
8594,2023-06-11,2023-06-11,,Online Transfer,880.98,0.00,3917010.87
8595,2023-06-11,2023-06-12,,Loan EMI,1419.06,0.00,3915591.81
8596,2023-06-12,2023-06-12,,Groceries - Supermarket,180.36,0.00,3915411.45
8597,2023-06-12,2023-06-12,,Credit Card Payment,446.89,0.00,3914964.56
8598,2023-06-12,2023-06-12,,Groceries - Supermarket,129.36,0.00,3914835.20
8599,2023-06-12,2023-06-12,,Interest Credited,0.00,14.83,3914850.03
8600,2023-06-12,2023-06-12,,Takeout,22.72,0.00,3914827.31
8601,2023-06-13,2023-06-12,,Utility Payment,112.41,0.00,3914714.90
8602,2023-06-12,2023-06-12,,ATM Withdrawal,353.28,0.00,3914361.62
8603,2023-06-13,2023-06-13,,Takeout,22.01,0.00,3914339.61
8604,2023-06-14,2023-06-13,,Credit Card Payment,776.79,0.00,3913562.82
8605,2023-06-13,2023-06-13,,ATM Withdrawal,424.84,0.00,3913137.98
8606,2023-06-13,2023-06-13,,Transfer Received,0.00,2211.72,3915349.70
8607,2023-06-14,2023-06-13,,Online Transfer,391.33,0.00,3914958.37
8608,2023-06-14,2023-06-13,,Investment - Mutual Funds,2928.36,0.00,3912030.01
8609,2023-06-12,2023-06-13,,ATM Withdrawal,445.20,0.00,3911584.81
8610,2023-06-14,2023-06-13,,ATM Withdrawal,140.04,0.00,3911444.77
8611,2023-06-15,2023-06-14,,Coffee Shop,5.96,0.00,3911438.81
8612,2023-06-15,2023-06-14,,Investment - Mutual Funds,2201.10,0.00,3909237.71
8613,2023-06-14,2023-06-14,,Interest Credited,0.00,39.58,3909277.29
8614,2023-06-14,2023-06-14,,Transfer Received,0.00,1607.44,3910884.73
8615,2023-06-14,2023-06-14,,Salary Credit,0.00,4522.69,3915407.42
8616,2023-06-14,2023-06-14,100209,Cheque Issued,2897.83,0.00,3912509.59
8617,2023-06-15,2023-06-15,,Interest Credited,0.00,41.84,3912551.43
8618,2023-06-14,2023-06-15,,Credit Card Payment,731.38,0.00,3911820.05
8619,2023-06-15,2023-06-15,,Interest Credited,0.00,44.69,3911864.74
8620,2023-06-15,2023-06-15,,Transfer Received,0.00,812.82,3912677.56
8621,2023-06-15,2023-06-15,,Groceries - Supermarket,117.82,0.00,3912559.74
8622,2023-06-17,2023-06-16,,Salary Credit,0.00,2757.41,3915317.15
8623,2023-06-16,2023-06-16,,Daily Essentials,35.41,0.00,3915281.74
8624,2023-06-15,2023-06-16,,Interest Credited,0.00,20.26,3915302.00
8625,2023-06-15,2023-06-16,,Loan EMI,644.88,0.00,3914657.12
8626,2023-06-17,2023-06-16,,Transfer Received,0.00,2507.36,3917164.48
8627,2023-06-17,2023-06-16,,Salary Credit,0.00,4163.64,3921328.12
8628,2023-06-18,2023-06-17,,Daily Essentials,10.65,0.00,3921317.47
8629,2023-06-17,2023-06-17,,Credit Card Payment,237.73,0.00,3921079.74
8630,2023-06-17,2023-06-17,,Transfer Received,0.00,2952.78,3924032.52
8631,2023-06-16,2023-06-17,,Dining Out,10.92,0.00,3924021.60
8632,2023-06-17,2023-06-17,,Salary Credit,0.00,2457.88,3926479.48
8633,2023-06-17,2023-06-17,,Cash Deposit,0.00,176.92,3926656.40
8634,2023-06-16,2023-06-17,,Daily Essentials,30.69,0.00,3926625.71
8635,2023-06-17,2023-06-17,,Investment - Mutual Funds,1169.51,0.00,3925456.20
8636,2023-06-17,2023-06-17,,Dividend Received,0.00,398.56,3925854.76
8637,2023-06-18,2023-06-18,,Interest Credited,0.00,32.58,3925887.34
8638,2023-06-18,2023-06-18,,Salary Credit,0.00,3096.79,3928984.13
8639,2023-06-18,2023-06-18,,ATM Withdrawal,163.26,0.00,3928820.87
8640,2023-06-17,2023-06-18,,Investment Returns,0.00,158.06,3928978.93
8641,2023-06-18,2023-06-18,,Rental Income,0.00,1593.27,3930572.20
8642,2023-06-18,2023-06-18,,Transfer Received,0.00,717.74,3931289.94
8643,2023-06-18,2023-06-18,,ATM Withdrawal,248.91,0.00,3931041.03
8644,2023-06-18,2023-06-18,,Groceries - Supermarket,71.97,0.00,3930969.06
8645,2023-06-18,2023-06-18,,ATM Withdrawal,495.70,0.00,3930473.36
8646,2023-06-18,2023-06-18,,Transfer Received,0.00,2270.75,3932744.11
8647,2023-06-18,2023-06-18,,Transfer Received,0.00,2146.61,3934890.72
8648,2023-06-19,2023-06-19,,Dividend Received,0.00,366.61,3935257.33
8649,2023-06-19,2023-06-19,,Interest Credited,0.00,60.08,3935317.41
8650,2023-06-18,2023-06-19,,Transfer Received,0.00,1682.26,3936999.67
8651,2023-06-18,2023-06-19,,Transfer Received,0.00,2861.32,3939860.99
8652,2023-06-19,2023-06-19,,Credit Card Payment,610.13,0.00,3939250.86
8653,2023-06-18,2023-06-19,,Investment - Stocks,4056.68,0.00,3935194.18
8654,2023-06-19,2023-06-19,,Groceries - Supermarket,168.17,0.00,3935026.01
8655,2023-06-19,2023-06-19,,ATM Withdrawal,376.23,0.00,3934649.78
8656,2023-06-20,2023-06-19,,Investment Returns,0.00,648.18,3935297.96
8657,2023-06-20,2023-06-19,,Transfer Received,0.00,683.48,3935981.44
8658,2023-06-20,2023-06-20,,Salary Credit,0.00,3195.97,3939177.41
8659,2023-06-20,2023-06-20,,Transfer Received,0.00,2932.75,3942110.16
8660,2023-06-21,2023-06-20,,Online Transfer,1057.82,0.00,3941052.34
8661,2023-06-20,2023-06-20,,Transfer Received,0.00,513.96,3941566.30
8662,2023-06-19,2023-06-20,,Groceries - Online Delivery,71.31,0.00,3941494.99
8663,2023-06-20,2023-06-20,,Online Transfer,479.77,0.00,3941015.22
8664,2023-06-21,2023-06-21,,ATM Withdrawal,224.62,0.00,3940790.60
8665,2023-06-21,2023-06-21,,Utility Payment,190.88,0.00,3940599.72
8666,2023-06-21,2023-06-21,,ATM Withdrawal,287.20,0.00,3940312.52
8667,2023-06-21,2023-06-21,,Transfer Received,0.00,2572.69,3942885.21
8668,2023-06-22,2023-06-21,,Utility Payment,223.19,0.00,3942662.02
8669,2023-06-22,2023-06-21,,Transfer Received,0.00,1988.12,3944650.14
8670,2023-06-22,2023-06-21,,Dining Out,60.23,0.00,3944589.91
8671,2023-06-20,2023-06-21,,Daily Essentials,18.60,0.00,3944571.31
8672,2023-06-20,2023-06-21,,ATM Withdrawal,34.43,0.00,3944536.88
8673,2023-06-21,2023-06-22,,Dining Out,62.15,0.00,3944474.73
8674,2023-06-21,2023-06-22,,Online Transfer,1161.32,0.00,3943313.41
8675,2023-06-21,2023-06-22,,Online Transfer,1117.12,0.00,3942196.29
8676,2023-06-22,2023-06-22,,ATM Withdrawal,200.06,0.00,3941996.23
8677,2023-06-22,2023-06-22,,Transfer Received,0.00,2525.89,3944522.12
8678,2023-06-24,2023-06-23,,Investment - Mutual Funds,870.63,0.00,3943651.49
8679,2023-06-22,2023-06-23,,Dining Out,32.34,0.00,3943619.15
8680,2023-06-22,2023-06-23,,Loan EMI,1462.62,0.00,3942156.53
8681,2023-06-23,2023-06-23,,Salary Credit,0.00,2385.27,3944541.80
8682,2023-06-23,2023-06-23,,ATM Withdrawal,199.28,0.00,3944342.52
8683,2023-06-22,2023-06-23,,Investment - Mutual Funds,851.74,0.00,3943490.78
8684,2023-06-23,2023-06-23,,Cash Deposit,0.00,851.47,3944342.25
8685,2023-06-22,2023-06-23,,Interest Credited,0.00,91.58,3944433.83
8686,2023-06-23,2023-06-23,,Salary Credit,0.00,2910.06,3947343.89
8687,2023-06-23,2023-06-23,,Credit Card Payment,507.14,0.00,3946836.75
8688,2023-06-23,2023-06-23,,Credit Card Payment,333.09,0.00,3946503.66
8689,2023-06-24,2023-06-24,,ATM Withdrawal,424.25,0.00,3946079.41
8690,2023-06-23,2023-06-24,,Transfer Received,0.00,1554.82,3947634.23
8691,2023-06-24,2023-06-24,,Utility Payment,140.67,0.00,3947493.56
8692,2023-06-25,2023-06-24,100210,Cheque Issued,559.58,0.00,3946933.98
8693,2023-06-24,2023-06-24,,Investment - SIP,211.38,0.00,3946722.60
8694,2023-06-24,2023-06-24,,Online Transfer,1280.50,0.00,3945442.10
8695,2023-06-24,2023-06-24,,ATM Withdrawal,178.13,0.00,3945263.97
8696,2023-06-25,2023-06-24,,Online Transfer,900.42,0.00,3944363.55
8697,2023-06-25,2023-06-24,,ATM Withdrawal,373.84,0.00,3943989.71
8698,2023-06-24,2023-06-24,,Credit Card Payment,965.14,0.00,3943024.57
8699,2023-06-23,2023-06-24,,Transfer Received,0.00,927.11,3943951.68
8700,2023-06-24,2023-06-24,,Credit Card Payment,873.51,0.00,3943078.17
8701,2023-06-25,2023-06-24,,Utility Payment,134.62,0.00,3942943.55
8702,2023-06-24,2023-06-24,,Utility Payment,97.78,0.00,3942845.77
8703,2023-06-25,2023-06-24,,Online Transfer,876.98,0.00,3941968.79
8704,2023-06-25,2023-06-25,,Utility Payment,91.28,0.00,3941877.51
8705,2023-06-26,2023-06-25,,Credit Card Payment,353.45,0.00,3941524.06
8706,2023-06-26,2023-06-25,,Transfer Received,0.00,2853.12,3944377.18
8707,2023-06-25,2023-06-25,100211,Cheque Issued,2602.97,0.00,3941774.21
8708,2023-06-26,2023-06-25,,Transfer Received,0.00,2156.93,3943931.14
8709,2023-06-25,2023-06-25,,Groceries - Supermarket,182.25,0.00,3943748.89
8710,2023-06-25,2023-06-25,,ATM Withdrawal,209.44,0.00,3943539.45
8711,2023-06-25,2023-06-25,,Transfer Received,0.00,578.08,3944117.53
8712,2023-06-25,2023-06-25,,ATM Withdrawal,117.65,0.00,3943999.88
8713,2023-06-25,2023-06-25,,Groceries - Supermarket,142.30,0.00,3943857.58
8714,2023-06-24,2023-06-25,,Groceries - Online Delivery,91.52,0.00,3943766.06
8715,2023-06-25,2023-06-25,,ATM Withdrawal,437.07,0.00,3943328.99
8716,2023-06-25,2023-06-25,,Cash Deposit,0.00,653.67,3943982.66
8717,2023-06-25,2023-06-25,,Transfer Received,0.00,1515.40,3945498.06
8718,2023-06-25,2023-06-25,,Credit Card Payment,718.42,0.00,3944779.64
8719,2023-06-24,2023-06-25,,Interest Credited,0.00,29.70,3944809.34
8720,2023-06-26,2023-06-26,,Investment - SIP,289.01,0.00,3944520.33
8721,2023-06-26,2023-06-26,,Salary Credit,0.00,3116.78,3947637.11
8722,2023-06-26,2023-06-27,100212,Cheque Issued,630.00,0.00,3947007.11
8723,2023-06-28,2023-06-27,,Dining Out,16.48,0.00,3946990.63
8724,2023-06-26,2023-06-27,,Credit Card Payment,623.11,0.00,3946367.52
8725,2023-06-26,2023-06-27,,Online Transfer,1434.82,0.00,3944932.70
8726,2023-06-27,2023-06-27,,ATM Withdrawal,143.62,0.00,3944789.08
8727,2023-06-29,2023-06-28,,Loan EMI,1118.56,0.00,3943670.52
8728,2023-06-28,2023-06-28,,ATM Withdrawal,310.51,0.00,3943360.01
8729,2023-06-28,2023-06-28,,Credit Card Payment,415.78,0.00,3942944.23
8730,2023-06-27,2023-06-28,,Transfer Received,0.00,774.57,3943718.80
8731,2023-06-28,2023-06-29,,Loan EMI,1368.26,0.00,3942350.54
8732,2023-06-29,2023-06-29,100213,Cheque Issued,989.85,0.00,3941360.69
8733,2023-06-29,2023-06-29,,Salary Credit,0.00,3699.35,3945060.04
8734,2023-06-30,2023-06-30,,Transfer Received,0.00,732.95,3945792.99
8735,2023-07-01,2023-06-30,,Online Transfer,230.27,0.00,3945562.72
8736,2023-06-30,2023-06-30,,ATM Withdrawal,196.19,0.00,3945366.53
8737,2023-06-30,2023-06-30,,Salary Credit,0.00,3710.21,3949076.74
8738,2023-06-29,2023-06-30,,ATM Withdrawal,404.21,0.00,3948672.53
8739,2023-06-30,2023-06-30,,Dining Out,28.62,0.00,3948643.91
8740,2023-06-30,2023-06-30,,ATM Withdrawal,55.73,0.00,3948588.18
8741,2023-06-30,2023-06-30,,Transfer Received,0.00,2031.40,3950619.58
8742,2023-07-01,2023-07-01,,Cash Deposit,0.00,935.24,3951554.82
8743,2023-07-01,2023-07-01,,Investment - SIP,958.46,0.00,3950596.36
8744,2023-07-01,2023-07-01,,Online Transfer,646.39,0.00,3949949.97
8745,2023-07-01,2023-07-01,100214,Cheque Issued,1776.89,0.00,3948173.08
8746,2023-07-01,2023-07-01,,ATM Withdrawal,157.82,0.00,3948015.26
8747,2023-06-30,2023-07-01,,Transfer Received,0.00,1026.49,3949041.75
8748,2023-07-01,2023-07-01,,Transfer Received,0.00,1466.80,3950508.55
8749,2023-07-01,2023-07-01,,Rental Income,0.00,1462.45,3951971.00
8750,2023-07-01,2023-07-02,,Online Transfer,271.08,0.00,3951699.92
8751,2023-07-02,2023-07-02,,Online Transfer,1056.02,0.00,3950643.90
8752,2023-07-02,2023-07-02,,Transfer Received,0.00,2425.05,3953068.95
8753,2023-07-02,2023-07-02,,Credit Card Payment,893.89,0.00,3952175.06
8754,2023-07-02,2023-07-02,,ATM Withdrawal,346.76,0.00,3951828.30
8755,2023-07-03,2023-07-03,,Transfer Received,0.00,1672.88,3953501.18
8756,2023-07-03,2023-07-03,,Groceries - Online Delivery,149.67,0.00,3953351.51
8757,2023-07-02,2023-07-03,,Online Transfer,1482.74,0.00,3951868.77
8758,2023-07-04,2023-07-03,,Loan EMI,1074.98,0.00,3950793.79
8759,2023-07-03,2023-07-03,,Salary Credit,0.00,3242.11,3954035.90
8760,2023-07-03,2023-07-03,,Transfer Received,0.00,1535.70,3955571.60
8761,2023-07-03,2023-07-03,,Groceries - Online Delivery,146.16,0.00,3955425.44
8762,2023-07-03,2023-07-03,,Takeout,32.35,0.00,3955393.09
8763,2023-07-03,2023-07-03,,ATM Withdrawal,394.66,0.00,3954998.43
8764,2023-07-05,2023-07-04,,Salary Credit,0.00,4603.22,3959601.65
8765,2023-07-04,2023-07-04,,Groceries - Supermarket,161.96,0.00,3959439.69
8766,2023-07-03,2023-07-04,,Cash Deposit,0.00,484.15,3959923.84
8767,2023-07-04,2023-07-04,,ATM Withdrawal,167.65,0.00,3959756.19
8768,2023-07-03,2023-07-04,,Salary Credit,0.00,3298.81,3963055.00
8769,2023-07-05,2023-07-05,,ATM Withdrawal,197.48,0.00,3962857.52
8770,2023-07-04,2023-07-05,,ATM Withdrawal,71.83,0.00,3962785.69
8771,2023-07-05,2023-07-05,,Salary Credit,0.00,2730.27,3965515.96
8772,2023-07-06,2023-07-06,,Groceries - Supermarket,100.44,0.00,3965415.52
8773,2023-07-07,2023-07-06,,Transfer Received,0.00,574.32,3965989.84
8774,2023-07-06,2023-07-06,,Daily Essentials,43.31,0.00,3965946.53
8775,2023-07-06,2023-07-06,,Salary Credit,0.00,3901.11,3969847.64
8776,2023-07-07,2023-07-06,,Salary Credit,0.00,2735.90,3972583.54
8777,2023-07-05,2023-07-06,,Interest Credited,0.00,92.08,3972675.62
8778,2023-07-07,2023-07-06,,Interest Credited,0.00,11.88,3972687.50
8779,2023-07-06,2023-07-06,,Online Transfer,1662.17,0.00,3971025.33
8780,2023-07-06,2023-07-07,,Groceries - Supermarket,67.70,0.00,3970957.63
8781,2023-07-07,2023-07-07,,Loan EMI,1589.57,0.00,3969368.06
8782,2023-07-07,2023-07-07,,Dividend Received,0.00,227.11,3969595.17
8783,2023-07-08,2023-07-07,,Cash Deposit,0.00,277.62,3969872.79
8784,2023-07-07,2023-07-07,,Online Transfer,1873.73,0.00,3967999.06
8785,2023-07-07,2023-07-07,,Interest Credited,0.00,54.36,3968053.42
8786,2023-07-06,2023-07-07,,Online Transfer,1561.01,0.00,3966492.41
8787,2023-07-07,2023-07-07,,Utility Payment,267.26,0.00,3966225.15
8788,2023-07-07,2023-07-07,,Transfer Received,0.00,2815.61,3969040.76
8789,2023-07-07,2023-07-08,,Groceries - Supermarket,132.14,0.00,3968908.62
8790,2023-07-08,2023-07-08,,Transfer Received,0.00,2797.63,3971706.25
8791,2023-07-09,2023-07-08,,ATM Withdrawal,313.57,0.00,3971392.68
8792,2023-07-08,2023-07-08,,ATM Withdrawal,192.56,0.00,3971200.12
8793,2023-07-09,2023-07-09,,Salary Credit,0.00,3256.55,3974456.67
8794,2023-07-09,2023-07-09,,Takeout,49.83,0.00,3974406.84
8795,2023-07-08,2023-07-09,,Salary Credit,0.00,4547.38,3978954.22
8796,2023-07-09,2023-07-09,,ATM Withdrawal,24.08,0.00,3978930.14
8797,2023-07-09,2023-07-09,,Groceries - Supermarket,88.10,0.00,3978842.04
8798,2023-07-08,2023-07-09,,ATM Withdrawal,145.67,0.00,3978696.37
8799,2023-07-10,2023-07-10,100215,Cheque Issued,1310.68,0.00,3977385.69
8800,2023-07-10,2023-07-10,,Salary Credit,0.00,4924.63,3982310.32
8801,2023-07-11,2023-07-10,,Transfer Received,0.00,1320.39,3983630.71
8802,2023-07-10,2023-07-10,,Transfer Received,0.00,2141.97,3985772.68
8803,2023-07-10,2023-07-10,,Transfer Received,0.00,2845.52,3988618.20
8804,2023-07-10,2023-07-10,,Groceries - Supermarket,155.82,0.00,3988462.38
8805,2023-07-11,2023-07-11,,Online Transfer,151.41,0.00,3988310.97
8806,2023-07-11,2023-07-11,,Transfer Received,0.00,2751.27,3991062.24
8807,2023-07-12,2023-07-11,,Investment - SIP,329.18,0.00,3990733.06
8808,2023-07-10,2023-07-11,,Salary Credit,0.00,2840.28,3993573.34
8809,2023-07-12,2023-07-11,,Loan EMI,685.04,0.00,3992888.30
8810,2023-07-11,2023-07-11,,Utility Payment,221.23,0.00,3992667.07
8811,2023-07-12,2023-07-12,,Utility Payment,98.16,0.00,3992568.91
8812,2023-07-12,2023-07-12,,Loan EMI,1353.56,0.00,3991215.35
8813,2023-07-12,2023-07-12,100216,Cheque Issued,1457.98,0.00,3989757.37
8814,2023-07-12,2023-07-12,,Groceries - Supermarket,166.76,0.00,3989590.61
8815,2023-07-12,2023-07-13,,Salary Credit,0.00,2201.49,3991792.10
8816,2023-07-13,2023-07-13,,Utility Payment,162.61,0.00,3991629.49
8817,2023-07-13,2023-07-13,,ATM Withdrawal,269.31,0.00,3991360.18
8818,2023-07-13,2023-07-13,,Transfer Received,0.00,2896.50,3994256.68
8819,2023-07-12,2023-07-13,,Groceries - Supermarket,92.97,0.00,3994163.71
8820,2023-07-14,2023-07-14,,Online Transfer,258.15,0.00,3993905.56
8821,2023-07-14,2023-07-14,,Interest Credited,0.00,33.85,3993939.41
8822,2023-07-13,2023-07-14,,Credit Card Payment,947.87,0.00,3992991.54
8823,2023-07-14,2023-07-14,,ATM Withdrawal,181.49,0.00,3992810.05
8824,2023-07-15,2023-07-14,,Rental Income,0.00,2893.57,3995703.62
8825,2023-07-14,2023-07-14,,Credit Card Payment,962.38,0.00,3994741.24
8826,2023-07-15,2023-07-15,,Takeout,27.92,0.00,3994713.32
8827,2023-07-16,2023-07-15,,Credit Card Payment,244.47,0.00,3994468.85
8828,2023-07-15,2023-07-15,,Credit Card Payment,232.39,0.00,3994236.46
8829,2023-07-15,2023-07-15,,Dividend Received,0.00,311.59,3994548.05
8830,2023-07-15,2023-07-15,,Groceries - Supermarket,105.42,0.00,3994442.63
8831,2023-07-15,2023-07-15,,ATM Withdrawal,110.25,0.00,3994332.38
8832,2023-07-15,2023-07-15,,ATM Withdrawal,287.69,0.00,3994044.69
8833,2023-07-15,2023-07-15,,Salary Credit,0.00,3692.50,3997737.19
8834,2023-07-16,2023-07-16,,Utility Payment,59.21,0.00,3997677.98
8835,2023-07-16,2023-07-16,,Transfer Received,0.00,1676.93,3999354.91
8836,2023-07-16,2023-07-16,,Loan EMI,1644.32,0.00,3997710.59
8837,2023-07-16,2023-07-16,,Groceries - Supermarket,78.26,0.00,3997632.33
8838,2023-07-16,2023-07-16,,ATM Withdrawal,87.18,0.00,3997545.15
8839,2023-07-17,2023-07-17,,Credit Card Payment,408.01,0.00,3997137.14
8840,2023-07-17,2023-07-17,,Salary Credit,0.00,4407.72,4001544.86
8841,2023-07-17,2023-07-17,,Salary Credit,0.00,4702.69,4006247.55
8842,2023-07-16,2023-07-17,,Coffee Shop,5.75,0.00,4006241.80
8843,2023-07-17,2023-07-17,,Interest Credited,0.00,75.70,4006317.50
8844,2023-07-19,2023-07-18,,Transfer Received,0.00,1740.71,4008058.21
8845,2023-07-18,2023-07-18,,Salary Credit,0.00,2343.18,4010401.39
8846,2023-07-18,2023-07-18,,Groceries - Supermarket,167.31,0.00,4010234.08
8847,2023-07-18,2023-07-18,,Groceries - Supermarket,189.53,0.00,4010044.55
8848,2023-07-18,2023-07-18,,Salary Credit,0.00,4006.50,4014051.05
8849,2023-07-18,2023-07-18,,Cash Deposit,0.00,298.48,4014349.53
8850,2023-07-19,2023-07-19,,Groceries - Supermarket,159.07,0.00,4014190.46
8851,2023-07-19,2023-07-19,,Online Transfer,1130.41,0.00,4013060.05
8852,2023-07-20,2023-07-19,,Rental Income,0.00,1877.69,4014937.74
8853,2023-07-20,2023-07-19,,Salary Credit,0.00,2022.30,4016960.04
8854,2023-07-20,2023-07-20,,Utility Payment,240.12,0.00,4016719.92
8855,2023-07-19,2023-07-20,,Transfer Received,0.00,2244.12,4018964.04
8856,2023-07-20,2023-07-20,,Cash Deposit,0.00,266.39,4019230.43
8857,2023-07-20,2023-07-20,,Loan EMI,967.18,0.00,4018263.25
8858,2023-07-20,2023-07-21,,Groceries - Supermarket,172.36,0.00,4018090.89
8859,2023-07-22,2023-07-21,,Credit Card Payment,459.49,0.00,4017631.40
8860,2023-07-21,2023-07-21,,Online Transfer,1556.83,0.00,4016074.57
8861,2023-07-20,2023-07-21,,Transfer Received,0.00,555.70,4016630.27
8862,2023-07-21,2023-07-21,,Salary Credit,0.00,3443.46,4020073.73
8863,2023-07-21,2023-07-21,,Transfer Received,0.00,2259.43,4022333.16
8864,2023-07-22,2023-07-21,,Online Transfer,1324.08,0.00,4021009.08
8865,2023-07-20,2023-07-21,,Salary Credit,0.00,4797.81,4025806.89
8866,2023-07-21,2023-07-21,,Salary Credit,0.00,2562.41,4028369.30
8867,2023-07-21,2023-07-21,,Groceries - Online Delivery,93.45,0.00,4028275.85
8868,2023-07-23,2023-07-22,,Loan EMI,1057.57,0.00,4027218.28
8869,2023-07-22,2023-07-22,,Salary Credit,0.00,3580.52,4030798.80
8870,2023-07-22,2023-07-22,,Cash Deposit,0.00,550.15,4031348.95
8871,2023-07-22,2023-07-22,,Transfer Received,0.00,2125.07,4033474.02
8872,2023-07-23,2023-07-22,,Salary Credit,0.00,3812.21,4037286.23
8873,2023-07-22,2023-07-23,,ATM Withdrawal,373.94,0.00,4036912.29
8874,2023-07-23,2023-07-23,,ATM Withdrawal,296.56,0.00,4036615.73
8875,2023-07-22,2023-07-23,,Transfer Received,0.00,1405.78,4038021.51
8876,2023-07-23,2023-07-23,,Groceries - Supermarket,190.12,0.00,4037831.39
8877,2023-07-22,2023-07-23,,ATM Withdrawal,56.57,0.00,4037774.82
8878,2023-07-24,2023-07-24,,Salary Credit,0.00,3055.47,4040830.29
8879,2023-07-25,2023-07-24,,Transfer Received,0.00,541.18,4041371.47
8880,2023-07-24,2023-07-24,,Groceries - Supermarket,106.84,0.00,4041264.63
8881,2023-07-23,2023-07-24,,Online Transfer,1637.57,0.00,4039627.06
8882,2023-07-24,2023-07-24,,Groceries - Online Delivery,124.42,0.00,4039502.64
8883,2023-07-25,2023-07-24,,Utility Payment,181.62,0.00,4039321.02
8884,2023-07-25,2023-07-24,,Dining Out,31.52,0.00,4039289.50
8885,2023-07-23,2023-07-24,,Credit Card Payment,795.10,0.00,4038494.40
8886,2023-07-25,2023-07-24,,Groceries - Supermarket,82.49,0.00,4038411.91
8887,2023-07-24,2023-07-25,,Investment - SIP,187.22,0.00,4038224.69
8888,2023-07-25,2023-07-25,,Transfer Received,0.00,2986.68,4041211.37
8889,2023-07-26,2023-07-25,,Dining Out,54.18,0.00,4041157.19
8890,2023-07-25,2023-07-25,,Takeout,39.54,0.00,4041117.65
8891,2023-07-25,2023-07-26,,Groceries - Online Delivery,124.02,0.00,4040993.63
8892,2023-07-26,2023-07-26,,Coffee Shop,14.46,0.00,4040979.17
8893,2023-07-26,2023-07-26,,Dining Out,46.51,0.00,4040932.66
8894,2023-07-26,2023-07-26,,Credit Card Payment,454.85,0.00,4040477.81
8895,2023-07-26,2023-07-26,,Transfer Received,0.00,1101.35,4041579.16
8896,2023-07-26,2023-07-26,,Transfer Received,0.00,2696.88,4044276.04
8897,2023-07-25,2023-07-26,100217,Cheque Issued,828.91,0.00,4043447.13
8898,2023-07-26,2023-07-26,,Transfer Received,0.00,2779.34,4046226.47
8899,2023-07-27,2023-07-27,,Credit Card Payment,735.56,0.00,4045490.91
8900,2023-07-27,2023-07-27,,ATM Withdrawal,177.77,0.00,4045313.14
8901,2023-07-27,2023-07-27,,Salary Credit,0.00,2648.15,4047961.29
8902,2023-07-26,2023-07-27,,Salary Credit,0.00,2211.53,4050172.82
8903,2023-07-27,2023-07-27,,ATM Withdrawal,233.04,0.00,4049939.78
8904,2023-07-26,2023-07-27,,Transfer Received,0.00,1132.37,4051072.15
8905,2023-07-27,2023-07-27,,Takeout,32.58,0.00,4051039.57
8906,2023-07-27,2023-07-27,100218,Cheque Issued,1804.96,0.00,4049234.61
8907,2023-07-27,2023-07-27,,Loan EMI,1115.05,0.00,4048119.56
8908,2023-07-27,2023-07-28,,Interest Credited,0.00,34.30,4048153.86
8909,2023-07-28,2023-07-28,,ATM Withdrawal,278.27,0.00,4047875.59
8910,2023-07-28,2023-07-28,,Transfer Received,0.00,2522.54,4050398.13
8911,2023-07-28,2023-07-28,,Loan EMI,807.44,0.00,4049590.69
8912,2023-07-28,2023-07-28,,ATM Withdrawal,255.74,0.00,4049334.95
8913,2023-07-29,2023-07-28,,Cash Deposit,0.00,647.11,4049982.06
8914,2023-07-28,2023-07-28,,Salary Credit,0.00,4251.12,4054233.18
8915,2023-07-29,2023-07-29,,Transfer Received,0.00,1801.59,4056034.77
8916,2023-07-29,2023-07-29,,Groceries - Supermarket,47.40,0.00,4055987.37
8917,2023-07-29,2023-07-29,,ATM Withdrawal,69.63,0.00,4055917.74
8918,2023-07-29,2023-07-29,,Dividend Received,0.00,163.05,4056080.79
8919,2023-07-29,2023-07-29,,Coffee Shop,18.64,0.00,4056062.15
8920,2023-07-29,2023-07-29,,Daily Essentials,26.30,0.00,4056035.85
8921,2023-07-30,2023-07-30,,ATM Withdrawal,445.87,0.00,4055589.98
8922,2023-07-30,2023-07-30,,Cash Deposit,0.00,772.16,4056362.14
8923,2023-07-30,2023-07-30,,Online Transfer,543.81,0.00,4055818.33
8924,2023-07-30,2023-07-30,,Credit Card Payment,295.47,0.00,4055522.86
8925,2023-07-30,2023-07-30,,Groceries - Online Delivery,115.48,0.00,4055407.38
8926,2023-07-30,2023-07-30,,ATM Withdrawal,217.21,0.00,4055190.17
8927,2023-07-31,2023-07-31,,Rental Income,0.00,2199.08,4057389.25
8928,2023-08-01,2023-08-01,,Utility Payment,145.91,0.00,4057243.34
8929,2023-08-01,2023-08-01,,Cash Deposit,0.00,716.00,4057959.34
8930,2023-08-01,2023-08-01,,Transfer Received,0.00,2689.43,4060648.77
8931,2023-07-31,2023-08-01,,Utility Payment,227.74,0.00,4060421.03
8932,2023-07-31,2023-08-01,,Credit Card Payment,401.27,0.00,4060019.76
8933,2023-08-02,2023-08-01,,Online Transfer,369.94,0.00,4059649.82
8934,2023-07-31,2023-08-01,,Utility Payment,103.79,0.00,4059546.03
8935,2023-08-02,2023-08-02,,Groceries - Supermarket,61.30,0.00,4059484.73
8936,2023-08-02,2023-08-02,,Cash Deposit,0.00,705.05,4060189.78
8937,2023-08-02,2023-08-02,,Groceries - Supermarket,28.73,0.00,4060161.05
8938,2023-08-02,2023-08-02,,Transfer Received,0.00,1173.12,4061334.17
8939,2023-08-02,2023-08-02,,Rental Income,0.00,1735.79,4063069.96
8940,2023-08-02,2023-08-02,,Groceries - Online Delivery,62.78,0.00,4063007.18
8941,2023-08-02,2023-08-02,,Investment - Stocks,3133.61,0.00,4059873.57
8942,2023-08-02,2023-08-02,,ATM Withdrawal,415.97,0.00,4059457.60
8943,2023-08-02,2023-08-02,,Transfer Received,0.00,2722.25,4062179.85
8944,2023-08-03,2023-08-02,,Transfer Received,0.00,2937.51,4065117.36
8945,2023-08-02,2023-08-03,,ATM Withdrawal,369.97,0.00,4064747.39
8946,2023-08-03,2023-08-03,,Coffee Shop,11.52,0.00,4064735.87
8947,2023-08-03,2023-08-03,,Utility Payment,123.55,0.00,4064612.32
8948,2023-08-02,2023-08-03,,Transfer Received,0.00,1571.92,4066184.24
8949,2023-08-03,2023-08-03,,Salary Credit,0.00,4937.33,4071121.57
8950,2023-08-02,2023-08-03,,Groceries - Online Delivery,52.77,0.00,4071068.80
8951,2023-08-04,2023-08-03,,Online Transfer,854.08,0.00,4070214.72
8952,2023-08-03,2023-08-04,,Online Transfer,249.20,0.00,4069965.52
8953,2023-08-04,2023-08-04,,Groceries - Supermarket,149.76,0.00,4069815.76
8954,2023-08-05,2023-08-04,,Cash Deposit,0.00,173.79,4069989.55
8955,2023-08-05,2023-08-04,,Transfer Received,0.00,1332.94,4071322.49
8956,2023-08-04,2023-08-04,,Interest Credited,0.00,78.35,4071400.84
8957,2023-08-04,2023-08-04,,ATM Withdrawal,118.29,0.00,4071282.55
8958,2023-08-04,2023-08-04,,Credit Card Payment,781.51,0.00,4070501.04
8959,2023-08-05,2023-08-05,,ATM Withdrawal,461.40,0.00,4070039.64
8960,2023-08-04,2023-08-05,,Takeout,48.87,0.00,4069990.77
8961,2023-08-05,2023-08-05,,Online Transfer,1875.95,0.00,4068114.82
8962,2023-08-05,2023-08-05,,Investment - SIP,110.52,0.00,4068004.30
8963,2023-08-05,2023-08-05,,Transfer Received,0.00,1206.41,4069210.71
8964,2023-08-05,2023-08-05,,Groceries - Online Delivery,93.67,0.00,4069117.04
8965,2023-08-06,2023-08-06,,Dining Out,34.71,0.00,4069082.33
8966,2023-08-06,2023-08-06,,ATM Withdrawal,129.54,0.00,4068952.79
8967,2023-08-06,2023-08-06,,Online Transfer,1155.74,0.00,4067797.05
8968,2023-08-07,2023-08-06,,ATM Withdrawal,429.09,0.00,4067367.96
8969,2023-08-06,2023-08-06,,Transfer Received,0.00,2096.47,4069464.43
8970,2023-08-06,2023-08-06,,Dining Out,25.42,0.00,4069439.01
8971,2023-08-06,2023-08-06,,ATM Withdrawal,482.40,0.00,4068956.61
8972,2023-08-06,2023-08-06,,ATM Withdrawal,113.74,0.00,4068842.87
8973,2023-08-06,2023-08-06,,ATM Withdrawal,463.78,0.00,4068379.09
8974,2023-08-06,2023-08-06,,Online Transfer,1760.07,0.00,4066619.02
8975,2023-08-07,2023-08-07,,Salary Credit,0.00,2369.22,4068988.24
8976,2023-08-06,2023-08-07,,Groceries - Supermarket,130.74,0.00,4068857.50
8977,2023-08-07,2023-08-07,,Interest Credited,0.00,93.42,4068950.92
8978,2023-08-07,2023-08-07,,Transfer Received,0.00,1860.57,4070811.49
8979,2023-08-07,2023-08-07,,ATM Withdrawal,223.76,0.00,4070587.73
8980,2023-08-07,2023-08-07,,Transfer Received,0.00,2127.49,4072715.22
8981,2023-08-07,2023-08-07,,Groceries - Supermarket,166.56,0.00,4072548.66
8982,2023-08-08,2023-08-08,,Transfer Received,0.00,1763.33,4074311.99
8983,2023-08-08,2023-08-08,,Transfer Received,0.00,2034.13,4076346.12
8984,2023-08-08,2023-08-08,,Groceries - Supermarket,150.95,0.00,4076195.17
8985,2023-08-08,2023-08-08,,Transfer Received,0.00,1548.67,4077743.84
8986,2023-08-09,2023-08-08,,Groceries - Supermarket,199.76,0.00,4077544.08
8987,2023-08-07,2023-08-08,,Online Transfer,583.09,0.00,4076960.99
8988,2023-08-08,2023-08-08,,Transfer Received,0.00,2248.30,4079209.29
8989,2023-08-09,2023-08-09,,ATM Withdrawal,247.20,0.00,4078962.09
8990,2023-08-09,2023-08-09,,Online Transfer,499.49,0.00,4078462.60
8991,2023-08-08,2023-08-09,,ATM Withdrawal,494.03,0.00,4077968.57
8992,2023-08-09,2023-08-09,,Investment - Mutual Funds,1065.57,0.00,4076903.00
8993,2023-08-08,2023-08-09,,Transfer Received,0.00,1194.44,4078097.44
8994,2023-08-10,2023-08-09,,Transfer Received,0.00,2021.08,4080118.52
8995,2023-08-09,2023-08-09,,Transfer Received,0.00,1581.50,4081700.02
8996,2023-08-08,2023-08-09,,Cash Deposit,0.00,774.64,4082474.66
8997,2023-08-09,2023-08-09,,Transfer Received,0.00,1915.96,4084390.62
8998,2023-08-10,2023-08-10,,Transfer Received,0.00,1214.34,4085604.96
8999,2023-08-10,2023-08-10,,Transfer Received,0.00,2072.50,4087677.46
9000,2023-08-09,2023-08-10,,Online Transfer,1008.07,0.00,4086669.39
9001,2023-08-10,2023-08-10,,Interest Credited,0.00,44.62,4086714.01
9002,2023-08-09,2023-08-10,,Dining Out,89.30,0.00,4086624.71
9003,2023-08-11,2023-08-11,,Coffee Shop,19.84,0.00,4086604.87
9004,2023-08-11,2023-08-11,,Transfer Received,0.00,1808.87,4088413.74
9005,2023-08-11,2023-08-11,,Transfer Received,0.00,990.49,4089404.23
9006,2023-08-11,2023-08-11,,Online Transfer,1066.89,0.00,4088337.34
9007,2023-08-10,2023-08-11,,Online Transfer,1504.50,0.00,4086832.84
9008,2023-08-11,2023-08-11,,Interest Credited,0.00,76.53,4086909.37
9009,2023-08-12,2023-08-11,,Groceries - Supermarket,113.53,0.00,4086795.84
9010,2023-08-12,2023-08-12,,ATM Withdrawal,171.14,0.00,4086624.70
9011,2023-08-12,2023-08-12,,Transfer Received,0.00,1797.45,4088422.15
9012,2023-08-12,2023-08-12,,Transfer Received,0.00,543.54,4088965.69
9013,2023-08-11,2023-08-12,,Salary Credit,0.00,3727.99,4092693.68
9014,2023-08-12,2023-08-12,100219,Cheque Issued,2779.32,0.00,4089914.36
9015,2023-08-12,2023-08-12,,Salary Credit,0.00,4919.71,4094834.07
9016,2023-08-12,2023-08-12,,Investment Returns,0.00,821.66,4095655.73
9017,2023-08-12,2023-08-12,,Interest Credited,0.00,72.70,4095728.43
9018,2023-08-13,2023-08-13,,ATM Withdrawal,31.81,0.00,4095696.62
9019,2023-08-14,2023-08-13,,Groceries - Online Delivery,77.46,0.00,4095619.16
9020,2023-08-14,2023-08-13,,Groceries - Online Delivery,99.31,0.00,4095519.85
9021,2023-08-13,2023-08-13,,Daily Essentials,30.06,0.00,4095489.79
9022,2023-08-14,2023-08-13,,Investment Returns,0.00,140.76,4095630.55
9023,2023-08-13,2023-08-13,,Online Transfer,686.92,0.00,4094943.63
9024,2023-08-13,2023-08-13,100220,Cheque Issued,2573.20,0.00,4092370.43
9025,2023-08-13,2023-08-13,,ATM Withdrawal,309.75,0.00,4092060.68
9026,2023-08-13,2023-08-13,,ATM Withdrawal,493.88,0.00,4091566.80
9027,2023-08-14,2023-08-13,,Salary Credit,0.00,3310.54,4094877.34
9028,2023-08-14,2023-08-14,,Transfer Received,0.00,2654.21,4097531.55
9029,2023-08-14,2023-08-14,,ATM Withdrawal,336.24,0.00,4097195.31
9030,2023-08-14,2023-08-14,,Loan EMI,1468.80,0.00,4095726.51
9031,2023-08-14,2023-08-14,,Groceries - Supermarket,106.09,0.00,4095620.42
9032,2023-08-14,2023-08-14,,Transfer Received,0.00,1036.19,4096656.61
9033,2023-08-14,2023-08-14,,Transfer Received,0.00,1091.81,4097748.42
9034,2023-08-14,2023-08-14,,Transfer Received,0.00,2203.88,4099952.30
9035,2023-08-14,2023-08-14,,Groceries - Supermarket,145.76,0.00,4099806.54
9036,2023-08-15,2023-08-15,,ATM Withdrawal,21.33,0.00,4099785.21
9037,2023-08-15,2023-08-15,,Salary Credit,0.00,4502.31,4104287.52
9038,2023-08-15,2023-08-15,,Dining Out,83.91,0.00,4104203.61
9039,2023-08-16,2023-08-15,,Transfer Received,0.00,640.10,4104843.71
9040,2023-08-15,2023-08-15,,Salary Credit,0.00,4473.51,4109317.22
9041,2023-08-16,2023-08-15,,Loan EMI,700.72,0.00,4108616.50
9042,2023-08-14,2023-08-15,,Salary Credit,0.00,2319.37,4110935.87
9043,2023-08-16,2023-08-15,,Groceries - Supermarket,89.41,0.00,4110846.46
9044,2023-08-16,2023-08-16,,Transfer Received,0.00,2910.91,4113757.37
9045,2023-08-16,2023-08-16,100221,Cheque Issued,2675.60,0.00,4111081.77
9046,2023-08-17,2023-08-16,,ATM Withdrawal,400.08,0.00,4110681.69
9047,2023-08-16,2023-08-16,,Transfer Received,0.00,1766.75,4112448.44
9048,2023-08-16,2023-08-16,,ATM Withdrawal,358.30,0.00,4112090.14
9049,2023-08-15,2023-08-16,,Utility Payment,228.18,0.00,4111861.96
9050,2023-08-17,2023-08-16,,Online Transfer,1254.07,0.00,4110607.89
9051,2023-08-17,2023-08-16,,Salary Credit,0.00,2377.65,4112985.54
9052,2023-08-16,2023-08-16,,Salary Credit,0.00,3713.06,4116698.60
9053,2023-08-16,2023-08-16,,Salary Credit,0.00,4491.12,4121189.72
9054,2023-08-16,2023-08-16,,Dividend Received,0.00,346.14,4121535.86
9055,2023-08-16,2023-08-16,,Dividend Received,0.00,224.63,4121760.49
9056,2023-08-18,2023-08-17,,Investment Returns,0.00,342.90,4122103.39
9057,2023-08-18,2023-08-17,,Groceries - Supermarket,117.84,0.00,4121985.55
9058,2023-08-17,2023-08-17,,Rental Income,0.00,1231.46,4123217.01
9059,2023-08-16,2023-08-17,,Cash Deposit,0.00,662.65,4123879.66
9060,2023-08-16,2023-08-17,,Transfer Received,0.00,1402.49,4125282.15
9061,2023-08-17,2023-08-17,,Salary Credit,0.00,2521.95,4127804.10
9062,2023-08-17,2023-08-17,,Daily Essentials,7.54,0.00,4127796.56
9063,2023-08-17,2023-08-17,,Daily Essentials,27.80,0.00,4127768.76
9064,2023-08-18,2023-08-18,,ATM Withdrawal,61.42,0.00,4127707.34
9065,2023-08-17,2023-08-18,,Salary Credit,0.00,2148.40,4129855.74
9066,2023-08-18,2023-08-18,,Utility Payment,199.35,0.00,4129656.39
9067,2023-08-18,2023-08-18,,Transfer Received,0.00,1953.77,4131610.16
9068,2023-08-18,2023-08-18,,Online Transfer,131.25,0.00,4131478.91
9069,2023-08-18,2023-08-18,,Credit Card Payment,843.09,0.00,4130635.82
9070,2023-08-18,2023-08-18,,ATM Withdrawal,183.35,0.00,4130452.47
9071,2023-08-19,2023-08-18,,Interest Credited,0.00,38.02,4130490.49
9072,2023-08-19,2023-08-19,,Interest Credited,0.00,14.26,4130504.75
9073,2023-08-19,2023-08-19,,Online Transfer,206.57,0.00,4130298.18
9074,2023-08-20,2023-08-19,,Salary Credit,0.00,3163.55,4133461.73
9075,2023-08-20,2023-08-20,,Salary Credit,0.00,3574.44,4137036.17
9076,2023-08-21,2023-08-20,,Credit Card Payment,403.34,0.00,4136632.83
9077,2023-08-20,2023-08-20,,Transfer Received,0.00,2041.31,4138674.14
9078,2023-08-20,2023-08-20,,ATM Withdrawal,381.41,0.00,4138292.73
9079,2023-08-20,2023-08-20,,Rental Income,0.00,2448.95,4140741.68
9080,2023-08-20,2023-08-20,,Salary Credit,0.00,2542.94,4143284.62
9081,2023-08-21,2023-08-20,,Utility Payment,133.39,0.00,4143151.23
9082,2023-08-21,2023-08-21,100222,Cheque Issued,2562.00,0.00,4140589.23
9083,2023-08-21,2023-08-21,,Interest Credited,0.00,56.28,4140645.51
9084,2023-08-22,2023-08-22,,Online Transfer,1374.10,0.00,4139271.41
9085,2023-08-21,2023-08-22,,Credit Card Payment,967.33,0.00,4138304.08
9086,2023-08-22,2023-08-22,,Interest Credited,0.00,66.25,4138370.33
9087,2023-08-22,2023-08-22,,Cash Deposit,0.00,852.60,4139222.93
9088,2023-08-22,2023-08-22,,Transfer Received,0.00,2825.80,4142048.73
9089,2023-08-23,2023-08-22,,Takeout,32.98,0.00,4142015.75
9090,2023-08-24,2023-08-23,,Utility Payment,176.50,0.00,4141839.25
9091,2023-08-23,2023-08-23,,Groceries - Supermarket,180.65,0.00,4141658.60
9092,2023-08-23,2023-08-23,,Transfer Received,0.00,1310.33,4142968.93
9093,2023-08-22,2023-08-23,,Online Transfer,785.74,0.00,4142183.19
9094,2023-08-23,2023-08-23,,ATM Withdrawal,279.36,0.00,4141903.83
9095,2023-08-23,2023-08-23,,Groceries - Online Delivery,90.90,0.00,4141812.93
9096,2023-08-22,2023-08-23,,Online Transfer,1954.20,0.00,4139858.73
9097,2023-08-22,2023-08-23,,Salary Credit,0.00,3267.54,4143126.27
9098,2023-08-23,2023-08-23,,ATM Withdrawal,69.71,0.00,4143056.56
9099,2023-08-23,2023-08-23,,Investment - Stocks,4654.79,0.00,4138401.77
9100,2023-08-23,2023-08-23,,Utility Payment,127.53,0.00,4138274.24
9101,2023-08-24,2023-08-24,,Salary Credit,0.00,3879.62,4142153.86
9102,2023-08-25,2023-08-24,,Salary Credit,0.00,4223.05,4146376.91
9103,2023-08-23,2023-08-24,,Online Transfer,226.43,0.00,4146150.48
9104,2023-08-24,2023-08-24,,Interest Credited,0.00,13.96,4146164.44
9105,2023-08-24,2023-08-24,,Takeout,41.67,0.00,4146122.77
9106,2023-08-24,2023-08-24,,ATM Withdrawal,115.29,0.00,4146007.48
9107,2023-08-25,2023-08-25,,Groceries - Supermarket,148.36,0.00,4145859.12
9108,2023-08-24,2023-08-25,,Transfer Received,0.00,2186.41,4148045.53
9109,2023-08-25,2023-08-25,,Transfer Received,0.00,1201.10,4149246.63
9110,2023-08-25,2023-08-25,,Investment - SIP,921.76,0.00,4148324.87
9111,2023-08-25,2023-08-25,,Daily Essentials,30.08,0.00,4148294.79
9112,2023-08-25,2023-08-25,,Transfer Received,0.00,609.93,4148904.72
9113,2023-08-25,2023-08-25,,Transfer Received,0.00,2970.82,4151875.54
9114,2023-08-25,2023-08-25,,Transfer Received,0.00,2527.89,4154403.43
9115,2023-08-26,2023-08-26,,Groceries - Online Delivery,122.02,0.00,4154281.41
9116,2023-08-26,2023-08-26,,Investment - Stocks,4107.79,0.00,4150173.62
9117,2023-08-27,2023-08-26,,Online Transfer,1345.28,0.00,4148828.34
9118,2023-08-26,2023-08-26,,Transfer Received,0.00,2880.12,4151708.46
9119,2023-08-26,2023-08-26,,Online Transfer,662.51,0.00,4151045.95
9120,2023-08-26,2023-08-26,,ATM Withdrawal,285.24,0.00,4150760.71
9121,2023-08-26,2023-08-26,,Salary Credit,0.00,4007.65,4154768.36
9122,2023-08-26,2023-08-27,,Groceries - Supermarket,28.26,0.00,4154740.10
9123,2023-08-27,2023-08-27,,Transfer Received,0.00,619.86,4155359.96
9124,2023-08-27,2023-08-27,,ATM Withdrawal,382.10,0.00,4154977.86
9125,2023-08-28,2023-08-27,,Transfer Received,0.00,802.12,4155779.98
9126,2023-08-26,2023-08-27,,Cash Deposit,0.00,627.16,4156407.14
9127,2023-08-27,2023-08-27,,Groceries - Supermarket,156.52,0.00,4156250.62
9128,2023-08-28,2023-08-27,,Investment Returns,0.00,880.66,4157131.28
9129,2023-08-27,2023-08-27,100223,Cheque Issued,2577.14,0.00,4154554.14
9130,2023-08-27,2023-08-28,,Takeout,22.79,0.00,4154531.35
9131,2023-08-28,2023-08-28,,Transfer Received,0.00,639.24,4155170.59
9132,2023-08-28,2023-08-28,,Investment - Stocks,4688.66,0.00,4150481.93
9133,2023-08-27,2023-08-28,,Transfer Received,0.00,785.35,4151267.28
9134,2023-08-28,2023-08-28,,Credit Card Payment,580.10,0.00,4150687.18
9135,2023-08-28,2023-08-29,,Transfer Received,0.00,2812.00,4153499.18
9136,2023-08-29,2023-08-29,,Interest Credited,0.00,52.81,4153551.99
9137,2023-08-28,2023-08-29,,ATM Withdrawal,354.74,0.00,4153197.25
9138,2023-08-29,2023-08-29,,Investment - Mutual Funds,1136.33,0.00,4152060.92
9139,2023-08-28,2023-08-29,100224,Cheque Issued,2289.16,0.00,4149771.76
9140,2023-08-29,2023-08-29,,Daily Essentials,39.04,0.00,4149732.72
9141,2023-08-30,2023-08-30,,ATM Withdrawal,304.21,0.00,4149428.51
9142,2023-08-30,2023-08-30,,Credit Card Payment,218.54,0.00,4149209.97
9143,2023-08-30,2023-08-30,,Transfer Received,0.00,1825.18,4151035.15
9144,2023-08-29,2023-08-30,,Transfer Received,0.00,1633.19,4152668.34
9145,2023-08-30,2023-08-30,,Transfer Received,0.00,2458.19,4155126.53
9146,2023-08-30,2023-08-30,,Takeout,41.63,0.00,4155084.90
9147,2023-08-30,2023-08-30,,Loan EMI,1776.74,0.00,4153308.16
9148,2023-08-31,2023-08-30,,Salary Credit,0.00,3535.30,4156843.46
9149,2023-09-01,2023-08-31,,Online Transfer,231.99,0.00,4156611.47
9150,2023-08-31,2023-08-31,,Credit Card Payment,448.13,0.00,4156163.34
9151,2023-08-31,2023-08-31,,Dividend Received,0.00,310.20,4156473.54
9152,2023-08-31,2023-08-31,,Utility Payment,238.72,0.00,4156234.82
9153,2023-08-31,2023-08-31,,Groceries - Online Delivery,97.49,0.00,4156137.33
9154,2023-08-31,2023-08-31,,Salary Credit,0.00,4625.94,4160763.27
9155,2023-09-01,2023-08-31,,ATM Withdrawal,407.36,0.00,4160355.91
9156,2023-08-31,2023-08-31,,Credit Card Payment,643.00,0.00,4159712.91
9157,2023-09-01,2023-09-01,,Cash Deposit,0.00,316.15,4160029.06
9158,2023-08-31,2023-09-01,,Loan EMI,1225.44,0.00,4158803.62
9159,2023-09-01,2023-09-01,,Interest Credited,0.00,47.33,4158850.95
9160,2023-09-01,2023-09-01,,Groceries - Online Delivery,82.80,0.00,4158768.15
9161,2023-08-31,2023-09-01,,Transfer Received,0.00,2995.60,4161763.75
9162,2023-09-01,2023-09-01,,Transfer Received,0.00,1310.69,4163074.44
9163,2023-09-02,2023-09-01,,Transfer Received,0.00,2999.00,4166073.44
9164,2023-09-01,2023-09-02,,Online Transfer,1100.91,0.00,4164972.53
9165,2023-09-01,2023-09-02,,Coffee Shop,18.51,0.00,4164954.02
9166,2023-09-03,2023-09-02,,Salary Credit,0.00,4004.21,4168958.23
9167,2023-09-03,2023-09-03,100225,Cheque Issued,1069.45,0.00,4167888.78
9168,2023-09-03,2023-09-03,,Online Transfer,645.28,0.00,4167243.50
9169,2023-09-03,2023-09-03,,Transfer Received,0.00,2026.09,4169269.59
9170,2023-09-03,2023-09-03,,Credit Card Payment,493.26,0.00,4168776.33
9171,2023-09-03,2023-09-03,,Coffee Shop,6.28,0.00,4168770.05
9172,2023-09-04,2023-09-03,,ATM Withdrawal,278.90,0.00,4168491.15
9173,2023-09-03,2023-09-03,,ATM Withdrawal,470.85,0.00,4168020.30
9174,2023-09-03,2023-09-03,,Utility Payment,194.59,0.00,4167825.71
9175,2023-09-04,2023-09-04,,Salary Credit,0.00,3165.68,4170991.39
9176,2023-09-04,2023-09-04,,Online Transfer,1940.24,0.00,4169051.15
9177,2023-09-04,2023-09-04,,Salary Credit,0.00,3625.77,4172676.92
9178,2023-09-04,2023-09-04,,Interest Credited,0.00,23.79,4172700.71
9179,2023-09-04,2023-09-04,,Interest Credited,0.00,69.36,4172770.07
9180,2023-09-04,2023-09-04,,Transfer Received,0.00,2458.25,4175228.32
9181,2023-09-04,2023-09-04,,Salary Credit,0.00,3492.64,4178720.96
9182,2023-09-05,2023-09-04,,Transfer Received,0.00,1671.08,4180392.04
9183,2023-09-05,2023-09-05,,Dividend Received,0.00,234.05,4180626.09
9184,2023-09-05,2023-09-05,,Dining Out,57.00,0.00,4180569.09
9185,2023-09-06,2023-09-05,,Salary Credit,0.00,3305.83,4183874.92
9186,2023-09-05,2023-09-05,,ATM Withdrawal,357.89,0.00,4183517.03
9187,2023-09-06,2023-09-05,,Dining Out,85.39,0.00,4183431.64
9188,2023-09-05,2023-09-05,,Transfer Received,0.00,1916.98,4185348.62
9189,2023-09-06,2023-09-05,,Utility Payment,93.08,0.00,4185255.54
9190,2023-09-05,2023-09-05,,Dividend Received,0.00,245.28,4185500.82
9191,2023-09-06,2023-09-05,,Credit Card Payment,390.25,0.00,4185110.57
9192,2023-09-06,2023-09-05,,Groceries - Supermarket,81.80,0.00,4185028.77
9193,2023-09-06,2023-09-06,,Salary Credit,0.00,4663.64,4189692.41
9194,2023-09-07,2023-09-06,,Online Transfer,1506.80,0.00,4188185.61
9195,2023-09-07,2023-09-06,,Salary Credit,0.00,2253.68,4190439.29
9196,2023-09-06,2023-09-07,,Online Transfer,433.26,0.00,4190006.03
9197,2023-09-08,2023-09-07,,Online Transfer,166.48,0.00,4189839.55
9198,2023-09-07,2023-09-07,,Coffee Shop,8.94,0.00,4189830.61
9199,2023-09-07,2023-09-07,,Groceries - Supermarket,195.54,0.00,4189635.07
9200,2023-09-07,2023-09-07,,Groceries - Supermarket,161.66,0.00,4189473.41
9201,2023-09-07,2023-09-07,,Daily Essentials,7.09,0.00,4189466.32
9202,2023-09-07,2023-09-07,,Investment - Stocks,1763.59,0.00,4187702.73
9203,2023-09-07,2023-09-07,,Utility Payment,115.28,0.00,4187587.45
9204,2023-09-07,2023-09-07,100226,Cheque Issued,1996.46,0.00,4185590.99
9205,2023-09-07,2023-09-07,,Utility Payment,257.63,0.00,4185333.36
9206,2023-09-08,2023-09-07,,Transfer Received,0.00,1564.74,4186898.10
9207,2023-09-06,2023-09-07,,Investment - SIP,310.33,0.00,4186587.77
9208,2023-09-08,2023-09-07,,Credit Card Payment,983.90,0.00,4185603.87
9209,2023-09-06,2023-09-07,,Groceries - Online Delivery,61.68,0.00,4185542.19
9210,2023-09-07,2023-09-08,,Investment - SIP,782.57,0.00,4184759.62
9211,2023-09-07,2023-09-08,,Online Transfer,823.25,0.00,4183936.37
9212,2023-09-08,2023-09-08,,Investment Returns,0.00,562.07,4184498.44
9213,2023-09-08,2023-09-08,,Transfer Received,0.00,1878.94,4186377.38
9214,2023-09-08,2023-09-08,,Credit Card Payment,481.23,0.00,4185896.15
9215,2023-09-08,2023-09-08,,Cash Deposit,0.00,913.54,4186809.69
9216,2023-09-08,2023-09-08,,Utility Payment,153.72,0.00,4186655.97
9217,2023-09-09,2023-09-09,,Coffee Shop,19.79,0.00,4186636.18
9218,2023-09-10,2023-09-09,,Utility Payment,69.67,0.00,4186566.51
9219,2023-09-08,2023-09-09,,ATM Withdrawal,270.61,0.00,4186295.90
9220,2023-09-09,2023-09-09,,Groceries - Supermarket,84.13,0.00,4186211.77
9221,2023-09-10,2023-09-10,,Takeout,32.94,0.00,4186178.83
9222,2023-09-10,2023-09-10,,Online Transfer,370.92,0.00,4185807.91
9223,2023-09-10,2023-09-10,,Transfer Received,0.00,551.87,4186359.78
9224,2023-09-10,2023-09-10,,Transfer Received,0.00,1085.48,4187445.26
9225,2023-09-10,2023-09-10,,Utility Payment,107.00,0.00,4187338.26
9226,2023-09-10,2023-09-10,,Transfer Received,0.00,2353.62,4189691.88
9227,2023-09-11,2023-09-10,100227,Cheque Issued,948.96,0.00,4188742.92
9228,2023-09-09,2023-09-10,,Credit Card Payment,692.76,0.00,4188050.16
9229,2023-09-11,2023-09-11,,Transfer Received,0.00,2591.72,4190641.88
9230,2023-09-11,2023-09-11,,Utility Payment,263.84,0.00,4190378.04
9231,2023-09-11,2023-09-11,,Salary Credit,0.00,4027.13,4194405.17
9232,2023-09-10,2023-09-11,,Salary Credit,0.00,3421.62,4197826.79
9233,2023-09-11,2023-09-11,,Loan EMI,1627.24,0.00,4196199.55
9234,2023-09-12,2023-09-11,,Transfer Received,0.00,992.18,4197191.73
9235,2023-09-12,2023-09-12,,Daily Essentials,30.88,0.00,4197160.85
9236,2023-09-12,2023-09-12,,Transfer Received,0.00,747.93,4197908.78
9237,2023-09-12,2023-09-12,,ATM Withdrawal,129.34,0.00,4197779.44
9238,2023-09-11,2023-09-12,,Groceries - Supermarket,142.25,0.00,4197637.19
9239,2023-09-12,2023-09-12,,Credit Card Payment,420.69,0.00,4197216.50
9240,2023-09-14,2023-09-13,,Online Transfer,212.59,0.00,4197003.91
9241,2023-09-13,2023-09-13,,Groceries - Supermarket,49.63,0.00,4196954.28
9242,2023-09-13,2023-09-13,,Interest Credited,0.00,41.26,4196995.54
9243,2023-09-14,2023-09-13,,Cash Deposit,0.00,932.89,4197928.43
9244,2023-09-13,2023-09-13,,Dining Out,94.14,0.00,4197834.29
9245,2023-09-14,2023-09-13,,Cash Deposit,0.00,316.69,4198150.98
9246,2023-09-13,2023-09-13,,Transfer Received,0.00,2227.34,4200378.32
9247,2023-09-14,2023-09-14,,Salary Credit,0.00,4656.50,4205034.82
9248,2023-09-14,2023-09-14,,Takeout,17.68,0.00,4205017.14
9249,2023-09-14,2023-09-14,,Transfer Received,0.00,1342.22,4206359.36
9250,2023-09-14,2023-09-14,,Transfer Received,0.00,1997.26,4208356.62
9251,2023-09-14,2023-09-14,,Transfer Received,0.00,914.70,4209271.32
9252,2023-09-13,2023-09-14,,ATM Withdrawal,439.36,0.00,4208831.96
9253,2023-09-16,2023-09-15,,Groceries - Supermarket,181.39,0.00,4208650.57
9254,2023-09-15,2023-09-15,,Dining Out,65.91,0.00,4208584.66
9255,2023-09-15,2023-09-15,,Transfer Received,0.00,563.15,4209147.81
9256,2023-09-14,2023-09-15,,Groceries - Supermarket,51.16,0.00,4209096.65
9257,2023-09-14,2023-09-15,,Online Transfer,178.69,0.00,4208917.96
9258,2023-09-14,2023-09-15,,ATM Withdrawal,64.61,0.00,4208853.35
9259,2023-09-15,2023-09-15,,Credit Card Payment,307.03,0.00,4208546.32
9260,2023-09-15,2023-09-15,,Salary Credit,0.00,3412.75,4211959.07
9261,2023-09-14,2023-09-15,,Cash Deposit,0.00,793.03,4212752.10
9262,2023-09-14,2023-09-15,,Investment - Stocks,963.42,0.00,4211788.68
9263,2023-09-15,2023-09-15,,Credit Card Payment,822.94,0.00,4210965.74
9264,2023-09-15,2023-09-15,,Transfer Received,0.00,1104.74,4212070.48
9265,2023-09-16,2023-09-16,,Transfer Received,0.00,1471.58,4213542.06
9266,2023-09-16,2023-09-16,,Transfer Received,0.00,1683.03,4215225.09
9267,2023-09-17,2023-09-16,,ATM Withdrawal,340.99,0.00,4214884.10
9268,2023-09-17,2023-09-16,,Transfer Received,0.00,1038.54,4215922.64
9269,2023-09-17,2023-09-16,,Transfer Received,0.00,859.18,4216781.82
9270,2023-09-16,2023-09-16,,Online Transfer,527.24,0.00,4216254.58
9271,2023-09-17,2023-09-17,,Takeout,24.93,0.00,4216229.65
9272,2023-09-17,2023-09-17,,Salary Credit,0.00,3016.45,4219246.10
9273,2023-09-18,2023-09-17,,Utility Payment,152.27,0.00,4219093.83
9274,2023-09-17,2023-09-17,,Online Transfer,1163.79,0.00,4217930.04
9275,2023-09-17,2023-09-17,,ATM Withdrawal,205.46,0.00,4217724.58
9276,2023-09-17,2023-09-17,,Salary Credit,0.00,4788.51,4222513.09
9277,2023-09-18,2023-09-17,,Salary Credit,0.00,2688.59,4225201.68
9278,2023-09-17,2023-09-17,,Online Transfer,271.04,0.00,4224930.64
9279,2023-09-17,2023-09-17,,Transfer Received,0.00,1818.69,4226749.33
9280,2023-09-17,2023-09-17,,Credit Card Payment,449.45,0.00,4226299.88
9281,2023-09-17,2023-09-17,,Salary Credit,0.00,2175.74,4228475.62
9282,2023-09-17,2023-09-17,,Investment - Mutual Funds,398.67,0.00,4228076.95
9283,2023-09-19,2023-09-18,,ATM Withdrawal,459.62,0.00,4227617.33
9284,2023-09-18,2023-09-18,,Groceries - Supermarket,197.86,0.00,4227419.47
9285,2023-09-18,2023-09-18,,Loan EMI,1666.48,0.00,4225752.99
9286,2023-09-17,2023-09-18,,Credit Card Payment,262.27,0.00,4225490.72
9287,2023-09-17,2023-09-18,,ATM Withdrawal,45.44,0.00,4225445.28
9288,2023-09-18,2023-09-18,,ATM Withdrawal,100.18,0.00,4225345.10
9289,2023-09-18,2023-09-18,100228,Cheque Issued,1146.98,0.00,4224198.12
9290,2023-09-18,2023-09-18,,Credit Card Payment,919.98,0.00,4223278.14
9291,2023-09-19,2023-09-19,,Transfer Received,0.00,2148.26,4225426.40
9292,2023-09-18,2023-09-19,,Transfer Received,0.00,1657.36,4227083.76
9293,2023-09-19,2023-09-19,,Transfer Received,0.00,531.13,4227614.89
9294,2023-09-18,2023-09-19,,Investment - Mutual Funds,2994.33,0.00,4224620.56
9295,2023-09-18,2023-09-19,,Investment Returns,0.00,310.30,4224930.86
9296,2023-09-19,2023-09-19,,Groceries - Online Delivery,130.85,0.00,4224800.01
9297,2023-09-19,2023-09-19,,Dividend Received,0.00,414.81,4225214.82
9298,2023-09-19,2023-09-19,,Salary Credit,0.00,3419.86,4228634.68
9299,2023-09-20,2023-09-20,,Transfer Received,0.00,1880.68,4230515.36
9300,2023-09-20,2023-09-20,,Cash Deposit,0.00,758.57,4231273.93
9301,2023-09-20,2023-09-20,,Transfer Received,0.00,2880.00,4234153.93
9302,2023-09-21,2023-09-20,,Dining Out,98.46,0.00,4234055.47
9303,2023-09-20,2023-09-20,,Salary Credit,0.00,2087.81,4236143.28
9304,2023-09-20,2023-09-20,,Takeout,34.14,0.00,4236109.14
9305,2023-09-20,2023-09-20,,ATM Withdrawal,147.55,0.00,4235961.59
9306,2023-09-22,2023-09-21,,Online Transfer,720.30,0.00,4235241.29
9307,2023-09-21,2023-09-21,,Transfer Received,0.00,1873.61,4237114.90
9308,2023-09-21,2023-09-21,,Online Transfer,564.53,0.00,4236550.37
9309,2023-09-22,2023-09-21,,Groceries - Supermarket,41.89,0.00,4236508.48
9310,2023-09-21,2023-09-21,,Online Transfer,440.71,0.00,4236067.77
9311,2023-09-21,2023-09-21,,Online Transfer,1558.61,0.00,4234509.16
9312,2023-09-20,2023-09-21,,Transfer Received,0.00,2487.53,4236996.69
9313,2023-09-20,2023-09-21,,Salary Credit,0.00,3060.61,4240057.30
9314,2023-09-21,2023-09-22,,Salary Credit,0.00,4494.94,4244552.24
9315,2023-09-22,2023-09-22,,Groceries - Supermarket,193.83,0.00,4244358.41
9316,2023-09-23,2023-09-22,,Salary Credit,0.00,4603.09,4248961.50
9317,2023-09-22,2023-09-22,,Transfer Received,0.00,2714.69,4251676.19
9318,2023-09-23,2023-09-23,,Dining Out,85.72,0.00,4251590.47
9319,2023-09-23,2023-09-23,,Utility Payment,117.36,0.00,4251473.11
9320,2023-09-23,2023-09-23,,Salary Credit,0.00,2234.27,4253707.38
9321,2023-09-24,2023-09-24,,ATM Withdrawal,110.37,0.00,4253597.01
9322,2023-09-24,2023-09-24,,Groceries - Supermarket,21.79,0.00,4253575.22
9323,2023-09-25,2023-09-24,,Transfer Received,0.00,713.57,4254288.79
9324,2023-09-24,2023-09-24,,Transfer Received,0.00,1473.41,4255762.20
9325,2023-09-24,2023-09-24,,ATM Withdrawal,318.98,0.00,4255443.22
9326,2023-09-24,2023-09-24,,Salary Credit,0.00,4119.84,4259563.06
9327,2023-09-24,2023-09-24,,ATM Withdrawal,324.70,0.00,4259238.36
9328,2023-09-24,2023-09-24,,Utility Payment,254.72,0.00,4258983.64
9329,2023-09-24,2023-09-24,,Takeout,23.55,0.00,4258960.09
9330,2023-09-25,2023-09-24,,Takeout,16.90,0.00,4258943.19
9331,2023-09-24,2023-09-24,,Loan EMI,883.47,0.00,4258059.72
9332,2023-09-25,2023-09-25,,Groceries - Supermarket,133.78,0.00,4257925.94
9333,2023-09-25,2023-09-25,,ATM Withdrawal,291.67,0.00,4257634.27
9334,2023-09-25,2023-09-25,,Daily Essentials,22.03,0.00,4257612.24
9335,2023-09-25,2023-09-25,,Transfer Received,0.00,1247.21,4258859.45
9336,2023-09-25,2023-09-25,,Groceries - Supermarket,34.37,0.00,4258825.08
9337,2023-09-26,2023-09-25,,Salary Credit,0.00,3689.42,4262514.50
9338,2023-09-25,2023-09-25,,Salary Credit,0.00,4829.77,4267344.27
9339,2023-09-26,2023-09-26,,Transfer Received,0.00,2237.12,4269581.39
9340,2023-09-25,2023-09-26,100229,Cheque Issued,979.16,0.00,4268602.23
9341,2023-09-26,2023-09-26,,Salary Credit,0.00,3038.79,4271641.02
9342,2023-09-26,2023-09-26,,Dining Out,33.30,0.00,4271607.72
9343,2023-09-26,2023-09-26,,Investment Returns,0.00,718.64,4272326.36
9344,2023-09-25,2023-09-26,,Daily Essentials,39.30,0.00,4272287.06
9345,2023-09-26,2023-09-26,,Salary Credit,0.00,2510.73,4274797.79
9346,2023-09-26,2023-09-26,,Utility Payment,143.88,0.00,4274653.91
9347,2023-09-27,2023-09-27,,Takeout,16.96,0.00,4274636.95
9348,2023-09-28,2023-09-27,,Transfer Received,0.00,523.73,4275160.68
9349,2023-09-27,2023-09-27,,Transfer Received,0.00,1910.95,4277071.63
9350,2023-09-27,2023-09-27,,ATM Withdrawal,455.33,0.00,4276616.30
9351,2023-09-27,2023-09-27,,Investment - Mutual Funds,2865.59,0.00,4273750.71
9352,2023-09-27,2023-09-27,,Transfer Received,0.00,587.83,4274338.54
9353,2023-09-29,2023-09-28,,Interest Credited,0.00,32.67,4274371.21
9354,2023-09-28,2023-09-28,,Salary Credit,0.00,3625.79,4277997.00
9355,2023-09-29,2023-09-28,,Takeout,34.19,0.00,4277962.81
9356,2023-09-28,2023-09-28,,ATM Withdrawal,221.12,0.00,4277741.69
9357,2023-09-28,2023-09-28,,Groceries - Supermarket,30.65,0.00,4277711.04
9358,2023-09-28,2023-09-28,,Takeout,11.25,0.00,4277699.79
9359,2023-09-29,2023-09-28,,Online Transfer,1464.77,0.00,4276235.02
9360,2023-09-28,2023-09-28,,Salary Credit,0.00,3814.92,4280049.94
9361,2023-09-28,2023-09-28,,Salary Credit,0.00,3825.55,4283875.49
9362,2023-09-28,2023-09-28,,Groceries - Supermarket,139.75,0.00,4283735.74
9363,2023-09-29,2023-09-28,,Credit Card Payment,385.58,0.00,4283350.16
9364,2023-09-28,2023-09-28,,Transfer Received,0.00,2313.45,4285663.61
9365,2023-09-29,2023-09-29,,Salary Credit,0.00,4239.91,4289903.52
9366,2023-09-29,2023-09-29,,Groceries - Supermarket,53.98,0.00,4289849.54
9367,2023-09-29,2023-09-29,,Groceries - Supermarket,23.22,0.00,4289826.32
9368,2023-09-29,2023-09-29,,ATM Withdrawal,76.79,0.00,4289749.53
9369,2023-09-29,2023-09-29,,Dining Out,20.04,0.00,4289729.49
9370,2023-09-30,2023-09-30,,Transfer Received,0.00,1455.32,4291184.81
9371,2023-09-30,2023-09-30,,Cash Deposit,0.00,712.82,4291897.63
9372,2023-09-30,2023-09-30,,Loan EMI,1736.58,0.00,4290161.05
9373,2023-10-01,2023-10-01,100230,Cheque Issued,2741.56,0.00,4287419.49
9374,2023-09-30,2023-10-01,,Investment Returns,0.00,554.28,4287973.77
9375,2023-10-01,2023-10-01,,Online Transfer,1044.01,0.00,4286929.76
9376,2023-10-01,2023-10-01,,Groceries - Online Delivery,86.52,0.00,4286843.24
9377,2023-10-02,2023-10-02,,Investment Returns,0.00,705.25,4287548.49
9378,2023-10-02,2023-10-02,,Transfer Received,0.00,929.84,4288478.33
9379,2023-10-02,2023-10-02,100231,Cheque Issued,1770.41,0.00,4286707.92
9380,2023-10-02,2023-10-02,,Investment - Mutual Funds,2999.02,0.00,4283708.90
9381,2023-10-02,2023-10-02,,Dining Out,68.81,0.00,4283640.09
9382,2023-10-02,2023-10-02,,ATM Withdrawal,87.77,0.00,4283552.32
9383,2023-10-02,2023-10-02,,Groceries - Supermarket,114.87,0.00,4283437.45
9384,2023-10-03,2023-10-03,,Credit Card Payment,317.45,0.00,4283120.00
9385,2023-10-03,2023-10-03,,Transfer Received,0.00,1275.47,4284395.47
9386,2023-10-03,2023-10-03,,Groceries - Supermarket,65.44,0.00,4284330.03
9387,2023-10-03,2023-10-03,,Salary Credit,0.00,3892.30,4288222.33
9388,2023-10-02,2023-10-03,,Transfer Received,0.00,2295.42,4290517.75
9389,2023-10-02,2023-10-03,,Groceries - Supermarket,34.55,0.00,4290483.20
9390,2023-10-04,2023-10-03,,Utility Payment,98.40,0.00,4290384.80
9391,2023-10-03,2023-10-03,,Groceries - Supermarket,179.80,0.00,4290205.00
9392,2023-10-03,2023-10-03,,Utility Payment,217.40,0.00,4289987.60
9393,2023-10-03,2023-10-03,,Loan EMI,1596.70,0.00,4288390.90
9394,2023-10-03,2023-10-03,,Cash Deposit,0.00,216.19,4288607.09
9395,2023-10-05,2023-10-04,,Transfer Received,0.00,2634.64,4291241.73
9396,2023-10-04,2023-10-04,,ATM Withdrawal,59.14,0.00,4291182.59
9397,2023-10-04,2023-10-04,,Transfer Received,0.00,2566.53,4293749.12
9398,2023-10-04,2023-10-04,,ATM Withdrawal,141.97,0.00,4293607.15
9399,2023-10-04,2023-10-04,,ATM Withdrawal,278.84,0.00,4293328.31
9400,2023-10-04,2023-10-04,100232,Cheque Issued,1103.60,0.00,4292224.71
9401,2023-10-05,2023-10-04,,ATM Withdrawal,366.83,0.00,4291857.88
9402,2023-10-05,2023-10-04,,Groceries - Online Delivery,145.02,0.00,4291712.86
9403,2023-10-05,2023-10-04,,Utility Payment,192.20,0.00,4291520.66
9404,2023-10-04,2023-10-04,,Salary Credit,0.00,3970.60,4295491.26
9405,2023-10-04,2023-10-04,,Salary Credit,0.00,3448.54,4298939.80
9406,2023-10-03,2023-10-04,,Rental Income,0.00,2865.21,4301805.01
9407,2023-10-05,2023-10-04,,Transfer Received,0.00,2552.75,4304357.76
9408,2023-10-05,2023-10-05,,Dining Out,46.33,0.00,4304311.43
9409,2023-10-04,2023-10-05,,Transfer Received,0.00,1429.66,4305741.09
9410,2023-10-04,2023-10-05,,Salary Credit,0.00,2904.71,4308645.80
9411,2023-10-04,2023-10-05,100233,Cheque Issued,1225.30,0.00,4307420.50
9412,2023-10-06,2023-10-05,,Salary Credit,0.00,2460.93,4309881.43
9413,2023-10-07,2023-10-06,,Online Transfer,1497.46,0.00,4308383.97
9414,2023-10-06,2023-10-06,,Interest Credited,0.00,70.13,4308454.10
9415,2023-10-05,2023-10-06,,Transfer Received,0.00,1784.72,4310238.82
9416,2023-10-06,2023-10-06,,Dining Out,81.99,0.00,4310156.83
9417,2023-10-06,2023-10-06,,Investment - SIP,892.10,0.00,4309264.73
9418,2023-10-07,2023-10-06,,Utility Payment,179.87,0.00,4309084.86
9419,2023-10-07,2023-10-07,,ATM Withdrawal,98.19,0.00,4308986.67
9420,2023-10-08,2023-10-07,,Salary Credit,0.00,3445.39,4312432.06
9421,2023-10-07,2023-10-07,,Cash Deposit,0.00,406.63,4312838.69
9422,2023-10-08,2023-10-07,,Investment Returns,0.00,257.28,4313095.97
9423,2023-10-07,2023-10-07,,Transfer Received,0.00,1116.17,4314212.14
9424,2023-10-07,2023-10-07,,Cash Deposit,0.00,412.01,4314624.15
9425,2023-10-07,2023-10-07,,Utility Payment,134.53,0.00,4314489.62
9426,2023-10-07,2023-10-07,,Takeout,36.75,0.00,4314452.87
9427,2023-10-07,2023-10-08,,Utility Payment,167.96,0.00,4314284.91
9428,2023-10-09,2023-10-08,,Loan EMI,1082.49,0.00,4313202.42
9429,2023-10-08,2023-10-08,,ATM Withdrawal,169.15,0.00,4313033.27
9430,2023-10-08,2023-10-08,,Dining Out,60.84,0.00,4312972.43
9431,2023-10-09,2023-10-08,,Transfer Received,0.00,2196.00,4315168.43
9432,2023-10-08,2023-10-08,,Transfer Received,0.00,2564.86,4317733.29
9433,2023-10-09,2023-10-08,,Transfer Received,0.00,2157.70,4319890.99
9434,2023-10-07,2023-10-08,,ATM Withdrawal,44.64,0.00,4319846.35
9435,2023-10-09,2023-10-09,,Utility Payment,156.15,0.00,4319690.20
9436,2023-10-09,2023-10-09,,Salary Credit,0.00,2168.03,4321858.23
9437,2023-10-08,2023-10-09,,Transfer Received,0.00,917.53,4322775.76
9438,2023-10-08,2023-10-09,,ATM Withdrawal,328.13,0.00,4322447.63
9439,2023-10-09,2023-10-09,,ATM Withdrawal,389.87,0.00,4322057.76
9440,2023-10-09,2023-10-09,,Investment - Stocks,3261.67,0.00,4318796.09
9441,2023-10-09,2023-10-09,,Transfer Received,0.00,2234.75,4321030.84
9442,2023-10-09,2023-10-09,100234,Cheque Issued,1355.35,0.00,4319675.49
9443,2023-10-10,2023-10-10,,Groceries - Online Delivery,61.72,0.00,4319613.77
9444,2023-10-11,2023-10-10,,Online Transfer,1460.10,0.00,4318153.67
9445,2023-10-09,2023-10-10,,Online Transfer,215.46,0.00,4317938.21
9446,2023-10-10,2023-10-10,,Transfer Received,0.00,2113.63,4320051.84
9447,2023-10-11,2023-10-10,,Credit Card Payment,402.65,0.00,4319649.19
9448,2023-10-09,2023-10-10,,Groceries - Supermarket,26.40,0.00,4319622.79
9449,2023-10-10,2023-10-10,,Coffee Shop,7.44,0.00,4319615.35
9450,2023-10-10,2023-10-10,,Transfer Received,0.00,1993.33,4321608.68
9451,2023-10-11,2023-10-11,100235,Cheque Issued,601.15,0.00,4321007.53
9452,2023-10-11,2023-10-11,,Coffee Shop,7.38,0.00,4321000.15
9453,2023-10-10,2023-10-11,,Transfer Received,0.00,2109.26,4323109.41
9454,2023-10-12,2023-10-11,,Transfer Received,0.00,2270.91,4325380.32
9455,2023-10-11,2023-10-11,,Online Transfer,1419.96,0.00,4323960.36
9456,2023-10-11,2023-10-11,,Online Transfer,233.06,0.00,4323727.30
9457,2023-10-12,2023-10-12,,Dividend Received,0.00,336.29,4324063.59
9458,2023-10-12,2023-10-12,,Credit Card Payment,545.47,0.00,4323518.12
9459,2023-10-12,2023-10-12,,Transfer Received,0.00,1531.63,4325049.75
9460,2023-10-13,2023-10-12,,ATM Withdrawal,285.90,0.00,4324763.85
9461,2023-10-12,2023-10-12,,Salary Credit,0.00,2400.21,4327164.06
9462,2023-10-12,2023-10-12,,Transfer Received,0.00,2446.23,4329610.29
9463,2023-10-14,2023-10-13,100236,Cheque Issued,927.54,0.00,4328682.75
9464,2023-10-14,2023-10-13,,Interest Credited,0.00,54.63,4328737.38
9465,2023-10-13,2023-10-13,,Credit Card Payment,939.67,0.00,4327797.71
9466,2023-10-13,2023-10-13,,Groceries - Supermarket,44.82,0.00,4327752.89
9467,2023-10-14,2023-10-13,,Transfer Received,0.00,755.96,4328508.85
9468,2023-10-13,2023-10-13,,Transfer Received,0.00,1370.40,4329879.25
9469,2023-10-14,2023-10-14,,Transfer Received,0.00,2146.12,4332025.37
9470,2023-10-14,2023-10-14,,Coffee Shop,16.81,0.00,4332008.56
9471,2023-10-14,2023-10-14,,Investment Returns,0.00,632.76,4332641.32
9472,2023-10-15,2023-10-14,,Salary Credit,0.00,3577.66,4336218.98
9473,2023-10-13,2023-10-14,,ATM Withdrawal,127.23,0.00,4336091.75
9474,2023-10-15,2023-10-14,,Dining Out,38.08,0.00,4336053.67
9475,2023-10-14,2023-10-14,,Transfer Received,0.00,1514.11,4337567.78
9476,2023-10-15,2023-10-14,,Online Transfer,355.02,0.00,4337212.76
9477,2023-10-14,2023-10-14,,Dining Out,23.04,0.00,4337189.72
9478,2023-10-14,2023-10-14,,Daily Essentials,28.25,0.00,4337161.47
9479,2023-10-15,2023-10-15,,ATM Withdrawal,85.83,0.00,4337075.64
9480,2023-10-15,2023-10-15,,ATM Withdrawal,95.27,0.00,4336980.37
9481,2023-10-15,2023-10-15,,ATM Withdrawal,295.93,0.00,4336684.44
9482,2023-10-16,2023-10-15,,Online Transfer,320.64,0.00,4336363.80
9483,2023-10-14,2023-10-15,,Salary Credit,0.00,3819.34,4340183.14
9484,2023-10-16,2023-10-16,,Credit Card Payment,361.17,0.00,4339821.97
9485,2023-10-16,2023-10-16,100237,Cheque Issued,1591.35,0.00,4338230.62
9486,2023-10-16,2023-10-16,,Dining Out,66.66,0.00,4338163.96
9487,2023-10-15,2023-10-16,,Salary Credit,0.00,2895.43,4341059.39
9488,2023-10-16,2023-10-16,,Transfer Received,0.00,1251.76,4342311.15
9489,2023-10-16,2023-10-16,,Dividend Received,0.00,206.09,4342517.24
9490,2023-10-17,2023-10-16,,Salary Credit,0.00,2504.95,4345022.19
9491,2023-10-16,2023-10-16,,Credit Card Payment,226.87,0.00,4344795.32
9492,2023-10-17,2023-10-17,,Salary Credit,0.00,4232.98,4349028.30
9493,2023-10-17,2023-10-17,,Rental Income,0.00,1960.39,4350988.69
9494,2023-10-18,2023-10-17,,Credit Card Payment,858.76,0.00,4350129.93
9495,2023-10-18,2023-10-17,,Interest Credited,0.00,64.80,4350194.73
9496,2023-10-18,2023-10-18,,Transfer Received,0.00,1601.36,4351796.09
9497,2023-10-18,2023-10-18,,Salary Credit,0.00,3909.47,4355705.56
9498,2023-10-18,2023-10-18,,Salary Credit,0.00,2604.40,4358309.96
9499,2023-10-18,2023-10-18,,Groceries - Supermarket,110.29,0.00,4358199.67
9500,2023-10-18,2023-10-18,,Salary Credit,0.00,3016.91,4361216.58
9501,2023-10-18,2023-10-18,,Online Transfer,1228.97,0.00,4359987.61
9502,2023-10-18,2023-10-19,,Salary Credit,0.00,3597.46,4363585.07
9503,2023-10-19,2023-10-19,,Investment - SIP,902.26,0.00,4362682.81
9504,2023-10-18,2023-10-19,,ATM Withdrawal,372.75,0.00,4362310.06
9505,2023-10-20,2023-10-20,,ATM Withdrawal,119.32,0.00,4362190.74
9506,2023-10-19,2023-10-20,,Daily Essentials,14.84,0.00,4362175.90
9507,2023-10-20,2023-10-20,,Transfer Received,0.00,2614.53,4364790.43
9508,2023-10-20,2023-10-20,,Dividend Received,0.00,116.37,4364906.80
9509,2023-10-20,2023-10-20,,Cash Deposit,0.00,714.80,4365621.60
9510,2023-10-20,2023-10-20,,Daily Essentials,40.92,0.00,4365580.68
9511,2023-10-20,2023-10-20,,Salary Credit,0.00,4221.78,4369802.46
9512,2023-10-20,2023-10-20,,Transfer Received,0.00,1728.13,4371530.59
9513,2023-10-20,2023-10-20,,Transfer Received,0.00,850.64,4372381.23
9514,2023-10-21,2023-10-20,,Credit Card Payment,813.67,0.00,4371567.56
9515,2023-10-22,2023-10-21,,ATM Withdrawal,459.52,0.00,4371108.04
9516,2023-10-20,2023-10-21,,Cash Deposit,0.00,963.11,4372071.15
9517,2023-10-21,2023-10-21,,Salary Credit,0.00,4306.50,4376377.65
9518,2023-10-21,2023-10-21,,Transfer Received,0.00,1471.83,4377849.48
9519,2023-10-20,2023-10-21,,Transfer Received,0.00,2200.56,4380050.04
9520,2023-10-21,2023-10-21,,Online Transfer,1814.74,0.00,4378235.30
9521,2023-10-21,2023-10-21,,Transfer Received,0.00,2396.58,4380631.88
9522,2023-10-22,2023-10-22,,Takeout,15.87,0.00,4380616.01
9523,2023-10-22,2023-10-22,,Loan EMI,1249.42,0.00,4379366.59
9524,2023-10-22,2023-10-22,,Rental Income,0.00,1241.78,4380608.37
9525,2023-10-22,2023-10-22,,Groceries - Supermarket,104.12,0.00,4380504.25
9526,2023-10-23,2023-10-23,,Online Transfer,1385.57,0.00,4379118.68
9527,2023-10-22,2023-10-23,,Transfer Received,0.00,1531.65,4380650.33
9528,2023-10-23,2023-10-23,,Rental Income,0.00,2257.86,4382908.19
9529,2023-10-23,2023-10-23,,Transfer Received,0.00,2992.71,4385900.90
9530,2023-10-24,2023-10-24,,Groceries - Supermarket,166.36,0.00,4385734.54
9531,2023-10-23,2023-10-24,,Salary Credit,0.00,2992.32,4388726.86
9532,2023-10-23,2023-10-24,,Cash Deposit,0.00,280.12,4389006.98
9533,2023-10-24,2023-10-24,,ATM Withdrawal,351.21,0.00,4388655.77
9534,2023-10-24,2023-10-24,,Online Transfer,1173.54,0.00,4387482.23
9535,2023-10-24,2023-10-24,,ATM Withdrawal,216.59,0.00,4387265.64
9536,2023-10-24,2023-10-24,,ATM Withdrawal,479.33,0.00,4386786.31
9537,2023-10-24,2023-10-24,,Salary Credit,0.00,4693.18,4391479.49
9538,2023-10-24,2023-10-24,,Groceries - Supermarket,77.68,0.00,4391401.81
9539,2023-10-25,2023-10-25,,Groceries - Supermarket,71.72,0.00,4391330.09
9540,2023-10-25,2023-10-25,,ATM Withdrawal,237.22,0.00,4391092.87
9541,2023-10-24,2023-10-25,,Groceries - Supermarket,35.07,0.00,4391057.80
9542,2023-10-25,2023-10-25,,Credit Card Payment,980.57,0.00,4390077.23
9543,2023-10-25,2023-10-25,,Online Transfer,1834.24,0.00,4388242.99
9544,2023-10-25,2023-10-25,,ATM Withdrawal,273.86,0.00,4387969.13
9545,2023-10-26,2023-10-26,,Groceries - Online Delivery,74.68,0.00,4387894.45
9546,2023-10-26,2023-10-26,,Online Transfer,985.82,0.00,4386908.63
9547,2023-10-25,2023-10-26,,ATM Withdrawal,306.67,0.00,4386601.96
9548,2023-10-25,2023-10-26,,Dining Out,10.98,0.00,4386590.98
9549,2023-10-26,2023-10-26,,Online Transfer,1787.40,0.00,4384803.58
9550,2023-10-26,2023-10-26,,ATM Withdrawal,291.47,0.00,4384512.11
9551,2023-10-27,2023-10-26,,Salary Credit,0.00,4479.33,4388991.44
9552,2023-10-26,2023-10-26,,Interest Credited,0.00,88.48,4389079.92
9553,2023-10-26,2023-10-26,,Transfer Received,0.00,1313.28,4390393.20
9554,2023-10-26,2023-10-26,,ATM Withdrawal,65.15,0.00,4390328.05
9555,2023-10-26,2023-10-26,,ATM Withdrawal,95.07,0.00,4390232.98
9556,2023-10-26,2023-10-26,,Investment - Mutual Funds,442.05,0.00,4389790.93
9557,2023-10-26,2023-10-26,,Cash Deposit,0.00,945.51,4390736.44
9558,2023-10-26,2023-10-26,,Groceries - Online Delivery,88.73,0.00,4390647.71
9559,2023-10-27,2023-10-27,,ATM Withdrawal,400.77,0.00,4390246.94
9560,2023-10-27,2023-10-27,,Transfer Received,0.00,1307.46,4391554.40
9561,2023-10-28,2023-10-27,,Credit Card Payment,304.98,0.00,4391249.42
9562,2023-10-27,2023-10-27,,Takeout,25.52,0.00,4391223.90
9563,2023-10-27,2023-10-27,,Credit Card Payment,243.92,0.00,4390979.98
9564,2023-10-28,2023-10-28,,Salary Credit,0.00,3967.04,4394947.02
9565,2023-10-28,2023-10-28,,Interest Credited,0.00,42.94,4394989.96
9566,2023-10-27,2023-10-28,,Transfer Received,0.00,1500.83,4396490.79
9567,2023-10-28,2023-10-28,,Online Transfer,1467.40,0.00,4395023.39
9568,2023-10-27,2023-10-28,,Transfer Received,0.00,1001.80,4396025.19
9569,2023-10-30,2023-10-29,,Dining Out,83.24,0.00,4395941.95
9570,2023-10-30,2023-10-29,,ATM Withdrawal,188.94,0.00,4395753.01
9571,2023-10-30,2023-10-29,,Groceries - Supermarket,69.49,0.00,4395683.52
9572,2023-10-28,2023-10-29,,Groceries - Supermarket,40.87,0.00,4395642.65
9573,2023-10-30,2023-10-29,,Dining Out,26.31,0.00,4395616.34
9574,2023-10-29,2023-10-30,,Groceries - Supermarket,196.23,0.00,4395420.11
9575,2023-10-31,2023-10-30,,Online Transfer,1375.54,0.00,4394044.57
9576,2023-10-30,2023-10-30,,Dividend Received,0.00,189.07,4394233.64
9577,2023-10-30,2023-10-30,,Groceries - Supermarket,55.51,0.00,4394178.13
9578,2023-10-31,2023-10-31,,Coffee Shop,5.14,0.00,4394172.99
9579,2023-11-01,2023-10-31,,Transfer Received,0.00,1296.92,4395469.91
9580,2023-10-31,2023-10-31,,Investment - Stocks,3069.68,0.00,4392400.23
9581,2023-11-02,2023-11-01,,Transfer Received,0.00,2630.90,4395031.13
9582,2023-11-02,2023-11-01,,Daily Essentials,23.93,0.00,4395007.20
9583,2023-11-01,2023-11-01,,Groceries - Supermarket,93.71,0.00,4394913.49
9584,2023-11-02,2023-11-01,,Interest Credited,0.00,17.83,4394931.32
9585,2023-11-01,2023-11-01,,Investment - Mutual Funds,2177.65,0.00,4392753.67
9586,2023-11-01,2023-11-01,,Coffee Shop,19.99,0.00,4392733.68
9587,2023-11-01,2023-11-01,,Interest Credited,0.00,53.28,4392786.96
9588,2023-11-02,2023-11-01,,Credit Card Payment,243.36,0.00,4392543.60
9589,2023-11-02,2023-11-02,,Transfer Received,0.00,1173.79,4393717.39
9590,2023-11-02,2023-11-02,,Transfer Received,0.00,2615.98,4396333.37
9591,2023-11-02,2023-11-02,,Transfer Received,0.00,909.90,4397243.27
9592,2023-11-02,2023-11-02,,Transfer Received,0.00,626.19,4397869.46
9593,2023-11-03,2023-11-02,,Transfer Received,0.00,2225.71,4400095.17
9594,2023-11-03,2023-11-02,,Daily Essentials,37.22,0.00,4400057.95
9595,2023-11-03,2023-11-03,,Groceries - Supermarket,108.92,0.00,4399949.03
9596,2023-11-03,2023-11-03,100238,Cheque Issued,1736.53,0.00,4398212.50
9597,2023-11-04,2023-11-03,,Utility Payment,212.66,0.00,4397999.84
9598,2023-11-04,2023-11-03,,ATM Withdrawal,79.13,0.00,4397920.71
9599,2023-11-02,2023-11-03,,Cash Deposit,0.00,269.66,4398190.37
9600,2023-11-02,2023-11-03,,Credit Card Payment,267.94,0.00,4397922.43
9601,2023-11-04,2023-11-04,,Groceries - Supermarket,26.98,0.00,4397895.45
9602,2023-11-03,2023-11-04,,Dividend Received,0.00,239.46,4398134.91
9603,2023-11-05,2023-11-04,,Groceries - Supermarket,91.07,0.00,4398043.84
9604,2023-11-05,2023-11-04,,Groceries - Online Delivery,54.99,0.00,4397988.85
9605,2023-11-04,2023-11-04,,Groceries - Supermarket,157.82,0.00,4397831.03
9606,2023-11-05,2023-11-05,100239,Cheque Issued,606.52,0.00,4397224.51
9607,2023-11-04,2023-11-05,,Investment - SIP,515.56,0.00,4396708.95
9608,2023-11-04,2023-11-05,,Online Transfer,1415.74,0.00,4395293.21
9609,2023-11-05,2023-11-05,,ATM Withdrawal,455.17,0.00,4394838.04
9610,2023-11-06,2023-11-05,,Transfer Received,0.00,977.18,4395815.22
9611,2023-11-04,2023-11-05,,Investment - Mutual Funds,1830.59,0.00,4393984.63
9612,2023-11-05,2023-11-05,,Cash Deposit,0.00,727.65,4394712.28
9613,2023-11-07,2023-11-06,,Salary Credit,0.00,2473.97,4397186.25
9614,2023-11-06,2023-11-06,100240,Cheque Issued,1547.68,0.00,4395638.57
9615,2023-11-06,2023-11-06,,Rental Income,0.00,2097.88,4397736.45
9616,2023-11-06,2023-11-06,,Groceries - Supermarket,90.68,0.00,4397645.77
9617,2023-11-07,2023-11-06,100241,Cheque Issued,512.91,0.00,4397132.86
9618,2023-11-05,2023-11-06,,Transfer Received,0.00,1053.65,4398186.51
9619,2023-11-05,2023-11-06,,ATM Withdrawal,78.47,0.00,4398108.04
9620,2023-11-07,2023-11-07,100242,Cheque Issued,1119.36,0.00,4396988.68
9621,2023-11-06,2023-11-07,,Online Transfer,1064.55,0.00,4395924.13
9622,2023-11-07,2023-11-07,,Takeout,44.40,0.00,4395879.73
9623,2023-11-07,2023-11-07,,Transfer Received,0.00,1419.69,4397299.42
9624,2023-11-06,2023-11-07,,Online Transfer,1452.92,0.00,4395846.50
9625,2023-11-08,2023-11-07,,ATM Withdrawal,231.61,0.00,4395614.89
9626,2023-11-08,2023-11-08,,Investment - SIP,268.36,0.00,4395346.53
9627,2023-11-08,2023-11-08,,Transfer Received,0.00,658.22,4396004.75
9628,2023-11-07,2023-11-08,,ATM Withdrawal,257.67,0.00,4395747.08
9629,2023-11-09,2023-11-09,,Transfer Received,0.00,1972.01,4397719.09
9630,2023-11-08,2023-11-09,,Daily Essentials,12.01,0.00,4397707.08
9631,2023-11-08,2023-11-09,,Investment - Mutual Funds,624.41,0.00,4397082.67
9632,2023-11-09,2023-11-09,,Loan EMI,1159.66,0.00,4395923.01
9633,2023-11-09,2023-11-09,,Credit Card Payment,494.36,0.00,4395428.65
9634,2023-11-10,2023-11-09,,ATM Withdrawal,426.49,0.00,4395002.16
9635,2023-11-09,2023-11-09,,ATM Withdrawal,63.41,0.00,4394938.75
9636,2023-11-10,2023-11-09,,Groceries - Supermarket,36.42,0.00,4394902.33
9637,2023-11-09,2023-11-09,,Online Transfer,711.58,0.00,4394190.75
9638,2023-11-10,2023-11-10,,Groceries - Supermarket,91.69,0.00,4394099.06
9639,2023-11-10,2023-11-10,,Credit Card Payment,896.24,0.00,4393202.82
9640,2023-11-10,2023-11-10,100243,Cheque Issued,1911.96,0.00,4391290.86
9641,2023-11-11,2023-11-10,,Online Transfer,863.14,0.00,4390427.72
9642,2023-11-11,2023-11-10,,Salary Credit,0.00,3836.11,4394263.83
9643,2023-11-11,2023-11-10,,ATM Withdrawal,117.51,0.00,4394146.32
9644,2023-11-10,2023-11-10,,Dining Out,45.57,0.00,4394100.75
9645,2023-11-11,2023-11-11,,Groceries - Online Delivery,123.54,0.00,4393977.21
9646,2023-11-11,2023-11-11,,Groceries - Online Delivery,113.62,0.00,4393863.59
9647,2023-11-11,2023-11-11,,Loan EMI,1644.09,0.00,4392219.50
9648,2023-11-11,2023-11-11,,Investment Returns,0.00,349.63,4392569.13
9649,2023-11-11,2023-11-11,,Groceries - Supermarket,61.08,0.00,4392508.05
9650,2023-11-11,2023-11-11,,Dividend Received,0.00,144.32,4392652.37
9651,2023-11-10,2023-11-11,,Rental Income,0.00,1304.40,4393956.77
9652,2023-11-11,2023-11-11,,Transfer Received,0.00,2834.15,4396790.92
9653,2023-11-11,2023-11-11,,Credit Card Payment,824.25,0.00,4395966.67
9654,2023-11-12,2023-11-12,100244,Cheque Issued,849.81,0.00,4395116.86
9655,2023-11-13,2023-11-12,,Investment - Stocks,3175.68,0.00,4391941.18
9656,2023-11-12,2023-11-12,,Utility Payment,88.60,0.00,4391852.58
9657,2023-11-12,2023-11-12,,Online Transfer,395.63,0.00,4391456.95
9658,2023-11-12,2023-11-12,,Dining Out,63.99,0.00,4391392.96
9659,2023-11-12,2023-11-13,,Groceries - Supermarket,47.72,0.00,4391345.24
9660,2023-11-13,2023-11-13,,Transfer Received,0.00,1188.43,4392533.67
9661,2023-11-13,2023-11-13,,Transfer Received,0.00,899.29,4393432.96
9662,2023-11-13,2023-11-13,,Salary Credit,0.00,3841.84,4397274.80
9663,2023-11-13,2023-11-13,,Groceries - Online Delivery,104.98,0.00,4397169.82
9664,2023-11-13,2023-11-13,,Online Transfer,1011.57,0.00,4396158.25
9665,2023-11-13,2023-11-13,,ATM Withdrawal,103.92,0.00,4396054.33
9666,2023-11-12,2023-11-13,,Online Transfer,706.20,0.00,4395348.13
9667,2023-11-13,2023-11-13,,Investment - Mutual Funds,1259.17,0.00,4394088.96
9668,2023-11-13,2023-11-13,,ATM Withdrawal,180.02,0.00,4393908.94
9669,2023-11-14,2023-11-14,,Credit Card Payment,310.90,0.00,4393598.04
9670,2023-11-14,2023-11-14,,Online Transfer,992.90,0.00,4392605.14
9671,2023-11-14,2023-11-14,100245,Cheque Issued,2835.73,0.00,4389769.41
9672,2023-11-14,2023-11-14,,Transfer Received,0.00,1755.14,4391524.55
9673,2023-11-13,2023-11-14,,Groceries - Supermarket,72.71,0.00,4391451.84
9674,2023-11-14,2023-11-14,,Dining Out,71.17,0.00,4391380.67
9675,2023-11-14,2023-11-14,,Salary Credit,0.00,4992.50,4396373.17
9676,2023-11-14,2023-11-14,,Groceries - Supermarket,63.59,0.00,4396309.58
9677,2023-11-14,2023-11-14,,ATM Withdrawal,76.43,0.00,4396233.15
9678,2023-11-14,2023-11-14,,Investment - Mutual Funds,853.94,0.00,4395379.21
9679,2023-11-14,2023-11-14,,Salary Credit,0.00,4730.33,4400109.54
9680,2023-11-14,2023-11-14,,Groceries - Supermarket,49.71,0.00,4400059.83
9681,2023-11-14,2023-11-14,,Online Transfer,1783.20,0.00,4398276.63
9682,2023-11-14,2023-11-14,,Salary Credit,0.00,4455.79,4402732.42
9683,2023-11-15,2023-11-15,,Transfer Received,0.00,1715.53,4404447.95
9684,2023-11-14,2023-11-15,,Salary Credit,0.00,4535.51,4408983.46
9685,2023-11-15,2023-11-15,,Interest Credited,0.00,75.71,4409059.17
9686,2023-11-14,2023-11-15,,Investment - Stocks,4553.92,0.00,4404505.25
9687,2023-11-15,2023-11-15,,Investment Returns,0.00,883.97,4405389.22
9688,2023-11-14,2023-11-15,,Groceries - Supermarket,38.75,0.00,4405350.47
9689,2023-11-17,2023-11-16,,Salary Credit,0.00,4805.64,4410156.11
9690,2023-11-16,2023-11-16,,Investment Returns,0.00,726.36,4410882.47
9691,2023-11-16,2023-11-16,,Groceries - Online Delivery,62.09,0.00,4410820.38
9692,2023-11-16,2023-11-16,,ATM Withdrawal,58.57,0.00,4410761.81
9693,2023-11-17,2023-11-16,,Groceries - Supermarket,49.12,0.00,4410712.69
9694,2023-11-15,2023-11-16,,Dividend Received,0.00,490.57,4411203.26
9695,2023-11-16,2023-11-16,,Groceries - Supermarket,160.21,0.00,4411043.05
9696,2023-11-17,2023-11-17,,Investment - Stocks,1398.09,0.00,4409644.96
9697,2023-11-17,2023-11-17,,Online Transfer,945.58,0.00,4408699.38
9698,2023-11-18,2023-11-18,,Salary Credit,0.00,4875.24,4413574.62
9699,2023-11-17,2023-11-18,,Salary Credit,0.00,4583.79,4418158.41
9700,2023-11-18,2023-11-18,,ATM Withdrawal,465.35,0.00,4417693.06
9701,2023-11-19,2023-11-18,,Groceries - Supermarket,178.93,0.00,4417514.13
9702,2023-11-18,2023-11-18,,Credit Card Payment,221.37,0.00,4417292.76
9703,2023-11-17,2023-11-18,,ATM Withdrawal,45.62,0.00,4417247.14
9704,2023-11-19,2023-11-19,,Loan EMI,862.72,0.00,4416384.42
9705,2023-11-20,2023-11-19,,Transfer Received,0.00,1509.74,4417894.16
9706,2023-11-19,2023-11-19,,Transfer Received,0.00,1869.75,4419763.91
9707,2023-11-19,2023-11-19,,Online Transfer,1994.79,0.00,4417769.12
9708,2023-11-18,2023-11-19,,Interest Credited,0.00,11.20,4417780.32
9709,2023-11-19,2023-11-19,,Loan EMI,1273.55,0.00,4416506.77
9710,2023-11-21,2023-11-20,,ATM Withdrawal,432.96,0.00,4416073.81
9711,2023-11-21,2023-11-20,,Takeout,43.84,0.00,4416029.97
9712,2023-11-20,2023-11-21,,Transfer Received,0.00,1989.27,4418019.24
9713,2023-11-20,2023-11-21,,Transfer Received,0.00,1210.60,4419229.84
9714,2023-11-20,2023-11-21,,Online Transfer,345.00,0.00,4418884.84
9715,2023-11-22,2023-11-21,,Online Transfer,1433.99,0.00,4417450.85
9716,2023-11-21,2023-11-21,,Transfer Received,0.00,2214.03,4419664.88
9717,2023-11-20,2023-11-21,,Online Transfer,1545.83,0.00,4418119.05
9718,2023-11-21,2023-11-21,,Dining Out,76.86,0.00,4418042.19
9719,2023-11-21,2023-11-22,,Transfer Received,0.00,1044.86,4419087.05
9720,2023-11-21,2023-11-22,,Groceries - Supermarket,99.58,0.00,4418987.47
9721,2023-11-22,2023-11-22,,Interest Credited,0.00,67.22,4419054.69
9722,2023-11-23,2023-11-22,,Groceries - Supermarket,95.10,0.00,4418959.59
9723,2023-11-22,2023-11-22,,ATM Withdrawal,499.57,0.00,4418460.02
9724,2023-11-21,2023-11-22,,Transfer Received,0.00,548.08,4419008.10
9725,2023-11-22,2023-11-22,,Utility Payment,276.68,0.00,4418731.42
9726,2023-11-23,2023-11-23,,Transfer Received,0.00,773.79,4419505.21
9727,2023-11-24,2023-11-23,,Interest Credited,0.00,23.45,4419528.66
9728,2023-11-22,2023-11-23,,ATM Withdrawal,428.18,0.00,4419100.48
9729,2023-11-23,2023-11-23,,Takeout,11.61,0.00,4419088.87
9730,2023-11-25,2023-11-24,,Salary Credit,0.00,2389.45,4421478.32
9731,2023-11-24,2023-11-24,,Salary Credit,0.00,4248.72,4425727.04
9732,2023-11-24,2023-11-24,,Groceries - Supermarket,197.39,0.00,4425529.65
9733,2023-11-24,2023-11-24,,Interest Credited,0.00,34.67,4425564.32
9734,2023-11-24,2023-11-24,,Daily Essentials,42.47,0.00,4425521.85
9735,2023-11-24,2023-11-24,,Interest Credited,0.00,13.13,4425534.98
9736,2023-11-24,2023-11-24,,Online Transfer,1159.73,0.00,4424375.25
9737,2023-11-25,2023-11-24,,Groceries - Supermarket,127.32,0.00,4424247.93
9738,2023-11-24,2023-11-24,,Groceries - Supermarket,26.99,0.00,4424220.94
9739,2023-11-25,2023-11-25,,Transfer Received,0.00,1798.51,4426019.45
9740,2023-11-26,2023-11-25,,Salary Credit,0.00,3067.79,4429087.24
9741,2023-11-25,2023-11-25,,ATM Withdrawal,208.59,0.00,4428878.65
9742,2023-11-25,2023-11-25,,Investment Returns,0.00,796.10,4429674.75
9743,2023-11-25,2023-11-25,,Credit Card Payment,266.04,0.00,4429408.71
9744,2023-11-26,2023-11-26,,Groceries - Online Delivery,140.57,0.00,4429268.14
9745,2023-11-27,2023-11-26,100246,Cheque Issued,984.39,0.00,4428283.75
9746,2023-11-27,2023-11-26,,Utility Payment,224.04,0.00,4428059.71
9747,2023-11-27,2023-11-26,,ATM Withdrawal,328.92,0.00,4427730.79
9748,2023-11-26,2023-11-26,,Interest Credited,0.00,96.31,4427827.10
9749,2023-11-26,2023-11-26,,Investment Returns,0.00,82.01,4427909.11
9750,2023-11-27,2023-11-27,,Credit Card Payment,739.28,0.00,4427169.83
9751,2023-11-27,2023-11-27,,Salary Credit,0.00,4781.64,4431951.47
9752,2023-11-26,2023-11-27,,Transfer Received,0.00,1899.23,4433850.70
9753,2023-11-27,2023-11-27,,Online Transfer,1574.29,0.00,4432276.41
9754,2023-11-26,2023-11-27,,Cash Deposit,0.00,619.87,4432896.28
9755,2023-11-27,2023-11-27,,Dining Out,47.86,0.00,4432848.42
9756,2023-11-27,2023-11-27,,Salary Credit,0.00,2876.50,4435724.92
9757,2023-11-27,2023-11-27,,Groceries - Supermarket,125.22,0.00,4435599.70
9758,2023-11-28,2023-11-28,,ATM Withdrawal,352.35,0.00,4435247.35
9759,2023-11-27,2023-11-28,,Groceries - Online Delivery,102.93,0.00,4435144.42
9760,2023-11-28,2023-11-28,,Groceries - Supermarket,67.10,0.00,4435077.32
9761,2023-11-28,2023-11-28,,Transfer Received,0.00,2330.39,4437407.71
9762,2023-11-29,2023-11-28,,Groceries - Supermarket,182.17,0.00,4437225.54
9763,2023-11-28,2023-11-28,,Credit Card Payment,498.90,0.00,4436726.64
9764,2023-11-27,2023-11-28,,Daily Essentials,28.08,0.00,4436698.56
9765,2023-11-28,2023-11-28,,Salary Credit,0.00,2426.53,4439125.09
9766,2023-11-28,2023-11-28,,Groceries - Supermarket,102.44,0.00,4439022.65
9767,2023-11-28,2023-11-28,,Transfer Received,0.00,575.55,4439598.20
9768,2023-11-29,2023-11-29,,ATM Withdrawal,310.20,0.00,4439288.00
9769,2023-11-30,2023-11-29,,Dining Out,87.97,0.00,4439200.03
9770,2023-11-30,2023-11-29,,Daily Essentials,16.34,0.00,4439183.69
9771,2023-11-30,2023-11-30,,Groceries - Supermarket,127.31,0.00,4439056.38
9772,2023-11-30,2023-11-30,,Transfer Received,0.00,883.31,4439939.69
9773,2023-11-30,2023-11-30,,Rental Income,0.00,2748.30,4442687.99
9774,2023-11-30,2023-11-30,,Groceries - Supermarket,159.98,0.00,4442528.01
9775,2023-11-30,2023-11-30,,Transfer Received,0.00,2508.75,4445036.76
9776,2023-12-01,2023-12-01,,Interest Credited,0.00,21.75,4445058.51
9777,2023-12-01,2023-12-01,,Loan EMI,1471.27,0.00,4443587.24
9778,2023-11-30,2023-12-01,,Cash Deposit,0.00,196.14,4443783.38
9779,2023-12-01,2023-12-01,,Dining Out,38.25,0.00,4443745.13
9780,2023-12-01,2023-12-01,,Salary Credit,0.00,4118.39,4447863.52
9781,2023-12-01,2023-12-01,,Transfer Received,0.00,1462.47,4449325.99
9782,2023-12-01,2023-12-01,,Dining Out,35.51,0.00,4449290.48
9783,2023-12-02,2023-12-01,,ATM Withdrawal,282.01,0.00,4449008.47
9784,2023-12-01,2023-12-01,,Dividend Received,0.00,190.19,4449198.66
9785,2023-11-30,2023-12-01,,Interest Credited,0.00,91.67,4449290.33
9786,2023-12-02,2023-12-02,,Interest Credited,0.00,88.20,4449378.53
9787,2023-12-02,2023-12-02,,Credit Card Payment,954.98,0.00,4448423.55
9788,2023-12-03,2023-12-02,100247,Cheque Issued,1821.09,0.00,4446602.46
9789,2023-12-02,2023-12-02,,Transfer Received,0.00,2934.17,4449536.63
9790,2023-12-02,2023-12-02,,Online Transfer,674.60,0.00,4448862.03
9791,2023-12-03,2023-12-03,,Investment Returns,0.00,252.70,4449114.73
9792,2023-12-03,2023-12-03,100248,Cheque Issued,1612.29,0.00,4447502.44
9793,2023-12-03,2023-12-03,,Groceries - Supermarket,75.46,0.00,4447426.98
9794,2023-12-02,2023-12-03,100249,Cheque Issued,1816.46,0.00,4445610.52
9795,2023-12-03,2023-12-03,,Rental Income,0.00,1966.85,4447577.37
9796,2023-12-03,2023-12-03,,Investment - SIP,921.23,0.00,4446656.14
9797,2023-12-03,2023-12-03,,Online Transfer,565.91,0.00,4446090.23
9798,2023-12-03,2023-12-03,,Credit Card Payment,451.53,0.00,4445638.70
9799,2023-12-04,2023-12-03,,Loan EMI,1147.09,0.00,4444491.61
9800,2023-12-03,2023-12-03,,Daily Essentials,14.71,0.00,4444476.90
9801,2023-12-04,2023-12-04,100250,Cheque Issued,1273.61,0.00,4443203.29
9802,2023-12-04,2023-12-04,,Salary Credit,0.00,4451.68,4447654.97
9803,2023-12-04,2023-12-04,,Credit Card Payment,230.08,0.00,4447424.89
9804,2023-12-04,2023-12-04,100251,Cheque Issued,1776.68,0.00,4445648.21
9805,2023-12-04,2023-12-04,,Online Transfer,147.73,0.00,4445500.48
9806,2023-12-05,2023-12-05,,Transfer Received,0.00,558.29,4446058.77
9807,2023-12-05,2023-12-05,,Rental Income,0.00,1599.10,4447657.87
9808,2023-12-05,2023-12-05,,Interest Credited,0.00,41.25,4447699.12
9809,2023-12-05,2023-12-05,,Utility Payment,162.32,0.00,4447536.80
9810,2023-12-04,2023-12-05,,Online Transfer,590.93,0.00,4446945.87
9811,2023-12-06,2023-12-06,,Groceries - Supermarket,85.00,0.00,4446860.87
9812,2023-12-06,2023-12-06,,Dining Out,90.30,0.00,4446770.57
9813,2023-12-06,2023-12-06,,Credit Card Payment,258.77,0.00,4446511.80
9814,2023-12-06,2023-12-06,,Transfer Received,0.00,1293.67,4447805.47
9815,2023-12-06,2023-12-06,,Transfer Received,0.00,1522.59,4449328.06
9816,2023-12-06,2023-12-06,,Transfer Received,0.00,2848.39,4452176.45
9817,2023-12-05,2023-12-06,,Utility Payment,141.81,0.00,4452034.64
9818,2023-12-07,2023-12-06,,Online Transfer,141.64,0.00,4451893.00
9819,2023-12-06,2023-12-07,,Transfer Received,0.00,2667.50,4454560.50
9820,2023-12-07,2023-12-07,,Loan EMI,748.78,0.00,4453811.72
9821,2023-12-07,2023-12-07,,Transfer Received,0.00,2422.55,4456234.27
9822,2023-12-06,2023-12-07,,Dining Out,29.65,0.00,4456204.62
9823,2023-12-07,2023-12-07,,Transfer Received,0.00,2538.06,4458742.68
9824,2023-12-07,2023-12-07,,Groceries - Supermarket,116.35,0.00,4458626.33
9825,2023-12-07,2023-12-07,,Online Transfer,237.40,0.00,4458388.93
9826,2023-12-07,2023-12-07,,Transfer Received,0.00,2238.89,4460627.82
9827,2023-12-07,2023-12-07,,Transfer Received,0.00,2744.63,4463372.45
9828,2023-12-07,2023-12-07,,Coffee Shop,6.16,0.00,4463366.29
9829,2023-12-08,2023-12-08,,Salary Credit,0.00,3304.42,4466670.71
9830,2023-12-07,2023-12-08,,ATM Withdrawal,61.67,0.00,4466609.04
9831,2023-12-07,2023-12-08,,Interest Credited,0.00,63.27,4466672.31
9832,2023-12-08,2023-12-08,,Salary Credit,0.00,4459.99,4471132.30
9833,2023-12-09,2023-12-08,,Groceries - Supermarket,104.38,0.00,4471027.92
9834,2023-12-09,2023-12-09,,Online Transfer,461.26,0.00,4470566.66
9835,2023-12-09,2023-12-09,,Transfer Received,0.00,1353.44,4471920.10
9836,2023-12-09,2023-12-09,,Online Transfer,1120.03,0.00,4470800.07
9837,2023-12-08,2023-12-09,,Dining Out,95.21,0.00,4470704.86
9838,2023-12-10,2023-12-09,,Online Transfer,843.33,0.00,4469861.53
9839,2023-12-09,2023-12-09,,Transfer Received,0.00,2194.10,4472055.63
9840,2023-12-08,2023-12-09,,Dining Out,45.15,0.00,4472010.48
9841,2023-12-09,2023-12-09,,Online Transfer,1135.63,0.00,4470874.85
9842,2023-12-09,2023-12-10,,Salary Credit,0.00,3250.14,4474124.99
9843,2023-12-11,2023-12-10,,ATM Withdrawal,29.10,0.00,4474095.89
9844,2023-12-12,2023-12-11,,Transfer Received,0.00,599.66,4474695.55
9845,2023-12-11,2023-12-11,,Utility Payment,201.41,0.00,4474494.14
9846,2023-12-11,2023-12-11,,Transfer Received,0.00,871.66,4475365.80
9847,2023-12-12,2023-12-11,,Groceries - Supermarket,141.36,0.00,4475224.44
9848,2023-12-11,2023-12-11,,Salary Credit,0.00,4035.94,4479260.38
9849,2023-12-11,2023-12-11,,Transfer Received,0.00,898.40,4480158.78
9850,2023-12-11,2023-12-11,,ATM Withdrawal,201.20,0.00,4479957.58
9851,2023-12-11,2023-12-12,,Transfer Received,0.00,1117.00,4481074.58
9852,2023-12-13,2023-12-12,,Takeout,17.44,0.00,4481057.14
9853,2023-12-12,2023-12-12,,Groceries - Supermarket,25.51,0.00,4481031.63
9854,2023-12-12,2023-12-12,,Utility Payment,164.57,0.00,4480867.06
9855,2023-12-11,2023-12-12,,Dividend Received,0.00,420.22,4481287.28
9856,2023-12-12,2023-12-12,,Online Transfer,1205.85,0.00,4480081.43
9857,2023-12-12,2023-12-12,,Rental Income,0.00,1344.79,4481426.22
9858,2023-12-12,2023-12-12,,Online Transfer,442.40,0.00,4480983.82
9859,2023-12-12,2023-12-12,100252,Cheque Issued,1357.62,0.00,4479626.20
9860,2023-12-12,2023-12-12,,ATM Withdrawal,104.14,0.00,4479522.06
9861,2023-12-13,2023-12-12,,Credit Card Payment,664.37,0.00,4478857.69
9862,2023-12-13,2023-12-13,,Credit Card Payment,969.83,0.00,4477887.86
9863,2023-12-13,2023-12-13,,Credit Card Payment,936.74,0.00,4476951.12
9864,2023-12-13,2023-12-13,,Rental Income,0.00,2230.81,4479181.93
9865,2023-12-13,2023-12-13,100253,Cheque Issued,594.09,0.00,4478587.84
9866,2023-12-13,2023-12-13,,Groceries - Supermarket,122.60,0.00,4478465.24
9867,2023-12-14,2023-12-13,,Investment - SIP,355.36,0.00,4478109.88
9868,2023-12-14,2023-12-13,,ATM Withdrawal,147.23,0.00,4477962.65
9869,2023-12-12,2023-12-13,,ATM Withdrawal,152.77,0.00,4477809.88
9870,2023-12-14,2023-12-13,,Rental Income,0.00,1886.40,4479696.28
9871,2023-12-13,2023-12-13,,Transfer Received,0.00,1759.16,4481455.44
9872,2023-12-14,2023-12-13,,Dining Out,15.48,0.00,4481439.96
9873,2023-12-13,2023-12-13,,Utility Payment,91.11,0.00,4481348.85
9874,2023-12-13,2023-12-13,,Interest Credited,0.00,40.11,4481388.96
9875,2023-12-14,2023-12-14,,Salary Credit,0.00,3321.95,4484710.91
9876,2023-12-14,2023-12-14,,Dividend Received,0.00,86.90,4484797.81
9877,2023-12-13,2023-12-14,,Utility Payment,134.71,0.00,4484663.10
9878,2023-12-14,2023-12-14,,Groceries - Online Delivery,90.79,0.00,4484572.31
9879,2023-12-14,2023-12-14,,Transfer Received,0.00,2980.75,4487553.06
9880,2023-12-14,2023-12-14,,Takeout,29.73,0.00,4487523.33
9881,2023-12-14,2023-12-14,,Salary Credit,0.00,4633.41,4492156.74
9882,2023-12-14,2023-12-14,,Dining Out,45.12,0.00,4492111.62
9883,2023-12-14,2023-12-14,,Salary Credit,0.00,3843.35,4495954.97
9884,2023-12-14,2023-12-14,,Investment - Mutual Funds,2231.85,0.00,4493723.12
9885,2023-12-14,2023-12-14,,Transfer Received,0.00,2236.55,4495959.67
9886,2023-12-15,2023-12-15,,Salary Credit,0.00,2165.29,4498124.96
9887,2023-12-15,2023-12-15,,Dining Out,11.11,0.00,4498113.85
9888,2023-12-15,2023-12-15,,Online Transfer,1770.34,0.00,4496343.51
9889,2023-12-15,2023-12-15,,Utility Payment,95.94,0.00,4496247.57
9890,2023-12-15,2023-12-15,,Transfer Received,0.00,1665.28,4497912.85
9891,2023-12-15,2023-12-15,,Transfer Received,0.00,1716.06,4499628.91
9892,2023-12-16,2023-12-15,,Salary Credit,0.00,4918.47,4504547.38
9893,2023-12-15,2023-12-15,,Salary Credit,0.00,3253.92,4507801.30
9894,2023-12-16,2023-12-15,,Transfer Received,0.00,2139.71,4509941.01
9895,2023-12-16,2023-12-16,,Transfer Received,0.00,2691.40,4512632.41
9896,2023-12-16,2023-12-16,,Dining Out,90.96,0.00,4512541.45
9897,2023-12-16,2023-12-16,100254,Cheque Issued,1238.79,0.00,4511302.66
9898,2023-12-17,2023-12-16,,Groceries - Supermarket,83.49,0.00,4511219.17
9899,2023-12-16,2023-12-16,,Salary Credit,0.00,2048.79,4513267.96
9900,2023-12-17,2023-12-16,,ATM Withdrawal,88.66,0.00,4513179.30
9901,2023-12-16,2023-12-17,,Interest Credited,0.00,53.54,4513232.84
9902,2023-12-17,2023-12-17,,Transfer Received,0.00,2693.00,4515925.84
9903,2023-12-17,2023-12-17,,Loan EMI,803.93,0.00,4515121.91
9904,2023-12-17,2023-12-17,,Takeout,34.46,0.00,4515087.45
9905,2023-12-17,2023-12-17,,Interest Credited,0.00,41.53,4515128.98
9906,2023-12-17,2023-12-17,,Transfer Received,0.00,2720.88,4517849.86
9907,2023-12-17,2023-12-17,,Transfer Received,0.00,869.59,4518719.45
9908,2023-12-18,2023-12-18,,Utility Payment,190.10,0.00,4518529.35
9909,2023-12-19,2023-12-18,,Groceries - Supermarket,70.82,0.00,4518458.53
9910,2023-12-18,2023-12-18,,Credit Card Payment,791.52,0.00,4517667.01
9911,2023-12-18,2023-12-18,,Cash Deposit,0.00,330.81,4517997.82
9912,2023-12-18,2023-12-18,,Dining Out,94.47,0.00,4517903.35
9913,2023-12-18,2023-12-18,,Utility Payment,153.83,0.00,4517749.52
9914,2023-12-17,2023-12-18,,Utility Payment,242.35,0.00,4517507.17
9915,2023-12-18,2023-12-18,,Salary Credit,0.00,2444.05,4519951.22
9916,2023-12-18,2023-12-18,,Investment Returns,0.00,276.17,4520227.39
9917,2023-12-17,2023-12-18,,Investment Returns,0.00,141.82,4520369.21
9918,2023-12-17,2023-12-18,,Online Transfer,764.52,0.00,4519604.69
9919,2023-12-19,2023-12-19,,Transfer Received,0.00,1119.25,4520723.94
9920,2023-12-18,2023-12-19,100255,Cheque Issued,1778.56,0.00,4518945.38
9921,2023-12-19,2023-12-19,,Cash Deposit,0.00,872.75,4519818.13
9922,2023-12-19,2023-12-19,,Online Transfer,114.72,0.00,4519703.41
9923,2023-12-19,2023-12-19,,Salary Credit,0.00,2107.18,4521810.59
9924,2023-12-19,2023-12-19,,Rental Income,0.00,2707.14,4524517.73
9925,2023-12-20,2023-12-20,,Salary Credit,0.00,2910.73,4527428.46
9926,2023-12-20,2023-12-20,,Online Transfer,763.81,0.00,4526664.65
9927,2023-12-20,2023-12-20,,Interest Credited,0.00,78.50,4526743.15
9928,2023-12-20,2023-12-20,,Transfer Received,0.00,1560.56,4528303.71
9929,2023-12-20,2023-12-20,,Dining Out,98.28,0.00,4528205.43
9930,2023-12-21,2023-12-21,,Online Transfer,1797.05,0.00,4526408.38
9931,2023-12-21,2023-12-21,,Transfer Received,0.00,1156.17,4527564.55
9932,2023-12-21,2023-12-21,,ATM Withdrawal,196.03,0.00,4527368.52
9933,2023-12-22,2023-12-21,,Transfer Received,0.00,2342.33,4529710.85
9934,2023-12-22,2023-12-21,,ATM Withdrawal,44.96,0.00,4529665.89
9935,2023-12-21,2023-12-21,,Investment - Mutual Funds,527.77,0.00,4529138.12
9936,2023-12-21,2023-12-21,,Credit Card Payment,241.57,0.00,4528896.55
9937,2023-12-21,2023-12-21,,Transfer Received,0.00,2333.82,4531230.37
9938,2023-12-21,2023-12-21,,Utility Payment,208.33,0.00,4531022.04
9939,2023-12-21,2023-12-21,,Credit Card Payment,633.70,0.00,4530388.34
9940,2023-12-23,2023-12-22,,ATM Withdrawal,348.07,0.00,4530040.27
9941,2023-12-21,2023-12-22,,Transfer Received,0.00,1681.33,4531721.60
9942,2023-12-22,2023-12-22,,Loan EMI,1656.01,0.00,4530065.59
9943,2023-12-22,2023-12-22,,Dividend Received,0.00,364.66,4530430.25
9944,2023-12-21,2023-12-22,,Interest Credited,0.00,33.15,4530463.40
9945,2023-12-23,2023-12-23,,Groceries - Supermarket,107.83,0.00,4530355.57
9946,2023-12-22,2023-12-23,,Salary Credit,0.00,2204.12,4532559.69
9947,2023-12-23,2023-12-23,,ATM Withdrawal,111.57,0.00,4532448.12
9948,2023-12-24,2023-12-24,100256,Cheque Issued,2799.25,0.00,4529648.87
9949,2023-12-24,2023-12-24,,Transfer Received,0.00,1982.70,4531631.57
9950,2023-12-24,2023-12-24,,Investment - Stocks,4166.36,0.00,4527465.21
9951,2023-12-25,2023-12-25,,Transfer Received,0.00,875.18,4528340.39
9952,2023-12-25,2023-12-25,,Groceries - Online Delivery,130.78,0.00,4528209.61
9953,2023-12-26,2023-12-25,,Groceries - Supermarket,98.20,0.00,4528111.41
9954,2023-12-24,2023-12-25,,Credit Card Payment,831.01,0.00,4527280.40
9955,2023-12-25,2023-12-25,,ATM Withdrawal,39.35,0.00,4527241.05
9956,2023-12-25,2023-12-26,,ATM Withdrawal,212.79,0.00,4527028.26
9957,2023-12-27,2023-12-26,,Coffee Shop,13.32,0.00,4527014.94
9958,2023-12-26,2023-12-26,,Transfer Received,0.00,872.41,4527887.35
9959,2023-12-26,2023-12-26,,ATM Withdrawal,85.07,0.00,4527802.28
9960,2023-12-26,2023-12-26,,ATM Withdrawal,258.13,0.00,4527544.15
9961,2023-12-25,2023-12-26,,Salary Credit,0.00,4735.34,4532279.49
9962,2023-12-27,2023-12-26,,Transfer Received,0.00,934.23,4533213.72
9963,2023-12-26,2023-12-26,,Salary Credit,0.00,4596.61,4537810.33
9964,2023-12-27,2023-12-27,,Online Transfer,1606.58,0.00,4536203.75
9965,2023-12-27,2023-12-27,,Utility Payment,146.14,0.00,4536057.61
9966,2023-12-28,2023-12-27,,Groceries - Supermarket,147.79,0.00,4535909.82
9967,2023-12-27,2023-12-27,,Groceries - Supermarket,37.24,0.00,4535872.58
9968,2023-12-28,2023-12-27,,Rental Income,0.00,2436.86,4538309.44
9969,2023-12-26,2023-12-27,,Investment Returns,0.00,182.08,4538491.52
9970,2023-12-29,2023-12-28,,Dining Out,41.01,0.00,4538450.51
9971,2023-12-28,2023-12-28,,Online Transfer,860.47,0.00,4537590.04
9972,2023-12-28,2023-12-28,,Coffee Shop,17.69,0.00,4537572.35
9973,2023-12-29,2023-12-28,,Online Transfer,1176.36,0.00,4536395.99
9974,2023-12-29,2023-12-28,100257,Cheque Issued,1070.89,0.00,4535325.10
9975,2023-12-29,2023-12-28,,ATM Withdrawal,168.72,0.00,4535156.38
9976,2023-12-28,2023-12-28,,Loan EMI,1731.95,0.00,4533424.43
9977,2023-12-28,2023-12-28,,Transfer Received,0.00,2845.27,4536269.70
9978,2023-12-29,2023-12-29,,Utility Payment,62.84,0.00,4536206.86
9979,2023-12-30,2023-12-29,,Dining Out,80.02,0.00,4536126.84
9980,2023-12-29,2023-12-29,,Credit Card Payment,653.01,0.00,4535473.83
9981,2023-12-29,2023-12-29,100258,Cheque Issued,2036.13,0.00,4533437.70
9982,2023-12-29,2023-12-29,,Transfer Received,0.00,1463.77,4534901.47
9983,2023-12-28,2023-12-29,,ATM Withdrawal,58.78,0.00,4534842.69
9984,2023-12-29,2023-12-29,,Groceries - Online Delivery,52.94,0.00,4534789.75
9985,2023-12-30,2023-12-30,,Utility Payment,157.01,0.00,4534632.74
9986,2023-12-30,2023-12-30,,Groceries - Supermarket,179.86,0.00,4534452.88
9987,2023-12-30,2023-12-30,,Groceries - Supermarket,118.87,0.00,4534334.01
9988,2023-12-30,2023-12-30,,Interest Credited,0.00,86.48,4534420.49
9989,2023-12-30,2023-12-30,,Groceries - Online Delivery,103.79,0.00,4534316.70
9990,2023-12-30,2023-12-30,,Salary Credit,0.00,4682.52,4538999.22
9991,2023-12-30,2023-12-30,,Groceries - Supermarket,142.49,0.00,4538856.73
9992,2023-12-30,2023-12-30,,ATM Withdrawal,326.34,0.00,4538530.39
9993,2023-12-31,2023-12-31,,Transfer Received,0.00,2881.65,4541412.04
9994,2024-01-01,2023-12-31,,Interest Credited,0.00,11.58,4541423.62
9995,2023-12-31,2023-12-31,,Online Transfer,1514.73,0.00,4539908.89
9996,2024-01-01,2023-12-31,,Transfer Received,0.00,1358.86,4541267.75
9997,2023-12-31,2023-12-31,,ATM Withdrawal,150.01,0.00,4541117.74
9998,2024-01-01,2023-12-31,,Investment - Stocks,4675.82,0.00,4536441.92
9999,2023-12-31,2023-12-31,,Investment - Mutual Funds,1636.63,0.00,4534805.29
10000,2023-12-31,2023-12-31,,Salary Credit,0.00,3314.80,4538120.09
